;1
    #######
   #  # #  #
  #  #   #  #
 # # $ # $ # #
 #  .#.*.#.  #
#  #.......#  #
#  # $ $ $ #  #
 #  ## $ ##  #
 # # $$#$$ # #
 # # # $ # # #
  #         #
  # ## @ ## #
   #  # #  #
    #######
Solution: undefined

;2
    #######
   # # # # #
  #         #
 #  $ $ $ $  #
 # $## ####$ #
##  # ....#   #
## $ .###.#$  #
 #  #.# #.#  #
 # $#.###. $ #
 #  #.... #  #
  #$#### ####
  #  $ $ $  #
   #   @   #
    #######
Solution: undefined

;3
    #######
   #       #
  # $ $ $$  #
 #  $$#..#$  #
 #    ##.#   #
#   ###..###  #
# #$...$$.#.  #
 # $.#.$ ... #
 #  ###..###$#
 # $$ ##.#   #
  #   #..#$ #
  ## $ $$$  #
   #   @   #
    #######
Solution: undefined

;4
    #######
   #       #
  #  # ## # #
 #  #******  #
 # # *     # #
## # * ### #  #
#  $ * #   #  #
 # # * ### # #
 # # *     # #
 #   *****.  #
  # #     ###
  #  ## ##  #
   #   @   #
    #######
Solution: undefined

;5
    #######
   #       #
  # $ $ $$  #
 #    # $  # #
 # #   #$##  #
# $$ # $  ...##
#  $  ##  ...##
 #$ $  # ##..#
 # $ $  #....#
 #  $ $ #....#
  #$ $  #..##
  # $ $ #..##
   #   @ ###
    #######
Solution: u4l1u1l1u1l1u2r2d1r4d1r2u2l1d4r1d1l2u1l1d2u2r3u2l3u1l3u1l1u3r4l2d2r1d1u1l1u2l2d3r1d1r4d1r2u2l1d4r1d1l1u1l1d2u2r2u2l4u3l1u2r1d3u3l3d3r1d1r4d1r2u2l1d4r1d1l2u1l1d1u1r3u2l4u5r2d2l1r1u2l2d3u3l3d3r1d1r4d1r2u2l1d4r1d1l1u1l1d1u1r1u2l3u5r1d1r1d1l1u1l1d2u3l3d3r1d1r4d1r2u2l1d4r1d1l2u1r2u3l6u1l1u2r2u1r1d3u2l3d1l2u1r4l2d2r1d1r4d1r2u2l1d4r1d1l1u4l3u2l1u2r1d3u2l3d2r1d1r4d1r2u2l1d3r1d1l2r1u2l2u1l1u3l4d1l2d2r1d1r2d1u1l1u2r1u2l2d1r1d1r1u1l1u1r3u1r1d3u2l3d2r1d1r4d1r2u2l1d3r1d1l1u2l3u5l3d3l1d2r1d1r1d1r1d2l1u1l1u1l1u4r1u2d2l1u1l1u1r4u1r1d3u2l3d2r1d1r4d1r2u2l1d4u2l3u1l2u1l2d1l3d1u1r3d3r1d1r1d1r1d2l2u2l1u7l1u1r4u1r2d1u1l1d3u2l3d2r1d1r4d1r2u2l1d3u3d1l5u1l2d6r1d2l1u9l1u1r4u1r1d3u2l3d2r1d1r4d1r1l1u1r1u1r1d4u2l4u1l2u1l2d6r3d1l2d1l1u9l1u1r4u1r1d3u2l3d2r1d1r5u1r1d3u1l4u1l2u1l2d6r2u1l1d1l1u7l1u1r4u1r1d3u2l3d2r1d1r4d1r2u2l1d2u1l3u3l5d1l1d2r2d4l2u1r1d1r1u6l1u1r4u1r1d3u2l3d2r1d1r5u1r1d2u1l6u1l2d1l3d1r2u1r1d3r1d2l1u7l1u1r4u1r1d3u2l3d2r1d1r4d1r2u2l1d1r1d1l2u1l2u3l4d6l1u2l1u1r1d1r1u3l1u1r5u1r2d1l1u1l1d3u2l3d2r1d1r4d1r2l2r2u2l1d1l3d1u5l4d10l1u5l1u1r1d1r1u3l1u1r4u1r1d3u2l3d2r1d1r5u1r1d1l4d1r1l1u5l4d10r3u2l1r1u1l2d1l1u6l1u1r4u1r1d3u2l3d2r1d1r5l5u1l2d4l2u2l1u1r2d1r1u3l1u1r4u1r1d3u2l3d2r1d1r4l2u3l5d1r1d5r2u1l1d1l1u5l1u1r4u1r1d3u2l3d2r1d1r3

;6
    #######
   #       #
  #  # # #  #
 #  #****** .#
 # # *    ##$#
#  # * ## #   #
#  $ * #  #   #
 # # * ## #  #
 # # *    ####
 #   *****.  #
  # #     ###
  #  ## ##  #
   #   @   #
    #######
Solution: undefined

;7
    #######
   #       #
  # $ $$ $  #
 #   $ $ $ $ #
 # $ $   $$$ #
#  $ ## ##    #
#   #..#..#$  #
 #  #  #..#  #
 # $*..*...$ #
 #  #..#  #  #
  # #..#..# #
  #  ## ##  #
   #   @  ##
    #######
Solution: undefined

;8
    #######
   #       #
  #   #   # #
 # $ ####    #
 #  #....# # #
#  $#....     #
#    ..*.#   ##
 # $#....#####
 #   ####    #
 # $ $ $ $ $ #
  # $ $ $ $ #
  #  $ $ $  #
   #   @   #
    #######
Solution: undefined

;9
    #######
   #.#   #.#
  # .# $ #. #
 #  .# $ #.  #
 # #.# $ #.# #
# $#.  $  .#$ #
#   .#$$$#.   #
 #$#.  $  .#$#
 # #.# $ #.# #
 #  .# $ #.  #
  #$.# $ #.$#
  #  #$$$#  #
   #   @   #
    #######
Solution: undefined

;10
    #######
   #       #
  #  $ $ $ ##
 #  $ # ###  #
 # $ #      ##
##  $# ..#.  ##
## $ # #...  ##
 #  #  ...#  #
 # $#  .#..  #
 #   #     # #
  # $ #######
  #  $ $ $  #
   #   @   #
    #######
Solution: undefined

;11
    #######
   # #     #
  #    $ $  #
 #  $ $ $ $  #
 # $ ###$##$ #
#   # ....#   #
#  $$.##..#$  #
 #  #.....#  #
 # $#.###. $ #
 #  #.... #  #
  #$#### # ##
  #  $ $ $  #
   #   @   #
    #######
Solution: undefined

;12
    #######
   #   @   #
  #  # $ #  #
 #  $ $ $ $  #
 # $  $ $  $ #
#  $ $ $ $ $  #
# ###### #### #
 # .. #  .. ##
 # .. #  ..  #
 ##.# ####.###
  #.      . #
  #.      . #
   #       #
    #######
Solution: undefined

;13
    #######
   #       #
  #   * #$* #
 #    *$# *  #
 #####       #
##....#* #$* ##
##.*..#*$# * ##
 ###**#      #
 #.*..# * #$*#
 #.*.*# *$# *#
  #  $  $ $ #
  # $#$  $  #
   #   @   #
    #######
Solution: undefined

;14
    #######
   #       #
  #  $   $  #
 #  $$$ $$$  #
 #   $   $   #
#   ########  #
#  $#..*.. #  #
 #  #.# #* $ #
 #$$ .###. # #
 #   * $ * # #
  # #.###.  #
  # #.# #*  #
   # ..+.. #
    #######
Solution: undefined

;15
    #######
   #       #
  #  $ $ $  #
 ##$####  $  #
 # .... #$#$ #
##.  # .#    ##
##. ## .###$ ##
 #. # $.#    #
 #. #  .# #$ #
 # .... # $  #
  ####$# $# #
  #  $ $ $  #
   #   @   #
    #######
Solution: undefined

;16
    #######
   ##     ##
  ##  $$$$ ##
 #  # $  $   #
 # $   $   $ #
#  # ##### $  #
#  $ #...#$$$ #
 # # #...#   #
 #   #...#   #
 # # #...#####
  #  ##.   ##
  #    +    #
   # #  # ##
    #######
Solution: undefined

;17
    #######
   #   #   #
  #  # $ #  #
 #  .# $ #.  #
 # #.# $ #.# #
# $#.#$$$ .#$ #
#   .# # #.   #
 #$#.  @ #.#$#
 # #*# ###*# #
 #  .# $ #.  #
  # ## # ## #
  #  # $ #  #
   #       #
    #######
Solution: undefined

;18
    #######
   #  .    #
  #  #.# $$ #
 # # #.###   #
 # # #.#     #
#    #.# ###  #
# @# #.#$ $   #
 # # #.#   $ #
 #$# #.  $ $ #
 #    .# $$$ #
  # ##.##   #
  #  #.# $  #
   # #.##  #
    #######
Solution: undefined

;19
    #######
   #  # #  #
  #  #   .  #
 #  #  #.*.# #
 # #  #.*.*.##
#    #.*...*.##
#   #.*.....*.#
 # $##### ####
 #  $ $ $$ $ #
 # $$ $ $ $  #
  # $ $ $ $ #
  #  $ $ $  #
   #   @   #
    #######
Solution: undefined

;20
    #######
   #...#   #
  # .$.$    #
 #  ...## $  #
 ### #$###$ ##
#    #...$  $ #
# $  $.$.#$   #
 # $ #...#  $#
 #$$####  $  #
 #   # $ $ $ #
  # ... $ $ #
  ##.$.# $$ #
   #...#@  #
    #######
Solution: undefined

;21
    #######
   #   @   #
  #  $$$$$  #
 #  $     $  #
 # $$$$$$$$  #
#  $    # # # #
# $ $  ##...  #
 # $  # $.#. #
 #   ##..... #
 #### $.#.$# #
  # #..... ##
  #  .#.##  #
   # ...#  #
    #######
Solution: undefined

;22
    #######
   #       #
  #     #   #
 #   #  #$   #
 #  #..# $$  #
#   #..# $ $  #
# @ #.*  $ $  #
 #  #..# $ $ #
 ##  ..# $ $ #
 #  #..$ $ $ #
  # #..# $$ #
  # #..# $  #
   ##..#   #
    #######
Solution: undefined

;23
    #######
   #       #
  # $$   $$ #
 # $  #.#  $ #
 #   #...#   #
#  $#..... $  #
#  $ #..$# $  #
 # $ #$..# $ #
 # $ .....#$ #
 #   #...#   #
  # $ #.# $ #
  # $ $ $ $ #
   #   @   #
    #######
Solution: undefined

;24
    #######
   #.. @ ..#
  #    $  ###
 ######$#    #
 #      #  $ #
##.#  $ ### ###
##. ## ## #   #
 #.  #$ # $$ #
 # $    #    #
 ##  ## # ## #
  # #  ##  ##
  #     $$  #
   #... #  #
    #######
Solution: undefined

;25
    #######
   #     # #
  #  # # #  #
 #   #$$ #   #
 # #.  $$ .# #
# $#.# # #.#$ #
#   .# @ #.   #
 #$#.#####.#$#
 # #.    #.# #
 #   #$# #   #
  #### $ ## #
  #  #   #  #
   #   #   #
    #######
Solution: undefined

;26
    #######
   #.#   #.#
  # .# $ #. #
 #  .# $ #.  #
 # #.# $ #.# #
# $#.# $  .#$ #
#   .#$$$#.   #
# $#.  $ #.#$ #
 # #.# $ #.# #
 #  .# $ #.  #
  #$.#   #.$#
  # $#$$$#  #
   #   @   #
    #######
Solution: undefined

;27
    #######
   # # @ # #
  #    *    #
 # $ * * *   #
 # * * * * * #
#  . * * * *  #
# # #*#*#*# # #
 # * * * * . #
 # * * * * * #
 #   * * * $ #
  #  * * *  #
   #   *   #
   # #   # #
    #######
Solution: undefined

;28
    #######
   #   @   #
  #  $ $ $  #
 #  $$ $ $ $ #
 #  $   ##   #
#  $ $ #..# $ #
# $$$###..#   #
 #   $..*.## #
 # # $.*....##
 #  #$##....##
  #    #..###
  ###  ###  #
   #       #
    #######
Solution: undefined

;29
    #######
   ##  @  ##
  #   $ $   #
 #  $$$$$ $  #
 # $    $$ $ #
#  $ #  $  ## #
# $$ #.####   #
 # $ #..     #
 # $ #..     #
 #   #..#    #
  ####..#   #
  #.....#   #
   #....#  #
    #######
Solution: undefined

;30
    #######
   #  #@   #
  #  ## **  #
 #  $ $ * *  #
 # $ $ $ **  #
#   $ $     ###
#  $ $  ###...#
 #  $ $ #  .$#
 # $  ###... #
 ##   #  .$###
  # ###... ##
  # #  .$####
   ##... ###
    #######
Solution: undefined

;31
    #######
   #       #
  #   $ $ $ #
 #  $ ##### ##
 # #$# $     #
#      $ # ...#
#  # ##$###...#
 # $ #    #..#
 # # #    #..#
 #  $ ## ##..#
  # $ #    ##
  # $ # $  .#
   #  @##  #
    #######
Solution: undefined

;32
    #######
   #       #
  ## $ $ $  #
 #  #####    #
 #     $ # $ #
#   ## $   $  #
#     # ## $  #
 #  ##    #  #
 #   # $  #$ #
 # ...## #   #
  #...#  # $#
  #...#  #  #
   #..#  #@#
    #######
Solution: undefined

;33
    #######
   ##  #  ##
  #  . @ .  #
 #  $.$ $.$  #
 ##*#.#*#.#*##
##  $.$ $.$  ##
### #.# #.# ###
 #  $.$ $.$  #
 #  #.# #.#  #
 #  $.$ $.$  #
  # #.# #.# #
  # $.$ $.$ #
   #       #
    #######
Solution: undefined

;34
    #######
   #       #
  #  $ $ $  #
 #   $  # $  #
 # $ $ #.# $ #
#  $  ##*##   #
# $ ##.....#$ #
#  # ..*.*..  #
 ### ####..# #
 #    ###* # #
  # #  #    #
  #  #  $$# #
   ##  @   #
    #######
Solution: undefined

;35
    #######
   ##      #
  #  $ $ $  #
 #   $  # $  #
 # $ $ #.# $ #
#  $  ##*##   #
# $ ##.....#$ #
#  # ..*.*..  #
 ### #  #..# #
 #    # #*  ##
  # #  ##   #
  #  # $ $# #
   ##  @   #
    #######
Solution: undefined

;36
    #######
   # # # # #
  ##   @   ##
 ## $ * *   ##
 #  * * * *  #
# # . * * * # #
#  #$#*#*# #  #
 #  * * * .  #
 ## . * * * ##
 #    * * $  #
  ##       ##
   # # # # #
   # # # # #
    #######
Solution: undefined

;37
    #######
   ##     ##
  #  $ $    #
 #  $ $ $ $  #
 # $ $ $$$$$ #
# $ $ $    $ ##
#  $ $  #.#   #
##  $  #..# # #
 # $  #...#  #
 ##  #....####
  # #..... ##
  ##...+.. ##
   ####  ###
    #######
Solution: undefined

;38
    #######
   ##     ##
  ## $ *   ##
 # # * * * # #
 #   + * *   #
#  ##$#*# ##  #
# #  * * .  # #
 # # * * * # #
 # # * * * # #
 #   * * *   #
  ## . * * ##
   ##  * $ #
   #      ##
    #######
Solution: undefined

;39
    #######
   #       #
  # #$ $ $  #
 #  $  ### $ #
 # #$$   # $ #
#   $  # $ #  #
# # $ #.#  $  #
#   ##...# #  #
 # # ..... $ #
 # # #...# # #
  #   #.  # #
  # #    #  #
   #   @   #
    #######
Solution: undefined

;40
    #######
   #       #
  # $$$$... #
 #   $  .##$ #
 # #####.#.$ #
#   #....#.   #
# #  .#....#  #
 # #  #.###  #
 # $ ##..  $ #
 #  $   #$$$ #
  #  $$#  $ #
  #  $ $ $  #
   #   @   #
    #######
Solution: undefined

;41
    #######
   ## # #  #
  #        ##
 #  $$$$$$$  #
 # $ #...# $ #
##  ###.###  ##
## $ #...# $ ##
 # $...#.# $ #
 # $##.#.. $ #
 #   #.#..$  #
  #$ #.$.#  #
  #   ### $ #
   #   @   #
    #######
Solution: undefined

;42
    #######
   ######  #
  ## $ $   ##
 #    $ $    #
 # $ ##.##  ##
#   ###.#######
#  $ ##.##   ##
 #  $.....$# #
 # $#*.*.* $ #
 #  $..#*.$  #
  #$ #. *#  #
  #   ### $ #
   # # @   #
    #######
Solution: undefined

;43
    #######
   #   #####
  ## $ $    #
 ## $ $ $ $  #
 #    #.##  ##
## $###.#######
##   #.. #   ##
 #  $..#. $# #
 # $#*.#.* $ #
 ## $..#..$  #
  #  #.$.#  #
  #   ### $ #
   #   @   #
    #######
Solution: undefined

;44
    #######
   #  ###  #
  ## $ $    #
 # $  $ $ $  #
 #    #.## $ #
#  $###.### $ #
#  $ ##.##    #
 #  $..... ###
 # $#*...* $ #
 #  $..#.#   #
  #$ #. .#$ #
  #   # #   #
   # # @ # #
    #######
Solution: undefined

;45
    #######
   ## # #  #
  ##   $ $  #
 # $  $ $ $  #
 # $ $#.## $ #
#  $  #.  #   #
#  $ ##.##  # #
 #  $..*.. # #
 #  #*.*..  ##
 ## $..#.#$  #
  #$ #. .#  #
  #   # # # #
   # # @   #
    #######
Solution: undefined

;46
    #######
   #  # # ##
  ##$ $     #
 #    # $ $  #
 # $$ #   #$ #
#   # # # # $ #
#    #####    #
 #$$$...*. # #
 #  #.....  ##
 #   #.#.#$  #
  #$ #. .#  #
  #   ### # #
   #   @   #
    #######
Solution: undefined

;47
    #######
   ######  #
  ## $ $    #
 # $  $ $  $ #
 #    #.##   #
#  $###.### $ #
#  $ ##.##    #
 #  *....#####
 # $#*...* $ #
 #  $..#.#   #
  #$ #.$.#$ #
  #   ###   #
   #   @   #
    #######
Solution: undefined

;48
    #######
   # # # # #
  #  #     ##
 # #   $ $   #
 #  ###*###$ #
##    #.#    ##
## $$##.## $ ##
 #  $..... ###
 # $##.$.* $ #
 #  $..#*.$  #
  #  #. .#  #
  # $ ### $ #
   #   @   #
    #######
Solution: undefined

;49
    #######
   ## # # ##
  ##        #
 #   $ $ $ $ #
 # ####*#### #
#  $  #.#    ##
#  $ #.. # $ ##
 # $ ..*.. ###
 # $##*#.* $ #
 #  $..#.#   #
  #  #. .#  #
  # $ ### $ #
   #   @   #
    #######
Solution: undefined

;50
    #######
   #  #  # #
  #  #     ##
 #     $ $ $ #
 ### ##*###$ #
## $  #.#    ##
## $ #.. # $ ##
 # $...*.# ###
 # $##*#.* $ #
 #  $..#.#   #
  #  #. .#  #
  # $ # # $ #
   #   @   #
    #######
Solution: undefined

;51
    #######
   # # # # #
  #  #     ##
 #     $ $ $ #
 ### ##*###$ #
## $  #.#     #
## $ #...# $  #
 # $...*.# #$#
 # $##*#.* $ #
 #  $..#.#   #
  #  #. .#  #
  # $ # # $ #
   #   @   #
    #######
Solution: undefined

;52
    #######
   ## # # ##
  ##        #
 #   $ $ $ $ #
 # ####*#### #
# $   #.#   $ #
#    #.. #    #
 #  $..... #$#
 # $#$.#.. $ #
 #  $..#*#   #
  #  #. .# $#
  # $ ### $ #
   #   @   #
    #######
Solution: undefined

;53
     #######
   ## # # ##
  ##        #
 #   $ $ $ $ #
 # ####.#### #
# $   #.#   $ #
#   $#.*.#    #
 ##  ....* #$#
 # $$#*#.. $ #
 #  $..#.#   #
  #  #. .# $#
  # $ # # $ #
   #   @   #
    #######
Solution: undefined

;54
    #######
   #   # # #
  #    *    #
 # ### # ### #
 #  *     *  #
## # ####### ##
## #       # ##
 # ####### # #
 # #       # #
 #  #  $  #  #
  #  # . #  #
  #   ###   #
   #   @   #
    #######
Solution: undefined

;55
    #######
   #   #   #
  #    *    #
 # ## ### ## #
 #  *     *  #
## #### #### ##
## #       # ##
 # ####### # #
 #  #     $# #
 ##          #
  #  #   ####
  #.  ###   #
   #   @   #
    #######
Solution: undefined

;56
    #######
   # # #   #
  #    *    #
 # ## ### ## #
 #  *     *  #
#  #### ### # #
#       # #   #
 #  #       ##
 #  # ##  #  #
 #   ##.     #
  #   #######
  #    $    #
   #   @   #
    #######
Solution: undefined

;57
    #######
   #   # # #
  #    *    #
 # ### # ### #
 #  *     *  #
## # ####### ##
## #   $   # ##
 # #$ $#$ $# #
 # #   #   # #
 #    $#$    #
  ##   #   ##
  #  .###.  #
   # ..+.. #
    #######
Solution: undefined

;58
    #######
   #   #   #
  #    *    #
 # ## ### ## #
 #  *     *  #
## ####$#### ##
## #       # ##
 # #$ #$# $# #
 # #  # #  # #
 #   $# #$   #
  ##   $   ##
  #  .###.  #
   # ..+.. #
    #######
Solution: undefined

;59
    #######
   #   # # #
  #    *    #
 # ### # ### #
 #  *     *  #
## #$####### ##
## #   $   # ##
 # #$ ### $# #
 # #  # #  # #
 #   $# #$   #
  ##   $   ##
  #  .###.  #
   # ..+.. #
    #######
Solution: undefined

;60
    #######
   #   # # #
  #    *    #
 # ### # ### #
 #  *     *  #
## #$#####$# ##
## #  #  # # ##
 # #$ $    # #
 # #  ###  # #
 #   $# $    #
  ##  #   ###
  #  ####.  #
   # ..+.. #
    #######
Solution: undefined

;61
    #######
   #   #   #
  #    *    #
 # ## ### ## #
 #  *     *  #
##  ###$###$ ##
##$ #...     ##
 #  #. . # # #
 # ##...#  # #
 #.  ###   # #
  # $$   $$ #
  #  $###$  #
   #   @   #
    #######
Solution: undefined

;62
    #######
   #   #   #
  #    *    #
 # ### # ### #
 #  *     *  #
## #$##$#### ##
##         # ##
 ###$#...  # #
 #   #.$.##  #
 ## $#...#   #
  #   ###   #
  #  $ $ $  #
   #   @   #
    #######
Solution: undefined

;63
    #######
   #   #   #
  #    *    #
 #  ### ###  #
 #   *    *  #
#  ## #### ## #
#  $ $#..# $  #
 # $  #..#$  #
 #  $*...# $##
 #   ##...$  #
  #$  #..#  #
  # $$ ###$ #
   #   @   #
    #######
Solution: undefined

;64
    #######
   # # # # #
  #  *   *  #
 #   # # #   #
 #   #   #   #
#  ## # # ##  #
#     $$      #
 #  # *..## ##
 #  $ **.# # #
 #  # *..    #
  # # $$  # ##
  # ### ### #
   #   @    #
    ########
Solution: undefined

;65
    #######
   #       #
  #### ### ##
 #   *   *   #
 # ## ### ## #
#   ...#      #
# # ...#$$$$$ #
 #  ...#     #
 #  . ##$#$ $#
 ## #    #   #
  #   #     #
  #   #$##$ #
   # # @   #
    #######
Solution: undefined

;66
    #######
   # *   * #
  #  # # #  #
 #  #     #  #
 # #  ###### #
## # ##  # #  #
## #  #  #  # #
 # #$ #$   $# #
 # #  #  #  # #
 #   $  $#    #
  ##  #  # ####
  #  #####  #
   ##..+..  #
    ########
Solution: undefined

;67
    #######
   # *   * #
  #  # # #  #
 #  # * * #  #
 # ##  #  ## #
#  #  * *  #  #
#  # $   $ #  #
 # #$#####$# #
 # # $ $ $ # #
 #           #
  ### #   # #
  #  .##### #
   # ..+...#
    ########
Solution: undefined

;68
    #######
   # *   * #
  #  # # #  #
 #  # * *##  #
 # #  #   #  #
#  # ##    #  #
#  # # ### #  #
 # # # # $ # #
 # #       # #
 #    $# $   #
  ###  #  # #
  #   ##### #
   #  .+.  #
    ########
Solution: undefined

;69
    #######
   # *   * #
  #  # # #  #
 #  # * *##  #
 # #  #   #  #
#  # ##    #  #
#  # # ### #  #
 # # $ # $ # #
 # #     $ # #
 #    $# $   #
  ###  #  # #
  #   ##### #
   #  .+...#
    ########
Solution: undefined

;70
    #######
   #  #.#  #
  #  #  .#  #
 #  #. $ .#  #
 # #. #*#  # #
#  . $.$.$ .  #
# ##  #.# .## #
 #  #. $ .#  #
 #   #.  #   #
 # $  #.#  $ #
  # $ $ $ $ #
  #  $$ $$  #
   #   @   #
    #######
Solution: undefined

;71
    #######
   #   @   #
  #  $ $ $  #
 #  $ $ $ $  #
 # $ $  ### ##
# $######  #  #
#      ...    #
 ##### ##* # #
 # $  .*.. # #
 #   #*### # #
  #   .*..  #
  #   $##*  #
   #   ... #
    #######
Solution: undefined

;72
    #######
   #   @   #
  # $ #$$$$ #
 # $  $    $ #
 #   # $ #   #
# #### ####   #
#    # *.. #  #
 #   # *## # #
 #     ..* # #
 #   # *.* # #
  # ## ##* ##
  # #  *.*  #
   #   ... #
    #######
Solution: undefined

;73
    #######
   #  # #  #
  #  #  # $ #
 #   #..  $ ##
 # $ #.*# #  #
#  $ #..# #$  #
# $$ #*.# $   #
 # # #..# $$ #
 # # #.*# $  #
 #   #..# $  #
  #$ #*.# $ #
  #   ..#   #
   #   @#  #
    #######
Solution: undefined

;74
    #######
   #   @   #
  #  $$$ $  #
 #  $  $$ $  #
 # $$   $ ## #
#  #  ####..# #
#  # ..*.*.*..#
 #  #..*.....#
 #   # #######
 #  # $   $  #
  # #    $  #
  #  #####$ #
   #       #
    #######
Solution: undefined

;75
    #######
   # .  $  #
  #  .# $   #
 #  #.### $  #
 # $#.#  ##$ #
#   #.#   $   #
#  $#.# $##$  #
 #  #.   #   #
 # $ .#  #   #
 #  #.##$$ # #
  # #.#  # ##
  # #.#     #
   ##.# @# #
    #######
Solution: undefined

;76
    #######
   ##      #
  # $ $ $   #
 #   $ $ $$  #
 # $  $ $ $  #
# $$$$ $ $ #. #
#  $  $ $ #.. #
##  $  $ #... #
 # $$$  #....#
 #  $  #....##
  #   #....##
  ## #....# #
   ##..+.# #
    #######
Solution: undefined

;77
    #######
   #       #
  #    $$   #
 #    #  $   #
 ##$### $ $###
##....#  $ $  #
##....##$ $   #
 #.#..## $ $ #
 #....# $ $  #
 #....#  $ $ #
  ## ##$# $ #
  #    $ #  #
   #   @   #
    #######
Solution: undefined

;78
    #######
   #       #
  #  ....# ##
 ##$#....#   #
 #  $..#.#   #
#  $#....$   ##
#   ######    #
 # $     #  ##
 # ## ##$ ## #
 #   $ $ $#  #
  # $ $ $ # #
  #  $ $ $  #
   #   @   #
    #######
Solution: undefined

;79
    #######
   #       #
  #  ##$#$$ #
 #      #    #
 #  $ #$#$$$ #
## #.#..#     #
##  .#.* $$$  #
 # #. ..#    #
 # #.#..#$$$ #
 # #.#.*     #
  ##.#..#$$$#
  # *###    #
   #.  @   #
    #######
Solution: undefined

;80
    #######
   #       #
  ####.#.$  #
 #   #.#.# $ #
 #$# #.#.# $ #
#  $  .#.##* .#
#...*.*.......#
 ##$######## #
 #   $ $ $ # #
 #  $ $ $ $  #
  # $ $ $ $ #
  #  $ $ $  #
   #   @   #
    #######
Solution: undefined

;81
    #######
   #   #   #
  #  $  $  ##
 #  $$$$$$#  #
 #   $  $   $#
# ## # ##   $ #
#  #...  #    #
 #  ...#  ## #
 # ##.##$#  ##
 #  ...      #
  ##...#    #
  #  # #  # #
   #   @  ##
    #######
Solution: undefined

;82
    #######
   #       #
  #  ### $  #
 # #    # $  #
 #   $  #$# ##
#  $ #  # #   #
# $$$#$$$ # # #
 # $   @# .. #
 #  ######.. #
 ####  # # ###
  #.. ..    #
  #.. .. #  #
   #   #   #
    #######
Solution: undefined

;83
    #######
   #   #   #
  #    **   #
 # $$  * *   #
 # $ $ * *   #
#  $ $ * *    #
#  $ $ * *    #
 # $$  **    #
 #  ** # ..  #
 #  * * #. . #
  # * * #. .#
  # * *  . .#
   #** @#..#
    #######
Solution: undefined

;84
    #######
   #   @   #
  #  $ $ $  #
 #  $ $ $ $  #
 # $ $ $ #####
#  $  $ $#... #
#  $$$ $ #.#. #
 #$  ### #.#.#
 # $ #  .....#
 #   # #.#.  #
  # ## #.#.##
  #  #  ... #
   # # ##  #
    #######
Solution: undefined

;85
    #######
   #       #
  # $$$ # # #
 #  $ $ #... #
 # $$ $ #.#. #
#   $ ## .#.$ #
#  ## ......  #
 #  #$.#.###$#
 # $  .#.#   #
 # $ #... $ ##
  # $ ###$  #
  #  $ $ $ ##
   #   @   #
    #######
Solution: undefined

;86
    #######
   #      ##
  #     # $ #
 # ###.#.$#  #
 #  ...#.  # #
# $ #....*.#  #
#   #.######  #
 #$##......$ #
 #  $ #####$ #
 #  $ $ $ $  #
  # $ $ $ $ #
  #  $ $ $  #
   #   @   #
    #######
Solution: undefined

;87
    #######
   #       #
  # $$#     #
 #  $   ##   #
 ## $$ #  ####
#   $  # .....#
#   $$ # .....#
 ##$$   #..###
 #  $$ ##..  #
 #  $   #..# #
  # $$#   # #
  # $       #
   #   @ # #
    #######
Solution: undefined

;88
    #######
   #   @   #
  #   ###   #
 # $$#...#   #
 #  $.....#  #
#  $$# . # $  #
#   $ #.#  $  #
 # $$ #..  $ #
 #  $ ..## $ #
 #  $ #.## $ #
  # $ #.#  $#
  # $ #.#   #
   #  #.#  #
    #######
Solution: undefined

;89
    #######
   #    @  #
  #  $ ###  #
 #  $$#...#  #
 # $ $.....  #
#  $ $# . #   #
#  $ $ #.#    #
 # $ $ #..   #
 # $ $ ..##  #
 #  $$ #.#   #
  #  $ #.#  #
  #  $$#.#  #
   #   #.# #
    #######
Solution: undefined

;90
    #######
   #...... #
  #....... .#
 # $# # # ## #
 # $  $ #    #
#  $#####     #
#  $ $ ****   #
 # $ $ *  *# #
 # $ $  **   #
 # $ $    $  #
  #  $**    #
  #   * *   #
   #  @* * #
    #######
Solution: undefined

;91
    #######
   #  #  # #
  #  $#$  # #
 #.#  $  #   #
 #.## $ #    #
#...# # $$ #  #
#...# # #     #
 #.     # ## #
 #.  ####    #
 #  #    #   #
  # # $$   ##
  #  $$ ##  #
   #   @   #
    #######
Solution: undefined

;92
    #######
   #  #  # #
  #  $#$  # #
 #.#  $  #   #
 #.## $ #  $ #
#...# # $$ #$ #
#...# # #     #
 #.     # ## #
 #.  ####  $ #
 #  #   .# $ #
  # # $$.. ##
  #  # $##  #
   #   @   #
    #######
Solution: undefined

;93
    #######
   #   @   #
  #  $$$$$  #
 #  $     $  #
 #$ $$$$$$$  #
#       # #$# #
#   #####...  #
 ####   $.#. #
 #   ##.*.*. #
 #  # $.#.$###
  # #.*...  #
  #  .#.### #
   # ...   #
    #######
Solution: undefined

;94
    #######
   #       #
  #  $$$ $  #
 #  $ $ $    #
 # ##   $$ ###
# #  #### #   #
#     .... * ##
 ## *#*##*#  #
 #   #.##.#* #
 ## * .*.+   #
  #  # ## #  #
  ###  * * ##
    #      #
    #######
Solution: undefined

;95
    #######
   ##   #  #
  # #.  $$ ##
 # $..# #  # #
 # # ####  # #
#   .$   #    #
## ### # ### ##
 #   ##    # #
 ##  $  $$.# #
 ###$### #   #
  #  @#  #  #
  #    # #  #
   # ... # #
    #######
Solution: undefined

;96
    #######
   #       #
  # # $ $ ###
 #  # $ $@ # #
 #   #### #  #
## #   .* $* ##
##  *#.##.#  ##
 #   #.##.#* #
 # #*$ ..    #
 #   # ##$#  #
  # #  * * ##
  ##  #  #  #
   ##      #
    #######
Solution: undefined

;97
     ##             ##
   #######       #######
  #  #    ##   ##       #
 ##  # #$   ###   $ $ $  #
#  $ # $ $ $ # $ $ $ # $  #
#   ###.*.#  #  #.*.### $ #
## $###.*.*# # #.....#.$ ##
##$ .....# # @ # ###... $ #
## $###....# # #.....#.$ ##
##$ ###.*.# ### ###.### $ #
##   # $#$        #$ # $  #
 ## $ $ $ $ ### $ $ $ $  #
  #       ##   ##       #
   ##  ###       #######
     ##             ##
Solution: undefined

;98
    #######
   #   #####
  ## $ $    #
 ## $ $ $ $  #
 #    #.##  ##
## $###.#######
##   #.. #   ##
 # $$..#. $# #
 #  #*.#.* $ #
 ## $..#..$  #
  #  #.$.#  #
  #   ### $ #
   # #     #
   # ## ## #
   #   @ # #
  # $ ###   #
  #  #.$.#  #
 #  $..#..$ ##
 # $ *.#.*#  #
 # #$ .#..$$ #
##   # ..#   ##
#######.###$ ##
 ##  ##.#    #
 #  $ $ $ $ ##
  #    $ $ ##
   #####   #
    #######
Solution: undefined

;99
    #######
   #   #####
  ## $ $    #
 ## $ $ $ $  #
 #    #.##  ##
## $###.#######
##   #.. #   ##
 # $$..#. $# #
 #  #*.#.* $ #
 ## $..#..$  #
  #  #.$.#  #
  #$  ### $ #
 # $.#  $   .#
 # #.##@##.# #
 #.   $  #.$ #
  # $ ###  $#
  #  #.$.#  #
 #  $..#..$ ##
 # $ *.#.*#  #
 # #$ .#..$$ #
##   # ..#   ##
#######.###$ ##
 ##  ##.#    #
 #  $ $ $ $ ##
  #    $ $ ##
   #####   #
    #######
Solution: undefined

;100
    #######       #######
   # *   * #     # # # # #
  #  # # #  #   #  #     ##
 #  # * * #  # #     $ $ $ #
 # ##  #  ## # ### ##*###$ #
#  #  * *  # ### $  #.#    ##
#  #   $   #     $ #.. # $ ##
 # #$#####$# ### $...*.# ###
 # # $ $ $ # # # $##*#.* $ #
 #           # #  $..#.#   #
  ### #   # #   #  #. .#  #
  #   ##### #   # $ # # $ #
   # ......#     #   @   #
    ########      #######
Solution: undefined

;101
    #########
   ##   @   ##
  ##  ##$##  ##
 ##  ##   ##  ##
 #  ##  $  ##  #
## ## .$ $. #  ##
## # .*.$.*. # ##
## $ $.$ $.$ # ##
 # #  $ * $  # #
 # ##  $.$  ## #
 #  ##  *  ##  #
 ##  #.   .#  ##
  ##  #...#  ##
   ## ## ## ##
    #       #
    #########
Solution: undefined

;102
    #########
   ##   @   ##
  ##  ##$##  ##
 ##  ##   ##  ##
 #  ##  $  ##  #
## ## .$$$. #  ##
## # .*.$.*. # ##
## $ $.$ $.$ $ ##
 # #  $$*$$  # #
 # ##  *.*  ## #
 #  ##  $  ##  #
 ##  #.....#  ##
  ##  #...#  ##
   ## ##*## ##
    #       #
    #########
Solution: undefined

;103
                  #######
                 #       #
                #### ### ##
               #   *   *   #
               # ## ### ## #
              #      #      #
              # #    #$$$$$ #
               #.....#     #
               #....##$#$ $#
               ## #.   #   #
                #   #     #
                #   #$##$ #
                 # #     #
    #######       ### ###       #######
   # #   # #    ##   @   ##    #       #
  #  # # #  #  ##  ##$##  ##  #   $ $ $ #
 #   #$$     # #  ##   ##  ###  $ #####  #
 # #.  $$#.# ##  ##  $  ##  ## $$# $     #
# $#.# # #.#$ # ## .$ $. #  #      $ #....#
#   .#   #.     # .**$**. #    #  # ##....#
# $#.#####.#$ # $ $.$ $.$ $ ## $ #    #..#
 # #.    #.# ## #  $ * $  # ## $$#    #..#
 #   #$# #   ## ##  ***  ## ##  $ ## ##..#
  #### $ ## # #  ##  $  ##  # # $ #    ##
  #  #   #  #  #  #.....#  ## #   # $   #
   #   #   #   ##  #...#  ##   #   ##  #
    #######     ## ##*## ##     #######
                 #       #
                  ### ###
                 #       #
                #  $ $ $  #
               # $ $$$$ $  #
               # #     ##  #
              #  # ####  #  #
              #      ... #  #
               ##### ##* # #
               # $  .*.. # #
               #   #*### # #
                # $ .*..  #
                #   $##*  #
                 #   ... #
                  #######
Solution: undefined

;104
    #######
   #   #   #
  #    *    #
 # ## ### ## #
 #  *     *  #
#  ####### #  #
#  #@#.$      #
 # #   #  ####
 # ##### ### #
 #   *   *   #
  # ##### # #
  #    *    #
   #   #   #
    #######
Solution: undefined

;105
    ###   ###
    #.#   #.#
    #$#####$#
    #   #   #
####    *    ####
#.$ ## ### ## $.#
###   *    *  ###
 #  ### #####  #
 #  #@#.$   #  #
  # #   #   # #
  # ### ##### #
  #   *   *   #
 ### ##### # ###
 #.$    *    $.#
 ####   #   ####
    #$#####$#
    #.#   #.#
    ###   ###
Solution: undefined

;106
             #######       #######
            # # #   #     #   #   #
           #    *    #   #    **   #
          # ## ### ## # # $$  * *   #
          #  *     *  # # $ $ * *   #
         #  #### ### # #  $ $ * *    #
         #        #    #  $ $ * *    #
          #  #       ## # $$  **    #
          #  # #### # # #  **   ..  #
     ##   #   ##.     # #  * * #. . #
   ##  ### #   ##### #   # * * #. .#    ##
  #       ##    $    # # # * * #. .# ###  ##
 # #   #    #       ## #  #**  #..###       #
#  #  **    *### ### # # # ### ####   $ $  # #
#..   * *  * #   #   # #         # $ $#$$ #   #
#..###* * * *### # # # #### ######  #.#.# # ###
#..  #**  **   # # # #     #     # #....###   #
#..#$#       # # # # ##### # ###   # #$...*$ ##
#..  #$$$$   # #   #   #   #    ## #.*..###   #
#..# #       #  ###    *    ### ##  #.*.# #$ ##
 # $$$$$$$  # #    ## ### ##     # $ $    #   #
  #       ##   ###   *    *  #### #   $#$ $ ##
   ##  ###   #  #  ### #####  #    ##  #    #
     ##    ## # #  #@#.$   #  # ##   #######
   ##  ###    #  # #   #   # #  # ##    ##
  #       ##   # # ### ##### # #     #######
 #   ## $   #  #     *   *     # # ##.  $   #
#  # # $ $ $ #  ### ##### # #  #  #   #    # #
#  #*  ##.## ##   #    *    ###  #  $ ####*#  #
#  # ##....# # ##  #   #   #    ## $ #...#    #
##*  #.....#   # # # ##### # ### #  $#. .# #  #
#  # ###.##  #     # #     #       $ #...$ #*##
#  #* $ *# $ ####### # ###########  $ #  # #  #
#  # #  $  $ #       # #         # # $ # #    #
 #   #$$  $ #### ### # # # ### ###       #*#  #
  # #     ###       #  #  #       #  ### $ # #
   ##  ### #  #####$ # # #  $$ $$  ##       #
     ##    # #    $  #   # $ $ $ $ # #######
          #  #  $  $  # # $  #.#  $ #   ##
          #   # ####### #   #.  #   #
          #  #..*.....# #  #. $ .#  #
         #  # ..*.*.*..# ##  #.# .## #
         #  #  ####..# #  . $.$.$ .  #
          # $$   $ ## # # #. #.#  # #
          #  $  $$ $  # #  #. $ .#  #
           #  $$$ $  #   #  # $.#  #
            #       #     #  #.#  #
             #######       #######
Solution: undefined

