;1
########
#      #
# $##  ###
#   ## $ ##
#@  .#$ $ #
###.      #
  #..######
  ####
Solution: 6-3d1,7-5l2,4-4d1,9-4l1,8-3l1d1,8-5l4,3-4d1,6-2d2,7-5l3,2-1d2,1-4r2

;2
   #####
####   #
#  $ $ ##
# $ $#  #
# $$ #$ #
#  # $  #
#  # #  #
##@ .#..#
 ##.....#
  #######
Solution: 4-2d5,5-8l1,6-3d4,7-8l1,4-5r2,7-4d3,4-2r1,6-1d3,5-5r1,7-4d2,2-2r3,6-1d6,1-3r2,4-4u1,3-2r2,6-1d5,2-5u1r1,4-3d4,1-3r2,4-2d4

;3
              ####
             ## .#
##############  .#
#     $         .#
# $# $ $ $ $### *#
# $  #####  # #*##
# # $#.. #$## #. #
#  $ #..$   $.#. #
# $# #..  $ # #. #
# $  ######## ####
# #  $    $   #
#  ..#### @ ###
###..#  #####
  ####
Solution: r1u1r2u3l2d1l2u1l2d1l1u1r3d1r2u1l3r1d1l2u1,6-10l2u1l1d2,5-3r9u1r2d1l1d3u3l11d8,15-8u5l1u1r1d1r1u1,2-3r13,1-5r2d1r1l1u1l1u1l1u1r13u1r1d4r1d2l1u5l1u1r1,4-6u2d1l2u2r12u1r1d5,2-7r1u1r1d4l1d1l2u2r2d1r1u6d1l2u2r12u1r1d4,2-9u1l1u1r2l1d2r2u5d1l2u2r12u1r1d3,10-5d2r1d1l3,11-10l7u1l1d1,8-4r1u1r1d3,11-7l4,6-4r3u1r1d3,11-7l3r2u2r1u1l1u1r4u1r1d2,4-4r5u1r1d3,9-7r3

;4
                       ####
######              ####  #
#  # ################     ##
#    #  #     ##....       #
#  #  $  $  # ###...   ##  #
#  $  #  # $  ####..#   ..##
#  # $  $  #  #####.  ## .#
#    #  #  $  ######@##  ##
## $   $   ## ########    #
 # # $ #  $ # #######    ##
 #   # $  # # ######    ##
 #     # $  # #####    ##
 ########## # ####    ##
 #          # ###    ##
 #            ##    ##
 ## ###########    ##
 #  #             ##
 #           #   ##
 ##########  #####
          ####
Solution: 11-9l1,8-11r2,11-10d3,12-14l8u1l1d3l1d1r9d1r1u1l1u1r4d1r1u1l1u1r1d1r1u1l1u1r1,9-8d2l1d1r2l1u2r2d4,12-14l8u1l1d3l1d1r9d1r1u1l1u1r4d1r1u1l1u1r1d1r1u1r1u1,12-5l1u1l1d4l1d3r2u2l1u1l1d2l1d1r2l1u2r2d4,13-12d2l9u1l1d3l1d1r9d1r1u1l1u1r4d1r1u1,12-7l2u1l1d4l1d1r2l1u2r2d4,13-10d4l9u1l1d3l1d1r9d1r1u1l1u1r4u1r1u1r1u1r1l1d1l1d1l1d2r1u1r1u1r1u1r1u1,8-8l2d2r2u1r1d1l1d1r2l1u2r2d4,13-13d1l9u1l1d3l1d1r9d1r1u1l1u1r4u1r1u1r1u1r1u1r1l1d1l1d1l1d1l1d2r1u1r1u1r1u1r1u1r1u1,9-6l1u1l1d2l1d1r2l1u2r2d4l1d1r2l1u2r2d4,13-13d1l9u1l1d3l1d1r9d1r1u1l1u1r4u1r1u1r1u1r1u1r1u1r1l1d1l1d1l1d1l1d1l1d2r1u1r1u1r1u1r1u1r1u1r1u1,4-8r4l1u2r2d4l1d1r2l1u2r2d4,13-14l9u1l1d3l1d1r9d1r1u1l1u1r4u1r1u1r1u1r1u1r1u1r1u1r1,16-17u1r1u1r1u1r1u1r1u1r1u1r1u1,4-9r1l1d2r2u2l1u1r3l1u2r2d4l1d1r2l1u2r2d4,12-14l8u1l1d3l1d1r9d1r1u1l1u1r4u1r1u1r1u1r1u1r1u1r1u1r1u1r1,16-17u1r1u1r1u1r1u1r1u1r1u1r1u1r1u1,8-4r1u1r1d3u1r2d2l2u1l1d4l1d1r2l1u2r2d4,12-14l8u1l1d3l1d1r9d1r1u1l1u1r4u1r1u1r1u1r1u1r1u1r1u1r1u1r1u1r1,16-17u1r1u1r1u1r1u1r1u1r1u1r1u1r1u1r1u3r1u1l3u1l3d2r2u1r1u1l3u1l1d1,4-6r5l1u2r2d2u1r2d2l2u1l1d4l1d1r2l1u2r2d4,12-14l8u1l1d3l1d1r9,2-8r6d1r2u2l1d3l1d1r2l1u2r2d4,12-14l8u1l1d3l1d1r7,2-5r2u1r1d1l1d1r3d2r2u2l1u1l1d2l1d1r2l1u2r2d4l1d1r2l1u2r2d4,13-14l9u1l1d3l1d1r5,5-4r1u1r1d4l1d1r2d1r2u2l1d3l1d1r2l1u2r2d4,12-14l8u1l1d3l1d1r3,15-15r1u1r1u1r1u1r1u1r1u1r1u1r1u1r1,17-16u1r1u1r1u1r1u1r1u1r1u1r1u1r1u3r1u1l3u1l3d2r2u1r1u1l4,12-18u1l1u1r4d1r1u1,9-17r2d1r1u1l1u1r4u1r1u1r1u1r1u1r1u1r1u1r1u1r1u1r1,16-17u1r1u1r1u1r1u1r1u1r1u1r1u1r1u1r1u3r1u1l3r3u2l6d3r2u1r1u1l3,7-17r4d1r1u1l1u1r4u1r1u1r1u1r1u1r1u1r1u1r1u1r1u1r1,16-17u1r1u1r1u1r1u1r1u1r1u1r1u1r1u1r1u3r1u3l3d2r2d1r1u2r1u1l3u1l1d1,5-17r6d1r1u1l1u1r4u1r1u1r1u1r1u1r1u1r1u1r1u1r1u1r1,16-17u1r1u1r1u1r1u1r1u1r1u1r1u1r1u1r1u3r1u3l4d2r3d1r1u2r1u1l9,15-15r1u1r1u1r1u1r1u1r1u1r1u1r1u1r1,17-16u1r1u1r1u1r1u1r1u1r1u1r1u1r1u3r1u3l4d2r3d1r1u2r1u1l8,22-5u1l1u2r2d1l1u1l1d1r1d1l2u1d1u1l1d2,16-14r1u1r1u1r1u1r1u1r1u1r1u1r1,18-15u1r1u1r1u1r1u1r1u1r1u1r1u3r1u3l3d2r2d1r1u2r1u1l4u1l1d1r1d1l2u1l1d1,17-13r1u1r1u1r1u1r1u1r1u1r1,19-14u1r1u1r1u1r1u1r1u1r1u3r1u3l3d2r2d1r1u2r1u1l4u1l1d1r1d1l2,18-12r1u1r1u1r1u1r1u1r1l1d1l1d1l1d1l1d2r1u1r1u1r1u1r1u1r1u3r1u3l3d2r2d1r1u2r1u1l7,19-11r1u1r1u1r1u1r1l1d1l1d1l1d2r1u1r1u1r1u1r1u3r1u3l3d2r2d1r1u2r1u1l6,20-10r1u1r1u1r1l1d1l1d2r1u1r1u1r1u3r1u3l3d2r2d1r1u2r1u1l3u1l1d1,21-9r1u1r1l1d2r1u1r1u3r1u3l4d2r3l3u2r4d2l4u2r1d1l1d1r3d4l2u1r1d1r1u3

;5
 ########
 #   #  #
 ##  $  #
 #.. #  #
 # .##$###
#####  ..#
#  $  $ .#
# $ $  ###
#@  ####
#####
Solution: 3-7r1,5-6r2,6-7l1,4-6l1,1-6r4,6-7u1,5-5r2,5-7l1,3-8u1,2-6r3,6-7u1,5-5r1u2,6-1d1l2,3-1d1,4-3l1,6-2d3,6-7u4,7-2l3,3-1d2,2-8u1,1-6r4,6-7u4,7-2l3,3-1d1

;6
##########
# ...... #
# .##### #
##  #  #$##
#  ##$    ##
##     # $ ##
#  # ### # @#
##     #$$ ##
 ##  #   $ #
  ##    $# #
   #####   #
       #####
Solution: 10-8l3,5-3d1,6-5l2,8-8u3,10-5l1,9-4l3,5-3d1,8-2d1,9-4l3,4-5l1,2-6u4,1-1r5,6-5l3,2-6u4,1-1r4,5-3d1,6-5l3,2-6u4,1-1r3,8-6u1,9-4l3,5-3d1,6-5l3,2-6u4,1-1r2,10-7l1,8-8u3,9-4l3,5-3d1,6-5l3,2-6u4,1-1r1,8-10u5,9-4l3,5-3d1,6-5l3,2-6u4,6-7d1,5-9r2,8-10u5,9-4l3,5-3d1,6-5l3,2-6u3

;7
          #####
 ######## # # #
 #      ###   #
 #   $  ##  $ #
 ##$### ###$# #
 #   #  ##    #
 # # #$    $ ##
 ###    ##  ##
###  ####  ##
#.  . .#  $ #
##  # ## $ ##
#.  . .#  ##
###.@.#####
  #####
Solution: 3-5u1,4-3r1,2-3r1,6-5d1,7-7l2,4-6d2,5-9l1,3-8d2,4-11l2,12-6l5,6-5d1,7-7l2,4-6d2,5-9l3,9-11u1,10-10u3,11-6l4,6-5d1,7-7l2,4-6d2,5-9l1,3-8d2,2-11r3,8-9r1,10-10u3,11-6l4,6-5d1,7-7l2,4-6d2,5-9l1,3-8d2,2-11r2,5-10d1,11-3d2,12-6l5,6-5d1,7-7l2,4-6d2,5-9l1,3-8d3,13-3l1,11-2d3,12-6l5,6-5d1,7-7l2,4-6d2,5-9l1,3-8d2,2-11r1,5-3r1,7-2d3,6-6r4,12-6l5,6-5d1,7-7l2,4-6d2,3-9r2,3-3r3,7-2d3,6-6r4,12-6l5,6-5d1,7-7l2,4-6d2

;8
    ######
    #    #
    # ## ####
#####  $    #
#   # ##$## #
#  $     $  #
#  # $   #$ ####
## #### ##     #
## #..# $  # $ #
## #..####   # #
#  #..#  # $ $ #
#  ...#  #$#$  #
#  ...#    $   #
####.+#  $   # #
   ####  # ### #
      ####     #
         #######
Solution: 2-5r4d1r2u1l5u1l1d6l1d1r3d1r1u3,10-5l7u1l1d6l1d1r2d1r1u3,10-7u1r1u1l8u1l1d6l1d1r3d1r1u2,8-3d1u1r3d2l8u1l1d6l1d1r2d1r1u2,6-3r1l2u2r3d3u1r3d2l8u1l1d6l1d1r3d1r1u1,12-12u4d3r2u4l3r1d2l2u3r1u1l8u1l1d6l1d1r2d1r1u1,10-12u6r1u1l8u1l1d7l1d1r2u1r1d1,12-12l1d1l1u7r1u1l8u1l1d7l1d1r3u1r1d1,8-13r1,10-14u8,11-5l8,2-4d7,1-12r3,12-10l1,10-11u5,11-5l8,2-4d7,1-12r2,14-10l3,10-11u5,11-5l8,2-4d7,1-12r1,7-8r2,10-9u3,11-5l8,2-4d6,1-11r3,4-6r2,7-7u1,8-5l5,2-4d6,1-11r2,14-8l1,12-9u1,13-7l2,10-8u2,11-5l8,2-4d6,1-11r1

;9
##########
#        #############
#  $ #        #      #
##$######  #  ### ## #
#         ###      $ #
# ## # #    $   ######
#  #     ####  ##   ##
## # ##    #####  #  ##
#  # #  #        ###  ##
#       ## ### # # ## @#
#  ###  #   #    # #  ##
##   # ##      # #   ##
 ##        ##### #  ##
  ##  #### #. .    ##
   ##      # . .  ##
    ################
Solution: 13-5l4,8-4d2,9-7l1,7-8u1,8-6l3,4-5d3,3-9r2,6-8d3,5-12r4,10-13u4,9-8r6,16-7d5,17-13l4,20-4l6,13-3d1,14-5l5,8-4d2,9-7l1,7-8u1,8-6l3,4-5d3,3-9r2,6-8d3,5-12r4,10-13u4,9-8r6,16-7d5,17-13l2,2-2d1,1-4r7,9-3d1,10-5l1u1l1d2,9-7l1,7-8u1,8-6l3,4-5d3,3-9r2,6-8d3,5-12r4,10-13u4,9-8r6,16-7d6r1d1l3,4-2l1u1l1d2,1-4r7,9-3d1,10-5l1,8-4d2,9-7l1,7-8u1,8-6l3,4-5d3,3-9r2,6-8d3,5-12r4,10-13u4,9-8r6,16-7d6r1d1l1

;10
          #########
         ##     # #
        ## .      #
       ## .  ##   #
      ## .  ##  # #
     ## .  ##   $ #
    ## .  ##  $ # #
   ## .  ## $ #   #
  ## .  ##  # $   #
### .  ##   $   # #
#@ .  ##   $ #$   #
##.  ## $  # $ #  #
 ## ##  #$ # #    #
  ###             #
    ###############
Solution: 17-5l1r1d2l2u4r1u1l4u1l1d1r1d1l1u1l1d1,13-8r1d1r1u6r1u1l4u1l1d1,13-6r1,15-7u4r1u1l4d1l1d1l1r1u1r1u2l1d1l1d1l1d1,14-11u2l1u1r1d1r1u6r1u1l4d1l1d1l1d1l1r1u1r1u1r1u2l1d1l1d1l1d1l1d1,11-9r3d1r1u7r1u1l4d1l1d1l1d1l1d1l1r1u1r1u1r1u1r1u2l1d1l1d1l1d1l1d1l1d1,12-11r1,14-12u3l1u1r1d1r1u6r1u1l4d1l1d1l1d1l1d1l1d1l1,11-1d1l1d1l1d1l1d1l1d1l1d1,11-7r1,13-8u1l1u1r2l1d2r2u5r1u1l4d1l1d1l1d1l1d1l1d1l1d1l1,11-1d1l1d1l1d1l1d1l1d1l1d1l1d1,12-10l1,10-11u1l1u1r5d1r1u7r1u1l4d1l1d1l1d1l1d1l1d1l1d1l1d1l1r1u1r1u1r1u1r1u1r1u1r1u1r1u2l1d1l1d1l1d1l1d1l1d1l1d1l1d1l1d1,7-11r2l2d2r2u2l1u1d1r1d1r1u2d1l2u1r1u1r5d1r1u7r1u1l4,10-11u1l1u1r5d1r1u7r1u1l2u1l2d2l1d1l1d1l1d1l1d1l1d1l1d1l1d1l1r1u1r1u1r1u1r1u1r1u1r1u1r1u1r1u2l1d1l1d1l1d1l1d1l1d1l1d1l1d1l1d1l1d1,14-2l2d1l1d1l1d1l1d1l1d1l1d1l1d1l1d1l1d1l1

;11
#########
#       #
# ## $  #
#  #$## #
## $    #
## ######
#  #  # #
#    .  #
#### # ###
  #  #   #
  # .@.  #
  ########
Solution: 4-4l1,2-3d3,1-7r3,6-7l1,4-6d3,3-10r3,4-2d1,5-4l2,2-3d3,1-7r3,6-7l1,4-6d3,8-10l1,6-2l1,4-1d2,5-4l2,2-3d3,1-7r3

;12
      #####
 ######   ##
 #        .#
 #  #### ..#
###$#  ##..#
#    $  ##.#
#   $#$  ###
## # $   $@#
 ###     ###
   #######
Solution: l2,6-5l3u2,2-2r6,9-1d1,8-3r1,10-2d2,1-5r1,3-6u3,2-2r6,9-1d1,8-3r1,10-2d1,4-7u1,5-5l1,3-6u3,2-2r6,9-1d1,8-3r1,6-7u1,7-5l3,3-6u3,2-2r6,9-1d2,6-7l1,4-8u2,5-5l1,3-6u3,2-2r7,8-7l1,6-8u2,7-5l3,3-6u3,2-2r6,9-1d1

;13
   ######
  ##    ####
 ##  $   $ #
##   # $   ##
#  # ####$  #
# ####    # #
#   .. #    #
#@ #..    # #
#### # ######
#    # #    #
# ##     ## #
# #  # #  # #
#           #
#############
Solution: 9-3d2,10-6l1,8-5d1,9-7l4,4-8u1,3-6r1,10-2l2,6-3r2,9-2d3,10-6l1,8-5d1,9-7l4,4-8u1,7-1d1,6-3r2,9-2d3,10-6l1,8-5d1,9-7l4,4-2r2,7-1d1,6-3r2,9-2d3,10-6l1,8-5d1,9-7l3

;14
     #####
######   #
##### $ @#
#### $  ##
### $  ##
#. $  ##
#.$  ##
#.  ##
#..##
####
Solution: 6-1d1l1d1l1d1l1d1l1d1,7-3l1d1l1d1l1d1l1d1l1,5-2d1l1d1l1d1l1d1l1d1,6-4l1d1l1d1l1d1l1,4-3d1l1d1l1d2,5-5l3,4-6l2

;15
  ######
 ##    ##
## $ $  #####
#  # #  #   #
#   # .  $ @#
# $# .$ $# ##
#  .  .    #
# .$.#######
## . #
 #####
Solution: 3-6d1,6-4d1r1d1l2u1l1d1,4-2r1u1r1d3r1d1l1,2-2r3u1r1d2,2-4d2,10-4l2d1,7-3d1,9-6l5,7-4d1r1d1l1

;16
####
#  #
# $####
#    @#
#  $ ###
#  # $ ##
## #$#  ##
 #      .#
 #####...#
     #####
Solution: 4-5d1,3-7r3,7-6d1,6-8r1,6-5l1,4-4d2,3-7r3,7-6d1,2-4r1,4-3d3,3-7r2,6-6d1,2-1d2,1-4r2,4-3d3,3-7r4

;17
#######
#  #  #
#+ *  #
## #  #
#     #
# $####
#  #
####
Solution: r2,4-1d1,2-6u3,3-2l1,4-4u1r1u1l1

;18
########
#..#   ##
# .  $  #
#  #$ $ #
#  # $  #
#.  $ $ #
#+.#   ##
########
Solution: 6-2l4,1-3u1,6-4u1,3-5r1,4-4u1,5-2l2,2-3u1,6-6u1l3,2-4d1,6-3d1,7-5l5,1-4d1,5-3d1,6-5l4,7-2l4

;19
  #########
###       ###
# $   $ $ . #
# # $.#.$.#.#
# #$.###.$. #
# @ $.#.$   #
###   $   ###
  ###   ###
    #####
Solution: 7-5r1,8-4r2,11-5u1,7-2r2,9-6u1,8-4r1,5-2r1,7-1d1,8-2d1,1-2r7,9-1d1,3-3r1,4-6u1,3-3d1,2-5r2,5-6r1,7-7u1

;20
 ####
##  ########
# .   #    #
# ..       #
#@ .####   #
##  #  # # #
 ####  $ # #
   #  $#$  #
   #   $   #
   #####   #
       #####
Solution: 8-8u4,9-3l5,3-2d1,8-8l2u1,4-8r4,10-8l1,8-9u5,9-3l6,2-4u1,6-5d1r1,8-7u3,9-3l6,6-8u1,5-6r2,8-7u3,9-3l5

;21
   ######
   #    #
#### ## ######
#            #
#   $ # $ ## #
# $ # $ ###  #
#  #  #      #
#  $ #########
##$# #     ..#
 #         ..#
 ##########.+#
          ####
Solution: 2-6u1,2-9u2r1,4-6d2,3-9r7,11-10u1,12-8l4,2-5d1,1-7r2,4-6d2,3-9r7,11-10u1,12-8l2,2-3d3,1-7r2,4-6d2,3-9r7,11-8d1,5-4l2,2-3d3,1-7r2,4-6d2,3-9r8,12-8d1,7-5l1,5-6u2,6-3l1,4-2d1,5-4l2,2-3d3,1-7r2,4-6d2,3-9r8,8-8r3,6-8r4,9-4l1,7-5u1,8-3l3,4-2d1,5-4l2,2-3d3,1-7r2,4-6d2,3-9r7

;22
 #######
 #     #
 # # # #
 #  ..+####
 #  #.##  #
###       #
#   # # # #
# $ #   $ #
#  #### # #
##  $     #
 #  ##  $ #
 ##    ####
  ######
Solution: 2-8u1,1-6r1,3-7u3,2-3r3,9-7l1,7-8u2,8-5l2,5-6u2,3-9r3,7-10u4,8-5l2,5-6u1,9-10l2,6-11u1,5-9r1,7-10u4,8-5l4,3-6u2,2-3r1

;23
 ####
 #  ##########
 #      #    #
## # #  $    #
#    #  ###  #
# ## ##   ####
#  # #  $ #
#  @ $ $###
#..#    #
#..######
####
Solution: 6-7l3,2-6d2,7-3r3,12-3l5,6-4u1,7-2l4,2-1d2,1-4r2,4-3d3,5-7l2,2-6d1,7-8u4,6-3r3,11-3l4,6-4u1,7-2l4,2-1d2,1-4r2,4-3d3,5-7l3,1-6d2,9-6l1,7-7u3,6-3r3,12-3l5,6-4u1,7-2l4,2-1d2,1-4r2,4-3d3,5-7l3,1-6d1

;24
    #####
    ##  #
  ### $ #
  ## $  #
### $  ##
#..$  ##
#+.  ###
######
Solution: 4-5l2,6-1d1l1d1l1d1,7-3l1d1l1d1l1,5-2d1l1d1l1d1,6-4l1d1l1d1l2,4-3d1l1d1u1r2d1l2r1d1l1

;25
   #######
   #  #  ##
  ##      #
 ##   #   #
##    ##  #
#  $#. . @#
# $ # *  ##
#   ######
#####
Solution: 3-6u1,2-4r2,5-5u2,4-2r3,8-1d3,9-5l1,1-6r1,3-7u2,2-4r2,5-3d1

;26
  #############
  #           #
###  $ #$ # # #
#    # $  $   #
#  $ # #$######
#  #     #..#
# ## ##### .#
#  #   #  . #
#         ..#
#######  @###
      #####
Solution: 2-4r1,4-3d4,3-8r5,9-9u1,8-7r1,10-8u2,6-2l1,4-1d6,3-8r5,9-9u1,8-7r2,11-8u2,8-3l1,8-5u1,6-2d2,9-3l2,7-5l2,4-4d3,3-8r5,9-9u1,8-7r2,11-8u1,6-2d2,7-5l2,4-4d3,3-8r5,9-9u1,8-7r1,8-1d1,9-3l2,6-2d2,7-5l2,4-4d3,3-8r7,11-3l4,6-2d2,7-5l2,4-4d3,3-8r6

;27
######
#    #
# $ @# ####
#  $####  ####
# $ $  #$    ##
#  $ $   $  ..##
# $  #  $  #.  ##
#   ######   ...##
#####    ###.. ..#
           #######
Solution: 4-5r2,7-6r2,8-5r3,12-4d3,10-7u1,9-5r2,12-4d2,11-7r2,14-6d1,13-8r2,6-5r5,12-4d2,11-7r2,14-6d1,13-8r1,8-3d1,7-5r4,12-4d2,11-7r1,13-6d1,2-5r9,12-4d2,11-7r3,2-3d1,1-5r10,12-4d2,11-7r2,3-2d2,2-5r9,12-4d2,11-7r1,5-4l1,3-3d1,2-5r9,12-4d1,2-7u1,1-5r11,2-1d3,1-5r10

;28
     ####
 #####  ##
##       ####
#   #       #
# $$$ ## ## #
##    #    @#
 ####. .  ###
    # .  ##
    ######
Solution: 3-5u2,2-2r3,6-1d1,5-3r2,8-2d3,9-6l1,7-5d1,8-7l1,1-4r1,3-5u2,2-2r4,7-1d1,6-3r1,8-2d3,9-6l1,3-4r1,5-3d2

;29
########
#      ####
#  #      #
# ###     #
#  $  ###.##
# $#$  # ..#
#  $      +#
#      #####
########
Solution: 2-6r2,2-4r2d1,5-5u2,4-2r1,6-1d1,5-3r3,9-2d2,8-5r1,5-7u4,4-2r1,6-1d1,5-3r3,9-2d2,3-6r6,2-6u1,1-4r3,5-5u2,4-2r1,6-1d1,5-3r3,9-2d1

;30
    ########
 ####      ##
 #          #
##$ ## # #  ##
#  $#  #     #
# $ $  ####  #
#    # #     #
######  . . @#
     # . .  ##
     #####  #
         ####
Solution: 3-3d1,3-6u1r2,6-6u3,5-2r4,10-1d2,9-4r1,11-3d3,12-7l2,9-6d1,10-8l2,2-2d1,3-5u2,2-2r7,10-1d2,9-4r1,11-3d3,12-7l2,9-6d1,1-5r1,3-6u3,2-2r7,10-1d2,9-4r1,11-3d3,12-7l3,1-4r1,3-5u2,2-2r7,10-1d2,9-4r1,11-3d3,12-7l1

;31
    ###########
   ##         #
  ## $       @#
 ## $  ########
## $  ##      #
# $  ##  #  # #
#   ##  ### # #
##  $      . .#
 #########  . #
         ##. .#
          #####
Solution: 3-7r7,11-6d1,10-8r1,5-1d1,4-2d1,3-3d3,2-7r8,11-6d2,1-5r1,3-4d2,2-7r10,13-6d2,6-3l1,5-4l1,4-2d1,3-3d3,2-7r10,5-4l1,3-3d3,2-7r8

;32
 ########
##      ####
#  #  #    #
# ###  $   #
#  #  .#.  #
#   $ ###  #
## $#$.#.  #
 ##        #
  ####  @###
     #####
Solution: 6-3r1,8-2d1,5-7u2,3-5r1,4-4r1,3-7u1,5-4d2,4-7r3,8-8u1,2-5r2,5-4d2,4-7r1,6-8u1

;33
      ######
     ##    #####
    ##         ##
   ##    ##     ##
  ##    ##  #    #
 ##    ##   $ #  #
 #    ##    # $  #
##   ##  #    #  #
#   ## $  $  $   #
#   #  #  #  #   #
#@  #          $ #
##  ######  #  # #
 #   #  #  ###   #
 #   #. .   .#####
 #      #  . #
 #      #   .#
 #####  .  ###
     #######
Solution: 13-5l1,11-6u3,12-2l4u1l1d1r1d1l1u1l1d1r1d1l1u1l1d1r1d1l1u1l1d1r1d1l1u1l1d8l1d1r4d1r1u1l1u1r3u1r1d2l1d1r2,14-8l2d1l1u6r1u1l4u1l1d1r1d1l1u1l1d1r1d1l1u1l1d1r1d1l1u1l1d1r1d1l1u1l1d8l1d1r4d1r1u1l1u1r3u1r1d1l1d1r1,9-8r1l1d2r2u7r1u1l4u1l1d1r1d1l1u1l1d1r1d1l1u1l1d1r1d1l1u1l1d1r1d1l1u1l1d9l1d1r4u1r1d1l1d1r1,6-8r4,11-9u6,12-2l4u1l1d1r1d1l1u1l1d1r1d1l1u1l1d1r1d1l1u1l1d1r1d1l1u1l1d8l1d1r4d1r1u1l1u1r5,16-10l4,11-11u8,12-2l4u1l1d1r1d1l1u1l1d1r1d1l1u1l1d1r1d1l1u1l1d1r1d1l1u1l1d8l1d1r4d1r1u1l1u1r1,15-6l1r1d2l2u5r1u1l6u1l1d1r1d1l1u1l1d1r1d1l1u1l1d1r1d1l1u1l1d1r1d1l1u1l1d8l1d1r3d1r1u1

;34
  ########
  #      #
  #      ####
 ##   #     ##
 # .  #  $ $ #
 #.#.## $ $  #
## .  #  # $ #
# . . # ### $##
#@ . ##  # $  #
######        #
     ##########
Solution: 10-4l1,9-5l1,7-6u3,8-2l3,4-1d5,5-7l2,2-8u2,9-4l1,7-5u2,8-2l3,4-1d5,5-7l1,3-6d1,10-8r1,11-7u1,12-4l4,7-5u2,8-2l3,4-1d5,5-7l1,4-8l1u1,1-8r1,11-6u1,12-4l4,7-5u2,8-2l3,4-1d5,5-7l2,10-6u2,11-3l3,7-4u1,8-2l3,4-1d5,13-8l1,11-9u4,12-4l4,7-5u2,8-2l3,4-1d3,12-6d1,13-8l1,11-9u4,12-4l4,7-5u2,8-2l4,3-1d2

;35
    ##########
   ##        ####
  ##     $ $    #####
 ##     ######$     #
##    ###    #  # # #
#     #    # ####$  #
# # $ #    $ #. #   #
# # ###  ### # .##  #
#     $    #  .  #$ #
####  #  *     . #  #
# #  ### # ##  #### #
#      #.#. ## #. ###
##   $ # .   ##. .#
 # $ ###   $  $ . #
## # #.   ##$ #  ##
#@   # .   #    ##
#################
Solution: 5-8r2d1r1u1,13-13r2d1r1u1r1u1d1l2u1r1,10-13r5d1r1u2,12-15u1r1u1l1u1l2d1r4,15-14u1,8-9r1u1r1d4l1d1r6,8-6d2l1d1r2u1r1d3r1d1l1,2-13d1u1r1,4-14u5r1u1l2,1-8r6u1r1d6r1d1l2,6-12l1u1l2d2r1u4r1u1l2,1-8r6u1r1d7r1d1l1,10-6r1,12-5d3,11-9r2d1r1u1l1u1r1d1r1u1,5-6l1u1l1d2,2-8r5u1r1d1l1d1r2u1r1d2,10-2l4u1l1d1r1d1l1u1l1d1r1d1l1u1l1d4,2-8r5u1r1d3,12-2l6u1l1d1r1d1l1u1l1d1r1d1l1u1l1d4,2-8r5u1r1d1l1d1r6d1r1u3,14-4u1r1u1l9u1l1d1r1d1l1u1l1d1r1d1l1u1l1d4,2-8r5u1r1d1l1d1r6d1r1u1,17-6u2,18-3l3d1l1u1r1u1l9u1l1d1r1d1l1u1l1d1r1d1l1u1l1d4,2-8r5u1r1d1l1d1r7,18-9u3r1u1l1d1l1u2d1r2u2l4d1l1u1r1u1l9u1l1d1r1d1l1u1l1d1r1d1l1u1l1d4,2-8r5u1r1d1l1d1r1

;36
       ###########
 #######+   ##   #
##     ##        #
#       ##  # # ##
#  ##    ##   ###
##  ##    ##  # #
 #$  ##    #  # #
 # $  ##   ##   #
 ## $  ##       #
  ## $  ##  # . #
   ## $  ####.#.#
    ##     #  . #
     #####    ###
         ######
Solution: 6-11u1l1u1l1u1l1u1l1u3l1u1r4u1r1d1l1d1r1u1r1d1l1d1r1u1r1d1l1d1r1u1r1d1l1d1r1u1r1d1l1d1r4d1r2u1l1d1l1u6d1l2u2r3u1r2d1l5d1l1u1r1u1l2,7-9l1u1l1u1l1u1l1,5-10u1l1u1l1u1l1u3l1u1r4u1r1d1l1d1r1u1r1d1l1d1r1u1r1d1l1d1r1u1r1d1l1d1r1u1r1d1l1d1r4u1r2d1l1u1l1d3,12-11r1,6-8l1d1l1r1u2l1u1l1r1d1r1d2l1u1l1u1l1u3l1u1r4u1r1d1l1d1r1u1r1d1l1d1r1u1r1d1l1d1r1u1r1d1l1d1r1u1r1d1l1d1r4u1r2d1l1u1l1d2,5-7l1d1u2l1r1d2l1u1l1u3l1u1r4u1r1d1l1d1r1u1r1d1l1d1r1u1r1d1l1d1r1u1r1d1l1d1r1u1r1d1l1d1r5u1r1d2,4-6l1d1l1u3l1u1r4u1r1d1r1l2d1r1u1r1d1l1d1r1u1r1d1l1d1r1u1r1d1l1d1r1u1r1d1l1d1r4u1r1d1

;37
   ##########
####  #     #
#         #@#
#  #.. .#####
## ######   #
#           #
#  #    # # #
## # ####   #
#  ###    # #
#   ##      #
##   #$#$#  #
 ##    $ ####
  ##     #
   #######
Solution: 8-11u2,7-8r1,9-9u3,10-5l7,2-6u3,1-2r6,6-11r1,8-12u3,7-8r1,9-9u3,10-5l7,2-6u3,1-2r3,6-2l1,4-1d1,6-9d1,5-11r2,8-12u3,7-8r1,9-9u3,10-5l7,2-6u3,1-2r3,5-1d1,9-2l1,7-1d1

;38
 ########
 #      #####
## # $  #   ####
#    #   $  $  #
#   ##$  ##   ##
# $##   ##   ##
#   #  ##   ##
#      #   ##
######    ##
 #  #    ##
 #. .   ##
 # .   ##
 #.@.###
 #####
Solution: 6-3d6,7-10l3,3-9d2,2-12r1,10-3l3,6-2d7,7-10l4,2-9d2,4-2r1,6-1d8,7-10l3,3-9d1,2-4d2,1-7r4,6-6d3,7-10l4,13-3l6,6-2d6,6-8d1,7-10l2

;39
  ##########
###   #    ####
#     $       #
#  $### $  #@ #
# $   # # ### #
# #$  #   #   #
#   .  * $  ###
###.#. #.#  #
  # .  . ####
  ########
Solution: 6-6r1,8-5d1,9-3l1,7-2d3,8-6l2,5-5d2,4-8r2,3-4d2,3-2d3,2-6r2,5-5d2,6-8l1,1-4r1,3-3d2,2-6r2,5-5d1,10-6l5,5-2r1,7-1d4

;40
     ########
   ###      #
  ##  $ $   #
  #  $ ###  #
  # $    #  #
  #### #    #
###. # #   ##
# ...# $ # #
# #. ###   #
#          ###
##   #   #   #
 ###   #   #@#
   ###########
Solution: 6-7r1,8-6d2,9-9l5d1l1u2r1u1l1,7-2r2u1r1d3r1d1l2,8-4d4r1d1l5d1l2u1r1d1r1u2,5-4u1,6-1d1,4-2r5u1r1d3r1d1l2,8-4d4r1d1l5d1l1u3,6-4u1l1u1r4u1r1d3r1d1l2,8-4d4r1d1l5d1l1u2,3-4r2,6-5u2l1u1r4u1r1d3r1d1l2,8-4d4r1d1l5d1l1u1

;41
   ##########
   #        #
   #  #   # #
   # ## $ $ #
  ##$#  #   #
  #  ## # $ #
  #  $ $  ###
###  # #  #
#       $ #
#   $ #####
#  ####. .#
#  . .# . ##
#@  .      #
###. .#  # #
  ##########
Solution: 5-9l2u1l1d3l1d1r6d1r1u1l1u1r1,6-6r1,9-8l5u1l1d1r1d1l1u1l1d3l1d1r6d1r1u1r1u1l1d1l1u1,6-6l1,4-5d3r1d1l2u1l1d3l1d1r6d1r1u1,4-3d5r1d1l2u1l1d3l1d1r3u1r1d1,9-6l5u1l1d3r1d1l1u1l1d3l1d1r1u1r1d1,9-3l1u1l1d3,8-6l4u1l1d3r1d1l1u1l1d3l1d1r2,11-3l3u1l1d3,8-6l4u1l1d3r1d1l1u1l1d2l1d1r3,11-5l1,9-6u2r1u1l2u1l1d3,8-6l4u1l1d3r1d1l1u1l1d2l1d1r1

;42
  ##########
###    #   #
# # @    . #
#   # ##.#.#
# # # #  . #
#   #      #
#  ###   ###
#      # #
# $ #    #
# #    $ ###
#  $ # #   #
#  # #   $ #
##     #####
 #######
Solution: 6-9r1,8-10u7,7-2r1,1-8r1,3-9u1,2-7r3,6-8u2,5-5r2,8-6u2,2-10r1,4-11u1,3-9r4,8-10u5,7-4r2,10-5u1,10-11l3,6-12u3,5-8r2,8-9u4,7-4r1

;43
 ##########
 #     @  ######
 #     #   #   #
 #  # ###    $ #
 #  #  # $ $ ###
##  #    #$# #
 #  #      $ #
 ## ##  # #  #
 #.$.#########
 # .    . #
 ##    . .#
  ###   ###
    #####
Solution: 3-7d1,2-9r5,12-6l5,6-7u1,7-5l1,5-6u3,6-2l2,3-1d7,2-9r1,4-8d1,3-10r5,10-4d1,11-6l4,6-7u1,7-5l1,5-6u3,6-2l2,3-1d7,2-9r1,4-8d1,3-10r3,8-4r1,10-3d2,11-6l4,6-7u1,7-5l1,5-6u3,6-2l2,3-1d7,2-9r2,14-3l3,10-2d3,11-6l4,6-7u1,7-5l1,5-6u3,6-2l2,3-1d7,3-10u1,4-8l1,6-9l1,4-10u1,12-4l1,10-3d2,11-6l4,6-7u1,7-5l1,5-6u3,6-2l2,3-1d7

;44
     ########
    ##      #
  ### $  #  #
###   # $   #
#..  $  #$  #
#+.  #      #
####   ######
  #   ##
  #####
Solution: 6-4l4,9-3d1r1d1l3,6-6u1r1u1l3u1l1d1r1d1l2,9-3l1u1l1d2,8-5l1,6-6u1r1u1l3u1l1d1r1d1l1,5-2r1u1r1d3,8-5l1,6-6u1r1u1l4

;45
         ####
   #######  #
   #        #
####   $ #  #
#     $  #  #
#    $ $##  ######
#   # $  #   #   ##
#  ### $ # .   .  ###
#   # $  #.#. .#.   #
#     #$ # .   .   @#
#        ############
##########
Solution: 7-4u1l1u1r4u1r1d5l1d1r5u1r1d2r1d1l1,7-6u1l1u2l1u1r5u1r1d5l1d1r4u1r2d1l1u1l1d1,7-5u2l1u1r4u1r1d5l1d1r5u1r1d1,7-8u5l1u1r4u1r1d5l1d1r4,7-10u7l1u1r4u1r1d5l1d1r1u1r1d2r1d1l1,5-8r1u5l1u1r5u1r1d5r1d1l1u1l1d1,7-9u6l1u1r4u1r1d5l1d1r1u1r1d1,5-6u3l1u1r6u1r1d5

;46
  ######
 ##    #
##  ## #####
#   @      #
#  .#.  #  #
## ### ### ###
 # .#.   #   #
 #     #   # #
 #    ##  ## #
 #   ####  # #
 ##    #  $  #
  # #    $#$ #
  #    #  $  #
  ####       #
     #########
Solution: 11-12l2d1l1u1,9-10d1l3d1l1u1r1u1l2r1d2l2u4l1u1r2d1r1u1,10-12l1d1l1u1r1u1l3d1l1u1r1u1l2r1d2l2u4r1u1l1d1l1u4l1u1r4l2u2r3d2r1d1l1,11-10l1u1l1d2l1d2r2u1l1d1l1u1r1u1l3d1l1u1r1u1l2r1d2l2u4r1u1l1d1l1u4l1u1r1u1r1d1,11-10d1r1d1l3d1l1u1r1u1l3d1l1u1r1u1l2r1d2l2u5

;47
    #####
#####  .#
#   $   #
# # # # #
#   $   #
#####. @#
    #####
Solution: 5-2l2d2r1,5-3d1,1-2r5,7-3u1

;48
   ####
####  #######
# $     $   #
# ## # $#$# #
#  $ # $  # #
#  # # #    #
# ##     ####
#  # #####  #
#    #      #
#### # # ...##
  #  ### # ..#
  #         +#
  #######  ###
        ####
Solution: 9-2l4u1l1d9l1d1r6d1r1u2d1l2u2r2u1r1d1l1d1r1,9-4u1,10-2l5u1l1d9l1d1r6d1r1u2d1l2u2r2u1r1d1,8-4l1u1d1r2u2l4u1l1d9l1d1r6d1r1u3r1u2l1d1r1d1l1,6-5u2r1u1l2u1l1d9l1d1r8,2-4r1,1-2r3d8l1d1r6d1r1u3d2l2u3r2u1r1d1,6-2l1u1l1d9l1d1r6d1r1u2

;49
            #########
  ###########  #    #
  #       #    #@   #
###  $         ## # ##
#   ### #####   # #  #
# ### #   # #   #    #
# #   # $ $ #  ##  #.#
#       #   ##    ##.#
###$### ###     #  #.#
#         #####    #.#
###########   ########
Solution: 4-3r9u1r1d5,13-8r1,15-9u1l1u1r2,17-8u5,16-2r2u1r1d3,18-5r1u1r1d4,9-6l1,7-7u3,6-3r7u1r1d5,13-8r1,15-9u1l1u1r2,17-8u5,16-2r2u1r1d3,18-5r1u1r1d3,11-6l3,7-7u3,6-3r7u1r1d5,13-8r1,15-9u1l1u1r2,17-8u5,16-2r2u1r1d3,18-5r1u1r1d2,3-9u1,2-7r4,7-8u4,6-3r7u1r1d5,12-8r2,15-9u1l1u1r2,17-8u5,16-2r2u1r1d3,18-5r1u1r1d1

;50
 ####
 #  #####
 #  ##  #########
 #   #          #
##  @#     #  $ #
#  .##  #    $# #
# ...# ### $# $ #
# #.##  #      ##
#       $ # ####
##  #########
 ####
Solution: 9-8l6,1-8r1,3-9u4,15-4l2,13-6u2,14-3l7,6-2d5,7-8l4,1-8r1,3-9u2,2-6r1,4-4l1,2-3d2,12-5u1,13-3l6,6-2d5,7-8l4,1-8r1,3-9u6,11-7u1,12-5l1,10-6u2,11-3l4,6-2d5,7-8l4,1-8r1,3-9u4,15-6l1,13-7u3,14-3l7,6-2d5,7-8l4,1-8r1,3-3d2,3-1d3,3-9u1

