;1
         ################
   #######              ##########
   #.....#  ..........  # . . . .#
   #.   .#  .   ..   .  # . . . .#
   #.   .#  .   ..   .  # . . . .##
   #.   .#  .        .  #.. . . ..#
   #.   .#  .        .  #.  . .  .#
####     #              #.... ....#
#        #### # # # #####         #
# $#$#$#$ $ $ $ $ $ $ $ $ $#$#$#$##
#                                 #
# $$$$$$$$$$$$$$$$$$$$$$$$$$$$$$$ #
#                                 #
# $#$#$#$#$#$#$#$#$#$#$#$#$#$#$#$ #
#          #                      #
##############$   $################
             #  @  #
             #######
Solution: u2r17u4l1u4l1u1r1d5l2u3l1u1r3l2d4l2u2r1l2u1r5l4d3l2u2l1u1r1d3l3u1r1d1r1u4d4r8d2l3u4l1u1r1d3r3d2l1u9d8r1d3l1u10d6l2d1r1d1r1u7d7l4u9d8r3d1r1u6d5l4d1l2u9d8r5d1r1u4d2l1r2d4l3u11d11l2u10d10l2u10d8l2u1r5d1r1u8d6l4u1l3d1r6d1r1u6d7u1l6u1l3u1r3d1r1u3d3l6u1r5d1r1u2d2l8u1r8d1r1u5d7l4u2l1u1r4d1r1u4d6l4u1r7d1r1u6d4l1d1l2d1l7u1r9d1r1u5d3l4u1l6d1r1d2l1u1r1u2l2d1r10d1r1u3d2l4d4l2u3l1u1r4d1r1u6d9l6u2l1u1r6d1r1u6d5l8d1l1u6d6l2u6d5r10d1r1u5d4l9d1l4u6d5r12d1r1u4d2l13u1r10d1r1u2d1l7u6l1u1r2l4d3r4d1r1u2l7d1r6d1r1u1l4d5l4u1r5d1r1u4l1u1r2l7d5l2u1r7d1r1u3l1u1r2l3d4l9u7d7u1r8d1r1u7l1u1r3l3d5r1d3r5d4l2u4r1u1l1d1l1u7d9r1d2l2u4r1u1l1d1l1u7l1u1r1d10r1d2l1d2r1u6r1u1l1d1l1u7d9r1d2l2u4r1u1l1d1l1u7r1u1l3r2d10l2u8r1u1l1d8r1d1r1u9r1u1l2r1d10r1d2l2u4l1u1r1d1r1u7r1u1l1d10r1d4l2u6l1u1r1d1r1u7d9l4u2l1u1r6d1r1u4r1u1l1d1l1u3d4l1d5l3u2l1u1r5d1r1u6r1u1l1d9l1d2l4u4l1u1r5d1r1u5r1u1l1d8l7u2l1u1r7d1r1u6d5l2d1l4d2l10d2r9u4l1u1r7d1r1u5d5l2d2l13u1l1u1r11d1r1u6r1u1l1d8l10u1l1u1r10d1r1u5r1u1l1d7l9u1l1u1r9d1r1u4r1u1l1d6l5u8d6l2u7d5r2d4l2u8l1u1r1d1r1u1d3l1d4l2u7d7l2u1l1u1r4l1d2r2u5r1u1l1d1l1u2d3r1d5l1d1l1u8d6l3d4r3u9d9l2u2l1u1r2d1r1u6d5r3d1r1u7d7r2d2l2u8d3r2d1l1r1d1l1d1u1d1l1u5d7l2u2r1u1l2d1l1u5

;2
    ###########
 ####         #
##  $$#$#*#$$ ######
# #   .            #
# $ # #  #  #.#  # #####
# # $    $       *     #
#   # #  ##.#    #    $##
#   # *           #.#   #
##  $ ##    #.#         #
 #  #  $  #      #.#   ##
 ##    #  $   #+#      ##
   ##     #        .....#
    ##       ############
     #########
Solution: 22-5d5,21-11r1,9-10r3,13-9d1,12-11r9,11-1d8,10-10r2,13-9d1,12-11r8,6-9r2,9-8d1,8-10r4,13-9d1,12-11r7,3-8r1,5-7d2,4-10r1,6-9d1,5-11r3,9-12u1,8-10r4,13-9d1,12-11r6,11-2r1,13-1d2,8-5r7,16-4d3,15-8r5,21-9u2,22-6l2,19-5d1,3-5r12,16-4d3,15-8r5,21-7d2,22-10l3,18-11u1,7-1d3,6-5r8,15-4d5,5-1d3,4-5r10,15-4d2,16-7l2,13-6d1,3-2r1,5-1d1,4-3r6,11-2d3,1-4r1,3-3d4,2-8r2,5-9u5,4-3r1

;3
         ######
     ####      ####
   ## .   $ #$$$   ##
  ##  #  @  .    .# ##
 ## $ .  #$$$$  $    ##
 #      $#        $   #
## .  .  # $. $     # #
#  #  #  # ###### #.  #
## .  .  #          ##
 ##   $     .   $   #
  ###     $ # $    #
     #####.......##
          #######
Solution: 10-9d1,14-9d1,15-11l3,17-9l3,13-8d2,14-11l1,19-5l1,17-4d5,18-10l4,13-9d1,15-4r1,17-3d6,18-10l3,14-9d1,10-5u1,9-3r7,17-2d7,18-10l2,15-9d1,11-3d1,10-5r6,17-4d5,18-10l1,16-9d1,13-3d1,12-5r4,17-4d4,18-9l5,13-6r5,19-5d1,6-10u1,4-3d4,5-8l1,8-6u2,9-3l1,7-2d3,8-6l4,11-2l4,14-1d1,15-3l7,7-2d3,8-6l1,10-6r1,16-2l1,14-1d1,15-3l7,7-2d1,8-4l1,13-1d1,12-3r4,12-5u1

;4
 ##############
 #            #
 # $ $  $    .#
# $######$ #  #
#  $  $    # *#
#   + # $  ####
##  $ # .   .##
 ##   # # # .##
 ## #   .    .##
  #    $   $   #
  ### ..#.#### #
    ###.###  ###
      ###
Solution: 7-8d2,12-9l2,9-8d1,3-6r1,5-5d3,4-9r1,6-8d1,9-5l1,7-4d5,7-2r5,9-2d5,8-8r3,12-9u1,4-2r5,10-1d4,9-6r2,2-2r6,9-1d6,8-8r4,5-4r3,9-3d4,10-8l1,2-4r6,9-3d2,10-6l1,2-2d2,1-5r2

;5
####
#  ###
#     #####
# $$$  $  #
# $@$  # $####
# $$$$ $     ###
#        $$$#  ##
#  #$ #.#      #
### $$ .. .$ ###
  #    ..      ##
  # .  .#   .   #
  #  *  . .   $ #
  #         ##..#
  #.....#########
  #..####
  ####
Solution: r2,5-7d2,6-10l1,4-9d4,3-8r1,4-6d6,5-13l1,3-12d1,6-8l1,4-7d5,3-13r3,4-4d8,3-13r2,4-2d10,3-13r1,1-4r2,4-3d9,2-2d1r1,4-2d9,5-12l1,3-11d1,1-4r2,4-3d6,14-10d1,11-7d3,10-11r4,15-10d1,9-5d5,10-11l2,7-12u4,10-5d5,11-11l3,7-12u3,9-3d7,10-11l2,7-12u2,11-5d4,10-10r1,6-5r2,9-4d6,10-11l2,7-12u1,4-5r4,9-4d6,10-11l1,6-3d2,5-6r3,9-5d2,10-8l1,8-3l2,5-2d3,4-6r4,9-5d3,10-9l1,2-4d1,1-6r8,10-5d5,3-4d1,2-6r7,10-5d2

;6
                ########
                #......#
                #......#
                #......#
######          #......#
#    #          #......#
# $$$####       #  $ ###
#       #     ###  # #
# $$#$$$#######    # #
#   #   $ $ $ $  @ # #
# $ .              # #
##$ $   # ### #$#  # #
 #  $  $#$  .      # #
 #$ $  $ $  ##.$ $##$#
 #  $  $    $    $ $ #
 #$ $                #
 #    ########## .   #
 ######        #######
Solution: 20-14u12,19-1r2,18-14r1,20-15u12,19-2r2,18-6r1,20-7u3,19-3r2,16-14r3,20-15u10,19-4r2,17-12d3,11-14r8,20-15u9,19-5r2,6-14r13,20-15u13,19-1r1,3-14r16,20-15u12,19-2r1,4-16u1,3-14r16,20-15u11,19-3r1,3-13r1,5-12d1,4-14r15,20-15u10,19-4r1,3-12r1,5-11d2,4-14r15,20-15u9,19-5r1,13-9r4,18-10u8,17-1r1,11-9r6,18-10u7,17-2r1,9-9r8,18-10u6,17-3r1,7-9r10,18-10u5,17-4r1,6-7d1,5-9r12,18-10u4,17-5r1,8-13r1,9-11d2,8-14r11,20-15u13,10-12d1,9-14r10,20-15u12,6-13r2,9-12d1,8-14r11,20-15u11,7-11d2,6-14r13,20-15u10,7-7d6,6-14r13,20-15u9,16-13l1,15-10d1,16-12l3,1-10r15,17-11u9,2-12u1,1-10r15,17-11u8,2-14u3,1-10r15,17-11u7,2-16u5,1-10r15,17-11u6,5-7d2,4-10r12,17-11u5,3-7d2,2-10r15,18-11u9,2-7d2,1-10r16,18-11u8,2-5d4,1-10r16,18-11u7,3-5d4,2-10r15,18-11u6,4-5d1,5-7l1,3-6d3,2-10r15,18-11u5,4-12u1

;7
    ###
    #.########
    #....    #
 #### $$# $$ #
##  $   #$ $##
#@$  . *#  ..##
## $ $  #. *..##
 ####$$ $ **..##
    #      ####
    ########
Solution: r1,3-4r1,5-5u3,10-6r2,10-8u1r2,9-6r2,10-2d3,9-6r1,12-3l1d1,10-5r1,9-3r1,11-2d2,7-7r4,6-8u1,7-4d2,6-7r4,6-7u1,5-5r1,7-4d2,6-7r3,9-5u2,10-2l1,7-4u1,6-4u1,4-6r2,7-5d1,6-7r2,9-8u1,5-8u5,2-5r2,2-6r4,7-7u1

;8
                          ###
       #######################
     ###                 ### #
    ##  $$# #  $$$$$       $ #
####    $ . #. # # . $  $  $ #
#  # $##$    $     . $     $ #
####    $$ $#$$$$#######$. $ #
 ###           # #........   #
 #              ..........## #
 #....# ##...   ..       #####
 #...## $ ##.          #######
 ##### $$ ################*###
    #      #            ####
    # $ $$$##           #*##
    ##      #           ####
     ## $$$ #
      ##  @##
        ####
Solution: 8-16u1,7-12u4,8-7l3,4-6d2,5-9l2,2-8d1,9-11l1,7-12u4,8-7l3,4-6d3,9-10l1,7-11u3,8-7l3,4-6d2,5-9l1,3-8d1,5-13r1,7-14u6,8-7l3,4-6d2,5-9l2,10-16u1l1,9-14l1,8-16u1,7-15u7,8-7l3,4-6d2,5-9l1,9-14l1,7-15u7,8-7l3,4-6d2,5-4d4,11-5d3,10-9r1,12-8d1,16-5d2,15-8r2,18-9u1,24-5d1,25-7l5,24-3d3,25-7l4,20-5r3,24-4d2,25-7l3,20-4r3,24-3d3,25-7l2,28-5l3,24-4d2,25-7l1,28-6l2,25-5d2,28-3l1d3,28-7l2,27-3l2,24-2d2,23-5r1,25-4d1,12-5r11,24-4d2,11-14l3,7-15u7,7-6d1,6-8r17,9-12d1l1,7-14u6,7-6d1,6-8r16,10-14l2,7-15u7,7-6d1,6-8r15,10-12d1,11-14l3,7-15u7,7-6d1,6-8r14,9-5d2,8-8r1,10-7d1,9-2d5,8-8r2,11-7d1,7-6r3,11-5d2,10-8r1,12-7d1,14-5d2,13-8r6,16-2d5,15-8r3,18-2d1l1,16-2d5,15-8r2,14-6r1,16-5d3,15-9r1,14-3r1,16-2d5,15-8r1,18-5u1,19-2d2,17-3r1,19-2d1,13-7u2,7-4r2,8-4d2,8-6d1,7-8r8,16-7d1,8-2d5,7-8r8

;9
   ####################
   #   # #  #  #  #   #
#### $ # # $# $# $#$  #
# @  $ $ $  #  #  # $ #
# $         $$ #  $   #
#   #$ $ $     . $ $  #
##  #  $##$$$$     $$ #
 #  #$  $    $$$$     #
 #              . $$$ #
 #.  ### * $  *.      #
 #..   $ *   .  * . $ #
 #.#.    *  *    .    #
 #.##.   . .    $ .$$ #
 #.# #.  . ........   #
 #.#  #. . .      . . #
 #.#   #.. .     $.$* #
 #.#    #* .      . . #
 ######################
Solution: d12,8-10l5,2-9d5,5-6d1,6-8l3,2-7d6,5-4d3,6-8l3,2-7d5,4-2r1d5,6-8l3,2-7d4,8-3l2,5-2d5,6-8l3,2-7d3,8-5l2,5-4d3,6-8l3,2-7d2,6-1d2,7-4l4,2-3d5,10-3l5,4-2d1,5-4l1,3-3d6,10-11l5,11-8d3,12-12l6,11-5d7,12-13l5,11-1d12,12-14l4,8-5r2,11-4d10,12-15l3,19-14d1,18-16r1,17-14d1,16-16r1,20-11d2,20-12l1,18-11d3,16-11d1,17-13l7,9-12d2,20-9d2,21-12l11,9-13u1,10-5d6,11-12l1,7-7r2,10-6d6,11-13l1,7-5d1,6-7r3,10-6d7,11-14l1,17-4d9,16-14r1,18-7d5,19-13l7,11-12d3,12-5d1,14-6l2,11-5d9,13-3d1l1,11-3d10,14-5l2,11-4d8,13-8u1l1,11-6d5,13-5d4,15-6d2,20-7d5,21-13l8,20-5d7,21-13l7,20-2d10,21-13l6,19-7d5,20-13l4,18-5r1d7,20-13l3,20-4d8,21-13l3,19-1d11,20-13l1,17-4r1,19-3d8,20-12l1,17-1d9,15-7r2,18-6d3,13-7r2,16-6d1,14-1d3,13-5r1

;10
###
#####       ######
###*#      ##    ########
###*########            #
#### $ $ $   $ $$   $$$$#####
#           ####  $ #    $  #
#  $ $ $ $  ###### #*# $ $  ##
##  $ $ $   ###### ###   $  ##
 #####  @              $ $  #
     ########  .# .$##   #  #
            #   #   # .$    #
            # * #   #     # #
         ####   .  .$    #  #
   ####### $          .     ##
   #  $ $ $  $ . $ .     #  ##
   ##       ...........# ...#
    ####...#..#..#..##. .####
       ###################
Solution: 13-13d2,17-13d1,18-15l1,16-14d1,9-14r3,13-13d1,14-15l3,10-14d1,7-14r4,12-13d1,13-15l4,8-14d1,5-14r6,12-13d1,13-15l3,9-14d1,10-13r2,13-12d2,14-15l1,12-14d1,21-12l5,15-11d4,19-8d7,18-4d11,22-3d12,26-8l1,24-7d8,23-9d3,22-13r3,26-12d2,27-15l1,26-6l1,24-5d7,23-13r2,26-12d2,24-7r2,27-6d8,24-8l1,22-7d7,24-6l1,22-5d8,23-14l10,12-13d1,23-3d10,24-14l10,13-13d1,21-5u1,21-4l2,18-3d11,19-15l4,16-5u1,14-4r3,18-3d11,19-15l3,16-2d1,15-4r2,18-3d11,19-15l2,22-3l5,16-2d1,15-4r2,18-3d11,19-15l1,12-4r5,18-3d11,8-4r9,18-3d10,17-14r1,19-13d1,6-4r11,18-3d10,17-14r2,20-13d1,4-4r13,18-3d10,17-14r3,21-13d1,26-5l3,22-4d8,9-7u2,8-4r13,22-3d6,6-6r4,11-5d2,10-8r7,18-7d4,19-12l3,15-13u3,7-7r3,11-6d1,10-8r7,18-7d6,19-14l3,4-6r6,11-5d2,10-8r7,18-7d6,17-14r1,2-6r8,11-5d2,10-8r7,18-7d4,19-12l2,5-7r5,11-6d1,10-8r7,18-7d4,17-12r1,3-7r7,11-6d1,10-8r7,18-7d1

;11
  ###########
###          #######
# $$     $$        ########
#  $ $ ##  $  ## $ $ $ $  ###
#  $   ### $##### $         ####
#  $  ##*#  ####      $  $    .#
##$$  #*##  ###  $          ...#
 #     ## $       ............##
 #$       $ $ .....######....##
 #  $ .....   ..###      #####
 #$   $   $ $ .#
 #  @ $ . $   ##
 ##$  $   $   #
  # $    .. $ #
  #  $   ..   #
  ##  $       #
   ###       ##
     #########
Solution: 17-5d1,16-7r8,25-6d1,24-5r5,22-4d2,21-7r4,26-6d1,18-3d3,17-7r9,27-6d1,17-2d4,16-7r11,28-6d1,20-3l1,18-2d5,22-3l3,18-2d4,17-7r11,24-3l5,18-2d4,17-7r10,12-9u1,11-7r5,17-8u1,16-6r13,9-7r6,16-8u1,15-6r13,9-8r5,15-9u1,14-7r1,16-8u1,15-6r12,10-1d5,9-7r17,12-3l1d3,10-7r15,10-2d4,9-7r15,8-2r2,11-1d5,10-7r13,12-11u3,11-7r11,12-14u6,11-7r10,9-10r3,13-11u3,12-7r8,9-12r3,13-13u5,12-7r7,9-11r3,13-12u4,12-7r6,3-9r11,5-10r6,12-11u3,11-7r6,5-2d5,4-8r12,2-7u2,2-6r2,5-5d2,4-8r11,2-3r1,4-2d5,3-8r11,2-5r2,5-4d3,4-8r9,3-3d3,2-7r2,5-6d2,4-9r9,5-11r2,5-12r7,13-13u2,12-10r1,6-16u1l1u1l1u1l1u2d3r6,4-13r5,4-11d2,3-14r5,2-9u3,1-5r3,5-4d4,4-9r5,2-11u5,2-10r6,9-9d3,1-5r3,5-4d4,4-9r4,1-4r3,5-3d5,4-9r3,3-1d7,2-9r4,1-2r3,5-1d7,4-9r1

;12
    #############
    #   ##.##   #
  ### $  ...  $ ###
###   $  ...  $   ###
#   $$$  ...  $$$   #
#  $$    ...    $$  #
# $$     ...     $$ #
# $      ...      $ #
# $$     ...     $$ #
#  $     ...     $  #
## $$$$  ...  $$$$ ##
 #    $  ...  $    #
 #### $  ...  $ ####
 ##   $  ...  $   ##
 #  $$$  ...  $$$  #
 # $$    ...    $$ #
 # $     ...     $ #
 # $$$$. ... .$$$$ #
 #    $ ..... $    #
 #### ###...### ####
    ######.######
         #.#
         #.#
         #@#
         ###
Solution: 15-2l4,10-3u1,5-2r5,15-3l4,10-2d19,5-3r4,10-2d18,5-18r4,10-17d2,15-18l4,10-17d1,14-16d1,15-18l3,11-17d1,6-16d1,5-18r3,9-17d1,2-16r6,9-15d2,18-16l6,11-15d2,17-18u1,18-16l7,10-15d2,16-18u1l3,12-16d1,17-16l5,11-15d1,4-18u1r3,8-16d1,2-17r7,3-14d2,2-17r6,5-13d3,4-17r2,15-13d3,16-17l2,17-14d1,18-16l7,3-16r5,17-14l1d1,17-16l5,15-13d1,16-15l4,2-15r7,4-13d1,3-15r5,5-14r4,16-14l4,15-13l3,4-13r5,15-12l3,5-12r4,5-11r4,15-11l3,2-9r6,9-8d5,3-11u1,2-9r6,9-8d4,4-11u1,3-9r5,9-8d3,5-9d1,4-11r4,4-10r5,1-7r7,2-9u1r6,5-3d1r3,9-5u2,3-4r5,9-5u1,4-6u1r5,10-6u3,3-4r6,10-5u1,1-7r6,8-6d2,7-9r1,2-5d2,1-8r6,8-7d2,7-10r1,2-6r6,2-5r6,15-11u1l3,16-9l5,18-9l6,19-7l8,18-9u1l7,17-11u2,18-8l6,19-7l7,18-5d1l7,17-4d1,18-6l6,17-5l6,15-3d1l5,17-4l6,15-6u2,16-3l4,18-8u3,19-4l7,16-11u5,17-5l5

;13
###################################
#                                 #
# $$$$$$$$$$$$$$$$$$$$$$$$$$$$$$$ #
#                                 #
# $$$$$$$$$$$$$$$$$$$$$$$$$$$$$$$ #
#                                 #
#    $$$$$$$$$$$$$$$$$$$$$$$$$    #
#               . .. .            #
###############. .  . .############
             #. . .. . .#
            #. . .  . . .#
           #. . .    . . .#
          #. . .      . . .#
         #. . .        . . .#
        #. . .          . . .#
   ##  #. . .     #      . . .# ##
   #.##. . .              . . .##.#
   # .. . .      # #       . . .. #
   #  .. .      #   #       . ..  #
   # . ..       ##@##        ..   #
   #.   .       #***#        . .  #
 ##.     .      #* *#       .   .##
 #.             #***#            .#
 ##################################
Solution: 15-5d8,17-14l6,10-13d8,11-22l8,15-3d12,16-16l4,11-15d5,12-21l8,15-1d13,16-15l6,9-14d6,14-5d1,13-7r1,15-6d8,16-15l5,10-14d2,11-17l6,4-18u1,14-3d3,13-7r1,15-6d7,16-14l4,11-13d6,12-20l7,14-1d5,13-7r1,15-6d8,16-15l4,11-14d5,12-20l3,5-5d1,4-7r10,15-6d6,16-13l4,11-12d6,12-19l6,6-5d1,5-7r9,15-6d9,16-16l5,10-15d3,11-19l3,7-5d1,6-7r7,13-7r1,15-6d8,16-15l5,10-14d4,11-19l2,8-5d1,7-7r7,15-6d8,16-15l4,11-14d3,12-18l5,9-5d1,8-7r6,15-6d8,16-15l4,11-14d3,12-18l4,10-5d1,9-7r5,15-6d10,16-17l10,11-5d1,10-7r4,15-6d8,16-15l4,11-14d3,12-18l2,12-5d1r2,15-5d11,16-17l9,11-7r3,15-6d10,16-17l7,2-3d3,1-7r13,15-6d10,16-17l5,3-3d3,2-7r12,15-5d10,16-16l8,4-3d3,3-7r11,15-6d9,16-16l6,5-3d3,4-7r10,15-6d9,16-16l4,6-3d3,5-7r9,15-6d8,16-15l7,7-3d3,6-7r8,15-6d8,16-15l5,8-3d3,7-7r7,15-6d8,16-15l3,9-3d3,8-7r6,15-6d7,16-14l6,10-3d3,9-7r5,15-5d9,15-16u1,16-14l4,11-3d3,10-7r4,15-6d7,16-14l2,12-3d3,11-7r3,15-6d6,16-13l5,13-3d3,12-7r2,15-6d6,16-13l3,2-1d5,1-7r13,15-6d6,16-13l1,3-1d5,2-7r12,15-6d5,16-12l4,4-1d5,3-7r11,15-6d5,16-12l2,5-1d5,4-7r10,15-5d6,22-5d16,21-22r11,22-3d13,21-17r11,33-18u1,22-1d19,21-21r10,29-5d1,30-7l7,22-6d14,21-21r6,23-5d1,24-7l1,22-6d13,21-20r9,23-3d3,24-7l1,22-6d13,21-20r7,23-1d5,24-7l1,22-6d12,21-19r8,28-5d1,29-7l6,22-6d13,22-21u1,21-19r7,27-5d1,28-7l5,22-6d11,21-18r9,26-5d1,27-7l4,22-6d11,21-18r8,25-5d1l2,22-5d12,21-18r6,26-7l3,22-6d10,21-17r10,32-3d3,33-7l10,22-6d10,21-17r9,31-3d3,32-7l9,22-6d10,21-17r7,30-3d3,31-7l8,22-6d10,21-17r5,29-3d3,30-7l7,22-6d10,22-18u1,21-16r8,28-3d3,29-7l6,22-6d9,21-16r6,27-3d3,28-7l5,22-6d9,21-16r4,26-3d3,27-7l4,22-6d8,21-15r7,25-3d3,26-7l3,22-6d8,21-15r5,24-3d3,25-7l2,22-6d9,22-17u1,21-15r3,32-1d5,33-7l10,22-6d7,21-14r6,31-1d5,32-7l9,22-6d7,21-14r4,30-1d5,31-7l8,22-6d7,21-14r2,29-1d5,30-7l7,22-6d6,21-13r5,28-1d5,29-7l6,22-6d6,21-13r3,27-1d5,28-7l5,22-6d6,21-13r1,26-1d5,27-7l4,22-6d5,21-12r4,25-1d5,26-7l3,22-6d5,21-12r2,24-1d5,25-7l2,22-6d5,6-1d5,5-7r9,15-6d4,16-11l3,7-1d5,6-7r8,15-6d4,16-11l1,8-1d5,7-7r7,15-6d3,16-10l2,9-1d5,8-7r6,15-6d3,21-5d5,20-11r4,21-3d7,20-11r2,21-1d9,20-5d4,19-10r4,20-3d6,19-10r2,20-1d8,19-5d3,18-9r4,19-3d5,18-9r2,16-5d5,16-3d5,17-9l2,16-1d7,17-5d4,18-5d3,19-1d7,18-3d3,17-7r4,22-6d1,17-3d4,16-8r3,18-1d5,17-7r3,17-1d5,16-7r2,10-1d5,9-7r7,17-6d1,11-1d5,10-7r4,15-6d1,12-1d5,11-7r6,13-1d5,12-7r3

