;1
 ###############
#################
#################
####         ####
### $  .*.  $ ###
###   * $ *   ###
### $ .   . $ ###
### $ . $ . $ ###
###   ..+..   ###
### $ . $ . $ ###
### $ . $ . $ ###
###   . $ .   ###
### $ *   * $ ###
####         ####
#################
#################
 ###############
Solution: 8-6d1,9-9l1,7-10u1,7-10r1,9-11u2,7-11r2,13-10l2,13-9l2,12-13u3,12-10u1,13-8l2,13-7l2,13-6l2,9-5l1,7-6u1,13-4l3,3-6r2,3-7r2,4-3d1,4-4d3,3-8r2,3-9r2,4-13u1,3-11r2,3-10r2

;2
 ###############
#################
#################
####         ####
### $ ....  $ ###
###   . $ .   ###
### $ *$$$* $ ###
###   . $ .   ###
### $ ..+.  $ ###
###   . $ .   ###
### $ *$$$* $ ###
###   . $ .   ###
### $ ....  $ ###
####         ####
#################
#################
 ###############
Solution: r1u3d2l2u2d1r1u1d2r1u1l1u1r1l6u1r2l2d2r1d1r1u1l1u1r1l2d3r2d1r4u1r2d3l2u2d2l2u2d2r1u2l5d1r1d1r1u1l1u1r1l2d2r2l2d1r2d1r5u2r3d1l5r4u1r1u1l1u1l1d2r1d1l3r3u2r1u5l1d1r1d1l2u4r1d3r1d1l1u1l1d5r1d1l2u1r1u4r1d3r1d1l2

;3
 ###############
#################
#################
####         ####
### $  ..*  $ ###
###   * $ .   ###
###   .       ###
###   . $     ###
### $ . @ $ $ ###
###   . $     ###
###   .       ###
###   * $ .   ###
### $  ..*  $ ###
####         ####
#################
#################
 ###############
Solution: 8-10d1,3-12r3,12-13u1,13-11l2,9-9l2,6-8d1,3-8r2,6-7d1,11-8l4,9-7l2,4-3d2,3-6r2,9-5l1,7-6u1,12-3d1,13-5l4,8-6u1,12-9u3,13-5l2

;4
 ###############
#################
#################
####         ####
### $ *...  $ ###
###   . $ .   ###
### $ .$ $. $ ###
###   .$ $.   ###
### $ . @ * $ ###
###   .$ $.   ###
### $ .$ $. $ ###
###   .   .   ###
### $ *...  $ ###
####         ####
#################
#################
 ###############
Solution: 8-10l1,8-9l1,8-9r1,8-10r1,8-7r1,8-6r1,8-7l1,8-6l1,8-6u1,13-4l3,4-3d1,3-5r3,7-6u1,4-13u1,3-11r6,3-8r2,4-7u1,3-5r2,4-9d1,3-11r2,12-7u1,13-5l2,13-12l5,12-9d2,13-12l4,12-7d4,13-12l3

;5
 ###############
#################
#################
####         ####
### $$*.... $ ###
###   . $ $   ###
###   . $ $   ###
###   . $     ###
### $ ..+.  $ ###
###   . $     ###
###   . $ $   ###
###   . $ $   ###
### $$*.... $ ###
####         ####
#################
#################
 ###############
Solution: 5-3l1r1d1u1l1d2l1d1r2l1u1r1l1d1l1d2r2d2r2d3l2u1d1l1u2l1u1r2l1d1r1d2r4u4l2r2u2l2r2u1l1d1l1u2d1r1u1r1u1r2d1l1d2r1d1l3r1u3r4u1l2d3r2d2l1r1u1l4r2d2l1d1l1u2l1r3d3l1u1l2r1u2l1d2u1l1d1r6d1l2

;6
 ###############
#################
#################
####         ####
### $ *.... $ ###
###   .$      ###
###   .$      ###
###  $.$  $   ###
###   ..+.    ###
###  $.$  $   ###
###   .       ###
###   .$      ###
### $ *$    $ ###
####         ####
#################
#################
 ###############
Solution: 5-8d1,4-10r1,13-4l2,6-5r2,9-6u1,6-6r1,8-7u2,7-8u3,4-3d1,3-5r2,5-8u1,4-6r1,11-7l4,7-10u1,8-8l1,8-11l1,7-13u4,4-13u3,3-9r2,10-10u1,11-8l2,12-13u4,13-8l3

;7
 ###############
#################
#################
####         ####
### $  ...  $ ###
###   . $ .   ###
### $ . $   $ ###
###   . $     ###
### $ . +.  $ ###
###   . $ .   ###
### $ .$ $. $ ###
###   .$ $.   ###
### $  .*.  $ ###
####         ####
#################
#################
 ###############
Solution: r1u1l2r2u1l1d1l1u2d1r1u1r5u1l3r3d2l2d1l1u1l2u1l5u1r2u1r1d1l3d2r2l2d2r2l2d2r2d1r1u1l3d2r3,7-9r1d1l1r1d1l1u1r2d1r3u1r1u1l2u1l3r2u1r3d1l4u1l2d3r2u1l1d2r5d1l2d1l1u1

;8
 ###############
#################
#################
####         ####
### $ *$ $* $ ###
###   . $ .   ###
###   . $ .   ###
###   . $ .   ###
### $ .*+*. $ ###
###   . $ .   ###
###   . $ .   ###
###   . $ .   ###
### $ * $ * $ ###
####         ####
#################
#################
 ###############
Solution: l1,8-8r1,9-9l2,9-10l2,9-11l2,8-13u1,7-11r2,12-13u2,13-10l2,12-7d1,13-9l2,7-7r2,7-6r2,8-4d3,7-3d4,9-3d4,12-3d1,13-5l2,4-3d1,3-5r2,4-9u2,3-6r2,4-13u5,3-7r2

;9
 ###############
#################
#################
####         ####
### $ *...* $ ###
###    $.$    ###
###     .     ###
###    $.$    ###
###  $  +     ###
###    $.$    ###
###     .     ###
###    $.$    ###
### $ *...* $ ###
####         ####
#################
#################
 ###############
Solution: 7-6u1,9-6u1,12-3d1,13-5l4,8-6u1,4-3d1,3-5r4,7-8u1,6-6r1,10-7l1,9-10d1,7-10d1,4-13u1,3-11r4,8-10d1,12-13u1,13-11l4,9-8d1,10-10l1,6-9r1,4-8r3

;10
 ###############
#################
#################
####         ####
### $ ..... $ ###
###    $.$    ###
### $   .$ $  ###
###    $.$    ###
###     +     ###
###     .$    ###
### $.  .$ $  ###
###  .  .$    ###
### $ ..    $ ###
####         ####
#################
#################
 ###############
Solution: 7-6u1,10-6l1u1,8-7u2,13-4l2,3-4r2,4-7u1,3-5r4,7-6d1,6-8r1,10-7l1,12-6l3,3-10r1,4-13u1,3-11r1,13-12l6,11-9d2,12-12l4,10-11l1,10-10l1,10-9l1

;11
 ###############
#################
#################
####         ####
### $ * $ . $ ###
###   . $ .   ###
### $ .  . $  ###
###   . .  $  ###
###   .*@     ###
###   . .$ $  ###
### $ .  . $  ###
###   . $ .$  ###
### $ *   .$  ###
####         ####
#################
#################
 ###############
Solution: 4-13u1,3-11r2,3-10r2,4-3d1,3-5r2,3-6r2,8-8l1,10-9l3,12-7l5,9-4l1,7-3d4,8-4d2,8-12u2,12-10l2,12-11l1,12-12l1,13-4l2,11-7u1,12-5l1,11-10u3,12-6l2

;12
 ###############
#################
#################
####         ####
### $ .     $ ###
###   . $ $   ###
### $ .       ###
###   .   $   ###
###   . @     ###
###   . $ $   ###
### $ .       ###
###   . $ $   ###
### $ ..... $ ###
####         ####
#################
#################
 ###############
Solution: 3-4r2,3-6r2,3-12r2,3-10r2,9-11l2,13-12l5,8-8d3,10-10d1,9-5l2,11-9l4,11-7l4,10-4d3,11-8l4,13-4l3,9-3d8

;13
 ###############
#################
#################
####         ####
### $ $. .$ $ ###
###    . .  $ ###
### $ $.$.$ $ ###
### $ . . . $ ###
### $ . + .   ###
###   . . . $ ###
### $ .   . $ ###
### $ .   . $ ###
### $ . $ . $ ###
####         ####
#################
#################
 ###############
Solution: 3-12r2,3-11r2,3-10r2,6-5d3,3-8r2,3-7r2,8-13u4,13-12l2,13-11l2,13-10l2,13-9l2,10-5d2,8-7d1,8-5d2,11-4l2,8-3d3,13-7l2,13-6l3,13-5l3,13-4l3,5-4r1,3-6r3,4-3d1,3-5r3

;14
 ###############
#################
#################
####         ####
### $ .$$$. $ ###
###   ..  .$  ###
### $$..$$. $ ###
###   . . .   ###
### $ * + * $ ###
###   . . .   ###
### $ .$$.. $ ###
###  $.  ..   ###
### $ .$$$. $ ###
####         ####
#################
#################
 ###############
Solution: 3-4r2,7-3d1,4-7u1,3-5r2,4-6r1,4-11r1,3-12r2,3-10r2,4-9u1,3-7r2,7-11u1,8-9l1,7-13u6,8-11u1,8-5d2,8-3d3,9-5d4,9-13u1,7-12r2,8-4r1,12-5l1,13-6l2,12-3d3,13-7l2,13-10l2,12-13u1,13-11l2,12-7d1,13-9l2

;15
 ###############
#################
#################
####         ####
### $ $...$ $ ###
###   . $ .   ###
### $ . $ . $ ###
###   . $ .   ###
###  $. @ .$  ###
###   . $ .   ###
### $ . $ . $ ###
###   . $ .   ###
### $ $...$ $ ###
####         ####
#################
#################
 ###############
Solution: 5-12r2,3-12r3,11-12l1,9-11l2,9-10l2,9-9l2,12-13u1,13-11l2,13-10l2,11-7d1,12-9l1,7-7r2,7-6r2,7-5r2,11-4l2,13-4l3,12-5d2,13-8l2,4-8r1,5-4r1,3-4r2,6-3d1,3-6r2,4-11u3,3-7r2

;16
 ###############
#################
#################
####         ####
### $ ....  $ ###
###   . $ .   ###
### $ . $ .$  ###
###   . $ .   ###
### $ ..+. $  ###
###   . $$    ###
### $ .  $ $  ###
###   . $$    ###
### $ .     $ ###
####         ####
#################
#################
 ###############
Solution: 9-6l1u1,7-7u2,13-4l3,11-7u1,12-5l1,11-9u2,12-6l1,7-7r2,3-4r2,3-6r2,6-7u1,3-8r2,6-9u2,3-12r2,6-13u5,3-10r2,6-11u2,8-10u1,9-8l1,10-9l3,10-10l3,9-12u3,8-12u3,13-12l6,11-9d1,12-11l5

;17
 ###############
#################
#################
####         ####
### $  ...  $ ###
###   .$ $.   ###
### $ . $ .$  ###
### $ . $ .$  ###
### $ . @ .   ###
### $ . $ .$  ###
### $ . . .$  ###
### $ . $. $  ###
### $  .. . $ ###
####         ####
#################
#################
 ###############
Solution: l1u3r2l2d1r1l1d2r1u3d2r1u2,4-3d1,3-5r2,3-6r2,3-7r2,3-8r2,3-9r2,3-10r2,3-11r2,3-12r3,8-10d1,8-8d1,13-12l2,12-11l2,12-10l1,12-9l1,12-7l1,11-5d2,12-8l1,12-3d2,13-6l2

;18
 ###############
#################
#################
####         ####
### $ ....  $ ###
###  $. $ .   ###
### $ . $ .$  ###
###  $. $ .   ###
### $ .*+* $  ###
###  $. .     ###
### $ .  . $  ###
###  $. $$.   ###
### $ . $ . $ ###
####         ####
#################
#################
 ###############
Solution: 5-10d1,4-13u1r1,3-11r2,3-10r2,4-9r1,3-8r2,4-7r1,3-6r2,4-5r1,3-4r2,7-5r2,7-6r2,8-8u3,9-4l1,13-4l4,11-7u2,12-4l2,11-9u1,12-7l1,7-12r2,8-12u3,9-12u2,10-9l1,12-10l2,13-12l1,11-13u1r1u1l1

;19
 ###############
#################
#################
####         ####
### $  ...  $ ###
###   . $ .   ###
### $ . $  $  ###
###   . $     ###
###    .+.    ###
###     $$.   ###
### $    $.$  ###
###   .$$$.   ###
### $  ...  $ ###
####         ####
#################
#################
 ###############
Solution: 8-10d1,8-10r1d1,7-10d1,3-12r2,6-13u1,13-12l2,10-13u1,11-11u1,12-9l1,9-10u1,8-10u1,9-7l1,7-6d1,4-11u3,3-7r2,3-6r2,3-4r2u1r1d1,9-5l1,7-6u1,8-7u2,13-4l3,11-7u1,12-5l1

;20
 ###############
#################
#################
####         ####
### $ ..... $ ###
###    $.$    ###
###    $.$    ###
###    $.$    ###
### $   +   $ ###
###     .     ###
###     *     ###
###     .     ###
### $   .   $ ###
####         ####
#################
#################
 ###############
Solution: 6-6r1,8-7u2,7-6u1,10-6l1u1,8-7u1,3-4r2,13-4l2,7-8u1,6-6r1,10-7l1,13-8l4,3-8r3,7-7d1,6-9r1,3-12r4,12-13u1,13-11l4

;21
 ###############
#################
#################
####         ####
### $ . $ . $ ###
###   . $ .   ###
### $ . $ . $ ###
###   . $ .   ###
###   . @ .   ###
###   .$$$.   ###
### $ . $ . $ ###
###   .$$$.   ###
### $  ...  $ ###
####         ####
#################
#################
 ###############
Solution: 9-4l2,7-5r2,13-4l2,9-6l2,13-6l2,7-7r2,4-3d1,3-5r2,4-5d1,3-7r2,7-10d1,9-10d1,9-10l1d1,12-11u2,13-8l2,8-8d1r1,8-9l1,6-10u1,12-13u1,13-11l2,7-11u1r2,8-9l1,3-10r2,4-13u1,3-11r2

;22
 ###############
#################
#################
####         ####
### $ . $ . $ ###
###   . $ .   ###
### $ . $ . $ ###
###   . $ .   ###
###   . @ .   ###
###   $. .$   ###
### $  .$.  $ ###
###    . .    ###
### $  $.$  $ ###
####         ####
#################
#################
 ###############
Solution: 9-13u1,6-12r1,3-12r3,7-13u1,9-10l1,9-12u1,13-12l3,9-13u1,11-9l1,5-9r1,3-10r2,6-11u2,13-10l2d1l1u2,9-7l2,3-6r2,3-4r2,9-5l2,8-5d1,7-7r2,7-4r2,12-3d1,13-5l2,13-6l2

;23
 ###############
#################
#################
####         ####
### $ . $ . $ ###
###   . $ .   ###
### $ . $ . $ ###
###   .$.$.   ###
### $$. + .$$ ###
###   . . .   ###
### $  . .  $ ###
###   $.$.$   ###
### $  .$.  $ ###
####         ####
#################
#################
 ###############
Solution: 7-6r2,7-5r2,7-4r2,8-7r1,3-4r2,6-7r1,3-6r2,6-7u1,4-9u2,3-6r2,5-9u1,4-7r1,4-11u2,3-8r2,4-13u3,3-9r2,9-12l1u3,5-11r1,11-11l1,13-12l3,13-10l5,12-7d2,13-10l3,11-7d1,12-9l3,12-5d3,13-9l2,12-3d4,13-8l2

;24
 ###############
#################
#################
####         ####
### $ .   . $ ###
### $ . $ .   ###
###   . $ .   ###
### $  . .  $ ###
### $   +   $ ###
###    .$.    ###
### $ . $ . $ ###
###   .   .   ###
### $ *   * $ ###
####         ####
#################
#################
 ###############
Solution: 12-13u1,13-11l2,13-10l2,7-9r1,8-11u2,4-13u1,3-11r2,3-10r2,3-7r1d1,3-9r3,7-6r2,7-5r2,13-4l2,3-4r2,3-5r2,5-8u1,4-6r1,13-7l5,12-9u1,13-7l3

;25
 ###############
#################
#################
####         ####
### $ .   . $ ###
### $ .   . $ ###
###   .   .   ###
### $  . .  $ ###
###    .+.    ###
### $   .   $ ###
### $   .   $ ###
###   $ . $   ###
### $   *   $ ###
####         ####
#################
#################
 ###############
Solution: 3-4r2,13-4l2,13-5l2,3-5r2,3-7r2,6-8u1,13-7l2,10-8u1,3-9r3,7-10u2,3-10r3,7-11u2,13-9l3,9-10u2,13-10l3,9-11u2,10-12u2,11-9l2,8-10u1,5-11r2,12-13u3,13-9l4,4-13u2,3-10r4

;26
 ###############
#################
#################
####         ####
### $ ..... $ ###
###   $   .   ###
### $    .  $ ###
###  $$$ .  $ ###
###     +     ###
###    . $$$  ###
### $  .    $ ###
###   .   $   ###
### $ ..... $ ###
####         ####
#################
#################
 ###############
Solution: u1d1l1,7-8u3,6-4r2,13-4l2,3-4r4,6-6u1,5-4r1,4-7u2,3-4r2,6-8u2,5-5r4,13-6l3,13-7l3,5-6d1l1d1r3,9-8d3,10-12l2,3-12r2,4-11u1,3-9r3,13-10l5,11-11l4,10-8d3,11-12l2,13-12l3,11-8d3,12-12l1

