;1
  #######
  #     #
### # # ###
# $ $$$@  #
#  ##. #$ #
# $##..#  #
#  .. .#$ #
#  #...#  #
#### ###$##
   #  $   #
   ####   #
      #####
Solution: u2l2d4r1l1r1d2l2u1r1u1d2r1u1l5u2d2r4u5l2d2u2r2d5l4u2r1l1d2r4u5l2d2r1l1u2r2d5l4u3r2l1d1l1d2r5u1l1d1l4u2r1d1l1d2r1u1r3u5l2d2l2d3r1u1d1r3u5l2d2r1l1u2r2d4r1d1l3r2u5r2d2l2r4d2l1u1r1u1l2r2d4l1u2r1u2l2u2l2d5l1d3r3d1r2u1l1u2r1u4l2u2l2d5l1d3r3l3u3r1u5r2d2l1r1u2l4d2l2d3u3r2u2r4d2r2d2l1u1r1u1l2r2d4l1u2r1u2l2u2l4d2l2d3u3r2u2r4d2r2d3u3l2u2l2d4r1d1l2d3r3d1r1u3r1u4l2u2l2d5r1d1l1u1l1d1u1r1u5l2d2r1l1u2r2d4r1d2l2u1r1u5r2d2l1r1u2l2d5l1d1r1u4r1d1u1l5d2r1u1l1u1r3l1u2r2d5u3l4d4r1u1r1l2u2r1d1l1d1r1u3r7d4l1d2l4u1d1r4u2r1u2l1u1r1u1l3r1u2l2d3u1r4d4l1u3r1u1l3r1u2l2d2

;2
  #####
  # @ #
### # #####
# $ $$    #
#  #  .#$ #
# $##*.#  #
#   . .#$ #
#  #...#  #
####.###$##
   #  $   #
   ####   #
      #####
Solution: undefined

;3
 ####
##  #######
#         #
# # ##### #
# #.. $ # ##
#  .# #    #
## .... #$ #
#  ##$###  #
# $$ @  $$ #
#  ######  #
####    ####
Solution: undefined

;4
###########
#   #  #  #
# $@*..*$ #
#   #  #  #
#####.$# ##
#   #. # #
# $ $ $  #
# # #  # #
# $ #.##.#
###  .   #
  ########
Solution: undefined

;5
##### #####
#   ###   #
# $ # $ # #
### $ #.$ #
 #  ...  ##
 #$#.#.#$#
##  ...  #
# $.# $ ###
# # $ # $ #
#   ### @ #
##### #####
Solution: undefined

;6
#####
#   #######
# $.$.$.$ #
###   . . #
# $.$.$.$##
# .$ $#@.#
# $.$.$.$##
###   . . #
# $.$.$.$ #
#   #######
#####
Solution: undefined

;7
    ######
#####    #
# $ $@$# ####
# # ## $    #
# #.$...# # #
#  .  ..#$# #
###.##  # # #
#  .#####   #
# # # $ $$# #
#     #     #
#############
Solution: undefined

;8
    ####
#####  #
# $ $@$######
# # ##      #
# #.$ ..# # #
#  .. .. $# #
###.#   # # #
#   #####   #
# # # $ $$# #
#     #     #
#############
Solution: undefined

;9
##### #####
#...###   #
#.$.    $ #
#.*.# # $ #
# $ # # $ #
# $ # # $ #
### # ##$ #
# $ # #.**#
# $ #$#. .#
#@   $ .*.#
###########
Solution: undefined

;10
    ######
#####.   #
#  $  .$ #
# $#$*$#$#
# .$...$ ##
#. *.@.* .#
## $...$. #
 #$#$*$#$ #
 # $.  $  #
 #   .#####
 ######
Solution: undefined

;11
   ##########
 ###        #
 #   ###### #
 # #.#   .# #
 # .....* # #
 ###*#*#$## #
 # *     ## #
##.# #$# #  #
# *.  $ $$  #
# *# #$# #  #
# $ @ $    ##
#   # $#####
#####  #
    ####
Solution: undefined

;12
    #####
    #   ####
    # # #  #
    # $ # $#
    ##  #  #  ####
     #$ # $#  #  #
#### #  #  #  # $#
#  ###$   $#  #  #
#   ...#   #### $#
# # #@#  #$      #
#.#$$$#     #$$ $#
#.........#   #  #
## ###.#########$#
 #  .*.. #   #   #
 ### #.#   #   #$#
   # $ ######### ##
   # #*           #
   #   ########   #
   #####      #####
Solution: undefined

;13
####         ####
#  ###########  #
#$   $ $ $ $  $ #
#  #$ $ $ $  #  #
# $#        ##$ #
#...#########...#
#.$.#       #.$.#
#...$ $ @ #  ...#
#################
Solution: undefined

;14
   #####
   #   ##########
#### #          #
#  .... ##$$$$# #
# #      #@   # #
# #....###$$$$# #
# #           # #
# ############# #
#               #
#################
Solution: undefined

;15
      #####
#######  @#
# * * * $ #
#  * * *  #
# * * * * #
#  * * *  #
# * * * * #
#  * * *  #
# . * * * #
#   #######
#####
Solution: undefined

;16
##########
#     #  ##
# $ $ $   #
##$## # # #
## #....* #
#  #  .# ##
# $# # @ #
#    #####
######
Solution: undefined

;17
###############
# $. . . . .  #
# # $ $ $ $ @ #
# ########## ##
#            #
##############
Solution: undefined

;18
 #####
##   #########
# $... . . . #
# # $ $ $ $$ #
# ######### ###
#           @ #
########### # #
          #   #
          #####
Solution: undefined

;19
##### #####
#   ###. .#
#  $  .$  #
# $##.$ $.#
## #.$ $.##
 # .$*$. #
##.$ $.# ##
#.$ $.##$ #
#  $.  $@ #
#. .###  ##
##### ####
Solution: undefined

;20
    ####
   ##  ##########
   #  .         #
   # #.## ##### #
####$#. # $   # #
#    . .$$#$#   #
# ##### # #   # #
# #   # # ##### #
# # # .   $   # #
# # $.#.#$#$#   #
# ### # # #   ###
#   # # @ #####
### $ . # $   ###
  ###.#.#$#$#   #
    # #   #   # ###
    # ### #####   #
  ### . # $   # # #
  #  ...#$#$#   # #
  # ##.   #   ### #
  #  ##########   #
  ##            ###
   ##############
Solution: undefined

;21
#####
#   ########
# #$$      #
#. . . . ..#
# #######.##
# $ $ $ $$#
###@      #
  #########
Solution: undefined

;22
 ##########
 #        ###
 # ******@. #
 # *      # #
###****** # #
#       * # #
#  ****** # #
#         # #
###$####### #
  #         #
  ###########
Solution: undefined

;23
 #######
 #     ####
 # ###$*. #
 #    *.# #
### ###.  #
# $ $ #.###
#     #.$ #
##$ $##.# #
 #  $ #.$ #
 ##   @.  #
  ######  #
       ####
Solution: undefined

;24
      ####
    ###  #####
    #        ###
   ##$##. ##$  #
 ###.  ##.$ .# ##
 # $ $ #. #  .$ #
##.#   $$.$.  # #
#  ###$#  #$#$# #
#  .# $ *. . .  ##
##  . . .* $ #.  #
 # #$#$#  #$###  #
 # #  .$.$$   #.##
 # $.  # .# $ $ #
 ## #. $.##  .###
  #  $## .##$##
  ###        #
    #####@ ###
        ####
Solution: undefined

;25
###########
#         #
# ####### #
# #   #   #
# #   $ $ #
# #$#$## ##
#......# #
# #$#$.$ #
# #  @.# #
# # $#.$ #
# #   .###
# ####. #
#    $$ #
######  #
     ####
Solution: undefined

;26
      #####
#######   ##
#          #
# #$***#$# ##
#   # *     #
###   *#### #
  ### *   # #
    ##*## # ##
    # *  @#  #
    # ***..  #
    #     #  #
    ##########
Solution: undefined

;27
    #####
#####   #
#  $  #$#
# #$#.  #
#  $ @ $###
# #$$#$$  #
# # .#. # #
# # ...$# #
# # .#. # #
# ##.#.## #
#    #    #
###########
Solution: undefined

;28
#######
#     ####
# ###.#  #
# # $ # $##
# # #.  $ #
# # $.### #
#   $.$ # #
##$#..*.*.#
# $  .# # #
#   #*  $ #
### #   # #
  # ##### #
  #   @   #
  #########
Solution: undefined

;29
       #####
   #####   ##
   #   $    #
 ###.# $# # #
 # $.  $ .# #
 # #.####.# #
 # #.  $ .  #
 #   ##$#.###
##$### $  #
# * *    ##
# #   #@ #
#   ######
#####
Solution: undefined

