;1
    #####
    #   #
    # # ####
    #  *   #
###### # # ####
#   #  #  *   #
# #$$$ #### # ####
# #... #  #  *   #
# ## #$$$ #### # ####
#    #... # @#  *   #
#### ## #$$$ #### # ##
   #    #... #  #  * #
   #### ## #$$$ #### #
      #    #... #  # #
      #### ## #$$$ # ##
         #    #... #  #
         #### ## #$$$ #
            #    #... #
            #### ## ###
               #    #
               ######
Solution: undefined

;2
     #####
     #   #
     # # ##
    ##  * ###
   ##  #$   ##
#### .. $.#  #
#    .##$$$..#
# # # #   $#.#
#  *$$$ $. ..#
###  .$ .$$$##
  ## #$$ $+ #
   #  .#.$ ##
   ## ...###
    ######
Solution: undefined

;3
#########################
#                       #####
# $ $ $ $ $ $ $ $ $ $ $@$...#
############# ###########$$.#
#.....$  #  $.$ $.$.....$...#
#.$$$$$..*.. .. ..$.$$$$$.$$#
#.....  $$$$$.$.$.$.     ...#
#.$$$$$.....$.$ $.$.$$$$$$$$#
#.....$ $   $.$ $. .....    #
#############################
Solution: u1l10d4l5u1l6r6d1r5d3l2u1l4d1l5r5u2l5u1d2u1r1u1d2u1r2l1u1d1r1u1d1r2d2l3u1d1r3u2l5r5d2l1u1l4r5u1l4r4d1r4d1u1l2d1l4r4u1r2d1l5r7u3l5u1l2d1l1d1u1r1u1r1d1l2d2r1u1d1r5d1r2u3l11r11d2l6d1l1u1l1u2r2d1l3r3u1r1d1u1r1d1u1r1d1u1r1d1u1r2d2l1u1r1u1l6u1l1d1r1d1l2r7u1r5d3r2u2r7l1u2r2u2d2l2d2l6d2l2u3l5r3d2u1l2d1l1r1u1l7r9u1r2d1l4d1l1u1r1u1l5r9d3r2u3l10r10d1l6d1l1u1r1u1l3r8l5u4r10d1r3l1d1u1r1d1u1l3u1l10d4r6d1r7l1u3d3l12u5r10d1r2d4l11u1r1u1l1d2r5u2r4l4d2r6u4l2u1l10d3r1d1l3u1r1d1r7u1r2l2d2r6u4l2u1l10d3r1d1l2r6d1r9u2d2l2u2r1d1l1d1l6d2r8u1d1l8u2l2u2l2r2d1r2u1l2d2r8u2l6d2r1u1d1r3u1r1d1r1u1l1u1r1l1d2l2u1d1l1u1l4u1r1l1d1l2u1r1d1l3r2u1l1d1r2l3d3u2r12u4l2u1l2d1r3l3u1l8d3l1d1r12d1r1u1l10r4d3r6u2d2r2u1l1d1l1u1d1l3r2l1u1d1l2u1d1l2u3r4l1d1l2u1l3d3r2u2d2r5l1u1d1l2u3r3d1l4r4d1r1d1l1u2l2d1u1l2d1l1d1r1l3u2d1r1l1u1l2d2r4l4u2l2d2r5l2u2l1u1r1l3d2r3d1r1u1l3u1l1u5r2d1l1u1l1d5l1d1r4l3u6l2d1r1u1r1d6l1d1r4l3u7r4d1l3u1l1d3l1d1r3l2u3r3u1r3d1l5u1l1d3l1d1r1u4l4d1r3u1r1d4l1d1r2l1u4r5u1r4d1l8u1l1d6u6l6d1r5u1r1d5u4l6u1l2d1r7u1r1d4u3l8u1l2d1r9u1r1d3u2l10u1l2d1r11u1r1d2

;4
   #####
   #   #
   # $ ##
#####$  #####
#   # # #   #
# $   #   $ #
##$#  @. #$##
#  ####.## #
# $ . .    #
# ##.#.#.#$##
# .#...#$$. #
##        # #
 #  # $$#   #
 ####   #####
    #####
Solution: r1d2l3d3l2u1l1u2r3d2r2u2r2l2d3l1d2r2l2u3r1u2l2d3r1d2r1u3d1l1u1l1u2r4l4d3r2d1u1r3d1r2u2d2l2u1l4u1l1u2r2d3u3r2d1u1l2d3r2u1d1u1r1l1d1l2u3r2d2r1d1l3u1l2d1l2u1l1u2r3d2r2u1d2u3r2d3r1d1r2u1d1l2u1l3u3d2l2u2r2d3u1d1l2r1d2r2l1u2r2u3l2d3l1d2r2u1d1l2u3r1u2r2d3l2u1l2d1u1r2d1r1d2l2u2l1u1r1d1r1u1d1r1d2l1r1u2l1u1d1r3d1r2u2l1r1d2l2u1l4u1l1u2l3d2r1d1r2u1r2d1r2u3l4d3u1r2d1r3d1r2u2l2d1l3u1l2r1d1u1l1u2r4d2r1d1l3u1l2u2r6d1u1l3r1d2r1d2r2u2l2d1u1r1u2l2d2u2l4d2r2d1r2u1r3d2l2u1l3u1l2r2l2d1l2u1l1u2r3d2r2d1l2r3d2l2u2r1l2u3l3d2r1d1r3d2r2u2l1u1l1d1l1u1d1l2u1l1u2r4l4d2r1d1r6u3l1u2l1r1d2r1d3l6u1l1u2r7d3r1d1r2u2l2d1l3u1l2d1l2u1l1u2r7d2r1d1l2d2l2u2d2r2u2l1u1l1r1d1r1d2l1u2d1l1u1l3r6u3d2r2u2l3u2r1u1r1u1r2d1l1d4u1l2d3r1d1r2u2l1u2l3u2r1u1r1l2d3r1d3l6u1l1u2r7l3r2u2l3u1l1u1l2d1r1d2l1d1r1l1d2r1d1r6u3l1u2l3u1l1r2d1r3l1d2r1d3l6u1l1u2r4l4d2r1d1r6u3l1u2l3u1l1u1l1d3l1d1r2l2d2r1d1r7d1r2u2l2d1l7u1l1u2r1u3r2d1r3d2r1d2r1l1r1d1l2r1u3r1l2u2r1u1r1u1r2d1l1d4u1l2d3u3l1u2r1u1r1l1d1l1d2r1d3r1d1r2u2l2d1l1u1d1l5d1l1u1r6u1r2u2l3u3r2u1r1d5u2d1l3u2l1r1u3l1u2l2d1r1d3l1d1r2l1u3r2d3u3l2u2r1d1l1d4r2u3l1u1l1d3l1d1r2

;5
           ##### ####
           #   ###  #  ####
           #       $####  #
      ##########$#..    $ #
 ##   #           .#####  #
###   #  $ $ $ $ # #.  # ##
##    #  ######### #.#$# #
##   #####    #    #.  # ###
##   #   # ## #*####.#$#   ##
##   # # #  #   #   .  # #  #
###  # # ## ###.# ##.#$# #  #
 ##### #  #      .# .  # #  #
  #### ## #####$# $ .#$# # ##
     #  #      @# $#.  # #  #
     ## #########$.....     #
      # #        $ $ $$# #  #
      #   ############   ####
      #####          #####
Solution: undefined

;6
###########################
#                         #
# ########### ########### #
# #         # #         # #
# # ##### # # # # ##### # #
# # #   #   # #   #   # # #
# # # # ##### ##### # # # #
# # #    *   $   *    # # #
# # ### $ * * * * $ ### # #
# #   #*   * # *   *#   # #
# # # # * #  .  # * # # # #
# #   #  * .   . *  #   # #
# ##### *         * ##### #
#      $ #.  @  .# $      #
# ##### *         * ##### #
# #   #  * .   . *  #   # #
# # # # * #  .  # * # # # #
# #   #*   * # *   *#   # #
# # ### $ * * * * $ ### # #
# # #    *   $   *    # # #
# # # # ##### ##### # # # #
# # #   #   # #   #   # # #
# # ##### # # # # ##### # #
# #         # #         # #
# ########### ########### #
#                         #
###########################
Solution: undefined

;7
 ######
 #    ##############
 # ## #            #
 # # .# ########## #
 # #$  $ $ $ $ $ # #
 # # .  . . . . .  #
 # #$  # $      ####
 # # .  .  $ # $  #
 # #$  $  . . . # #
 # # .  .    $ $# #
 # #$ $   @.  . # #
 # # . . .  $  $# #
 #  $ # $  .  . # #
####      $ #  $# #
#  . . . . .  . # #
# # $ $ $ $ $  $# #
# ########## #. # #
#            # ## #
##############    #
             ######
Solution: undefined

;8
 ######
 #    ##############
 # ## #            #
 # # .# ########## #
 # #$ #$ $ $ $ $ # #
 # # .# . . . . .  #
 # #$ #  ### #######
 # # .  .# $   $  #
 # #$ #$ $. . . # #
 # # .# .  $## $# #
 # #$ ##$ @. #. # #
 # # . . .$ $# $# #
 #  $   $ #.  . # #
####### ###  # $# #
#  . . . . . #. # #
# # $ $ $ $ $# $# #
# ########## #. # #
#            # ## #
##############    #
             ######
Solution: undefined

;9
   ####
   #  #
   #  #####
   #      #####
 #### # #     #
 #  #. .# $ $ #
##    . #  $  #
#   #. .##$ $##
#   # . #  $  #
#####. .# $ $ #
    # . #  $  #
    ### ### ###
     #  @     #
     #  ###   #
     #  # #####
     ####
Solution: undefined

;10
    #############
 #  #           # ####
# # # $ $ $ $ $ # #  ##
# # ########### ### @ #
 #   # . . . . .      #
 #   #           ### ##
 #  ## ########### # #
 #  # . . . . . #  # #
##### $ $ $ $ $ #  # #
 #  ########### ## # #
 #   # . . . . . # # #
 #  ## $ $ $ $ $ # # #
 # # ########### ### #
 ##   #              #
 #    #   #########  #
      #####       ####
Solution: undefined

;11
                     #############
                  ###################
                #######################
              ###########################
             #############################
            ###############################
           ######       #######       ######
          ###### $  $ $   ####  $ $ $   #####
          #####  $$$ $$$ $ ##  $$$ $$  $ #####
     #########   #     # $   $ #     # $ #########
   ########### $###   ###$ $$$###   ###$  ##########
 ####   ######  #########     #########   #####   ####
 ##     ###### $###    ##$   $##    ###   #####     ##
###    #######      $    $$$$$   $     $  ######    ###
##      ###### $$$$$ $$$$$   $$$$ $$$$$ #######      ##
##      #######          $   $         ########      ##
###    #########$$$$$$$  $$$$$$ $$$$$$$ ########    ###
 ###    #######     $ $ #  $  # $        ######    ###
  ####  #####         $$#     #$$   $  $  #####  ####
   ##########           $$$$$$$ $$$$$$$$$$##########
      ######   ....    .........    ....   #####
        ####    ...    .........    ....   ####
        ####    .......................    ####
        #####    .....................     ####
        ######     .................      #####
        #######      ......+......       ######
   ##############                     ##############
  ##################               ##################
  ###################################################
   #################################################
        #######################################
        #######################################
        #######################################
        #######################################
         ######################################
               ######     ####    ######
               ######     ###     ######
               ######    ###      ######
                ####    ####       ####
                       ####
                       ###
                      ###
                      ###
                      ###
                      ###
                       ###
                       ###
Solution: undefined

;12
 #########
## . . . ##
#  $$$$$  #
#.$$...$$.#
# $.$.$.$ #
#.$..$..$.#
# $.$.$.$ #
#.$$...$$.#
#  $$$$$. #
## . + . ##
 #########
Solution: undefined

;13
    #########
 ####       ##
 #    #####  #
 # ####   ## ###
 # # . @ . #   #
 # #.#.#.#.### ##
 #   . # .   #  #
####.#.#.#.# ## #
#    . # . #  # #
# ## $ # $ ## # #
# # $ $#$ $   # #
# #  $ # $ #### #
# # $ $#$ $#    #
# #  $ # $   ####
# #### #   ###
#      #####
########
Solution: undefined

;14
 ############
## $......$ #
#..$.$$$$.$ #
#.$$.$. #.$ #
#.$..$.$..$ #
#.$.#$.$$.$ #
#.$. ...$.$ #
#.$.#$$$$.$ #
#.$.... #.$ #
#.$$$$$$$.$ #
#.........$ #
# $$$$$$$$$ #
###        @#
  ###########
Solution: undefined

;15
 ##########
 #        #
##$$$$$$$ #
#  #..#.$ #
#  ##...$ #
#  #...#$ #
##$$ $.$  #
#  ..#.*#@##
#  .###.$  #
###        #
  ##########
Solution: undefined

;16
###########
#   #     #
# $ $   $ #
### #### ####
  #  $ # $  #
###.#$      #
#  .  #.##$##
# $.#$ . $ #
###. $@.#  #
#  .#$#.## ##
# $... . $  #
### $$#...  #
  ###   #####
    #####
Solution: undefined

;17
  ####
  #  ####
### $#  #####
# $   $ $ $ #
#   # $ $ $ #
##### # # # #
 #  # $ # $.#
 #.....+....#
 #.#$$ #   ##
 #   ### # #
 ##### #   #
       #####
Solution: undefined

;18
      #####
      #   #
  ##### . #####
  #.  $$.$$  .#
  # .  $.$ #. #
  # #.#$.$ .  #
###$  .$.$.# $###
#  $$$$#.#$$$$  #
# ......@...... #
#  $$$$#.#$$$$  #
###$ #.$.$.  $###
  #  . $.$#.# #
  # .# $.$  . #
  #.  $$.$$  .#
  ##### . #####
      #####
Solution: undefined

;19
      #####
     ##   #
     #  # #####
 ##### ## #   #
 #  $ . $$$   #
 # #$#.## #####
 # # #..+.    #
 # #....# ### #
## ## #.$$$ # #
#   $$$.# $ # #
#   # #     # #
##### ####### #
    #         #
    ###########
Solution: undefined

;20
              #####
        ####  #   ##########
 ########  #  # #          #
 #         #  #   #######  #
 #  ###### #  ### #     # ##
 ## #    # #    # ##### # #
  # # #### #    # #   # # ####
### # #....#    # # $$# #    #
# $ # #.$$ ###### #  @# #    #
#   # #.$   #   # ##$$# ### ##
## ## #.$$$ #      #  #   # #
 # #  #... ####.#  #$ ### # #
 # # ####.......#  #    # # #
 # # #  ##$$$$$###### $ # # #
 # # #  $  $  .       $ # # #
 # # #   #.....########## # #
 # # ##$$#######          # #
## #  #  #        ######### #
#  #### ## ########         #
# $      ###         #####  #
#  ###        #####  #   ####
#### #######  #   ####
           ####
Solution: undefined

;21
   #############
   #           # #####
#### ######### ###   #
#    #.......#       #
# ####........  ### ##
# #   ........###@  #
# #  #........#   # ##
# ## #........# $$$  #
#  # #........#   #  #
## # ########## $$$  #
 # #          #   ####
 # # #$$$$$$$$# $$#  #
 #   #        #    $ #
 #####$$$$$$$ # $$#  #
     #        #   #$ #
     # $$$$$$$# $$#  #
     #        #   #$ #
     # $$$$$$ #####  #
     #     # $ $ $ $ #
     ####            #
        ##############
Solution: undefined

;22
###########
# $ $  . .#
#  $ # #. #
# $ $@ . .#
#  $ # #. #
##$ $  . .##
 #.$.$.$.$ #
 #$.$.$.$. #
 #.$.$.$.$ #
 #         #
 ###########
Solution: undefined

;23
###########
#         #
#$$$$$$$$.#
#.. #.....#
# .$# $$ $#
# . # $ $ #
# .@#.....#
# .## $  .#
# ..$$$$ $#
###   #   #
  #########
Solution: undefined

;24
#######
#     #####
# $$$$$.$.#
# @#....$.#
## #.$$$$.#
#  #......#
# ####.#$###
#  #  . $  #
## $$$.$$  #
 # #  #   ##
 #    # # #
 ######   #
      #####
Solution: undefined

;25
 #########
 #   #   #########
 # $@* . # . # . #####
###$## $ * . # . #   #
#  $ ##$## $ * . # # ##
#  . * $ ##$## $ *    #
## . # . * $ ##$## $  #
 # . # . # . * $ ##$# #
 ##### . # . # . * $  #
     #########   #   ##
             #########
Solution: undefined

;26
    ####
#####  #####
#    ...   #
# ###  $ # #
# # ###$## ####
# # #  $ #@   #
# # # #...$ # #
# # # ##  $## ####
# # #     $...$  #
# # #####  # #$  #
# #     ####  $  #
# #####    #### ##
#     ####    # ##
#####    ###### #
    ####        #
       ##########
Solution: undefined

;27
########
#     .##
# $  #. ###
## ###.$+ #
# $..*.$# #
#  .$  $  #
###.$ #####
  ## $$ #
   #    #
   #  ###
   ####
Solution: undefined

;28
  ##########
###     #  #
# $*.$#...$##
# .   $$# * #
##.#$.# $ . #
# .$    . $ #
# #$# @ #$# #
# $ .    $. #
# . $ #.$#.##
# * #$$   . #
##$...#$.*$ #
 #  #     ###
 ##########
Solution: undefined

;29
 #####
 #   #######
 # $ $  #  #
## # $     #
#  $ $# #  #
#  $@$  #  #
## ### ## ##
 #....... #
 ##  #  # ##
  #        #
  #  ###   #
  #### #####
Solution: undefined

;30
      #######
  #####     #
  # @ # ### #
###$$$$$  # #
#     # # # #
# ###...  # #
# # $.#.### #
# # #... #  #
# #    # # ##
# ##$# $ # #
#  #   ### #
## #####   #
 #       ###
 #########
Solution: undefined

;31
      ##########
      #        #
      # ###### ##     #####
      #      #  #######   #
    ### #$#  ## #    $  # #
    #   $.$   # #   $.# # #
    # #$...$# # #  $..  # #
    # $..$..$ # # $..$# # #
  ###$..$@$..$# #$..$   # #
 ## $..$ # $..$ $..$#     #
## $..$ ### $..$..$   #####
#  ..$ ## ## $...$#####
# #.$  #   ## $.$ #
#  $  ##    #  $  #
##  ###     ##  ###
 ####        ####
Solution: undefined

;32
 ###########
 #         #
 # *.*+*.* #
 # *  #  * #
## $#####$ ##
#  . # # .  #
#  $ # # $  #
###$#####$###
 # .  #  . #
 # .$$.$$. #
 #         #
 ###########
Solution: undefined

;33
 ##########
 #   .#   #
 # $ .#$@ #
###$#. $$ #
#  $ ..#  #
# #$$#.####
#    #.#
####  .#
   #####
Solution: undefined

;34
####
#  #
#  # #####
# $###   #
##     $ #
 #$###@####
 #  ....  #
##$#.## # ####
#  #.#  #    ##
# $#* $$#$$$  #
#  #.#     #$ #
#....   #     #
####  #########
   ####
Solution: undefined

;35
     ###########
  ####         ####
  #  # ####### #  #
  #       $       #
  # ######$###### #
  # #     $     # #
  # #. $ #$# $ .# #
### #.####.####.# ###
# $.      +      .$ #
#   # ######### #   #
##### #   #   # #####
    # # $   $ # #
  ### ###.#.### ###
  #       #       #
  #  ###  #  ###  #
  #### #  #  # ####
       #######
Solution: undefined

;36
 #######
 # @#  #
##$$$$ #
#   #  #
# .... #
## # ###
 #   #
 #####
Solution: undefined

;37
 ########
 #   #  ####
 #   $     ######
 ### # ###      #
   # . $ ###### #
   # # #   $  # #
   # # #.##$# # #
   # # #  # # # ###
#### # #.$# # #   #
#  $$# #  # # ### #
# #.$.. .$# #   # #
#  . # #  # ### # #
## #$$*##$#   # # #
 # # #... + # # # #
 # #   # #.$  # # #
 # ##### # #### # #
 #       #      # #
 ####### ######## #
       #          #
       ############
Solution: undefined

;38
   #############
 ###     *     ####
 #   ### # ###    ##
 # ###   *   ####  #
## #   ## ##    ## #
#  # ###   ####  # #
# ## # $$#..  ## # #
# #  #  .$$$# .#$# #
# # ###.#$@ . .    #
#   # $.$.$$##.#####
#*#*  # $ #  #$ #
#   # ... ...  $###
# # ###$# # ##$$  #
# #  #.  $   # ## #
# ## #   # $ ..#  #
#  # ######### # ##
## #     *     # #
 # ##### # ##### #
 #       *       #
 #################
Solution: undefined

;39
              #
             # #
            #   #
         # #     # #
        #.#   #   # #
       #. .  # #     #
      #  .$.#   #$ $  #
     # # $. .# #  $ $# #
    #.  # $. .#  $ $ $  #
   #. .$ # $.# #  $ $ $  #
    #.$.$ . #   #  $ $  #
   # $. .$ *  * .   $ $  #
  #   #. .#  * * .#   #   #
 #   # #.#  * * *  # # #   #
#   #   #  * *@* *  #   #   #
 #   # # #  * * *  #.# #   #
  #   #   #  * *  #. .#   #
   #  $ $ .   *  * $. .$ #
    #  $ $ .#   # . $.$.#
   #  $ $ $  # #.$ # $. .#
    #  $ $ $  #. .$ #  .#
     # #$ $  # #. .$ # #
      #  $ $#   #.$.  #
       #     # #  . .#
        # #   #   #.#
         # #     # #
            #   #
             # #
              #
Solution: undefined

;40
########
#  #   ######
#  #$#   #  #
#   . .# #$ #
#  $ #. $   #
###$##.#$# ####
# @$  .....   #
# #$##.# #### #
#  $ #.# #  # #
###$. .# #  # #
#   #$## #  # #
#  $        # #
## $#####  ## #
 #  #   # ##  #
 ####   #    ##
        ######
Solution: undefined

;41
  #############
  #           #
  # ######### #
  # #   #   # #
  # # $   $ # #
  # #.# ##$ # #
  #  ..    ## #
### #.####.#  #
#   # $ @..$ ##
# ###### #.###
# # $ $  # #
# #      $ #
# ######## #
#          #
############
Solution: undefined

;42
  #############
  #           #
  # ######### #
  # #   #   # #
  # # $   $ # #
  # #.####$## #
  #  ..    #  #
### #.####.# ##
#   # $ @..$ #
# ###### #.# #
# # $ $  # # #
# #      $   #
# ######## ###
#          #
############
Solution: undefined

;43
  #############
  #           #
  # ######### #
  # #   #   # #
  # # $   $ # #
  # #.####$## #
  #  ..    #  #
### #.####.# ##
#   # $ @..# #
# ###### #.# #
# # $ $  # # #
# #      $ $ #
# ######## ###
#          #
############
Solution: undefined

;44
      ################
  #####              ####
  #  #  ############    #
  #    $ $ $ $ $ $ #### #
### # #. . . . . . .  # #
#     ## ####.#$##$#  # #
#  #   $ #  $$#    #  # #
# #### $. .##.##.#+ *## #
# #  ###*###.    ###  # #
# #          #*#   $  # #
# # $######### #####    #
# #                ##*###
# #  ########  # #    #
# ####      #### ######
#      ####      #
########  ########
Solution: undefined

;45
  ###########################
  ##################  #######
  ##                       ##
  ##     # #       # #     ##
  ##     # ##     ## #     ##
  ##     # # #   # # #     ##
  ##     # #  # #  # #     ##
  ##     # #   #  ## #     ##
  ###    # ##      # #    ###
   ###   #    # #        ###
    ###  # # ##### # #  ###
     ###   # #   # #   ###
      ###### #   # ######
       ##### #   # #####
           # #   # #
           # #   # #
           # #   # #
           # #   # #
           # #   # #
           # #  ## #      ####
############ #  #  ########  #
#            #  #            #
#  ########  #  ############ #
## #      ####             # #
 # #                       # #
 # #                       # #
 # #                       # #
 # #   #################   # #
 # #   #      #        #   # #
 # #  ##$ $ $ # # . . .#   # ##
 # ####  $ $ $#  . . . #####  #
 #      $ $ $ @ # . . .       #
 #  ###  $ $ $#  . . . ########
 #### ##$ $ $ # # . . .#
       #        #      #
       #################
Solution: undefined

;46
#########
#   @   #
# #$$$# #
# $...$ #
# $...$ #
#.#...#.#
# $$#$$ #
#   #   #
#########
Solution: undefined

;47
      ########
    ###      #
    #   #### #
    # ###  # #
    # #    # #
    # $ $ $# ####
##########.#    #
#    #.....#### #
# ##.#.$$$$$  # #
# #  $.#  .$  # #
# #  $.#@#.$  # #
# #  $.  #.$  # #
# #  $$$$$.#.## #
# ####.....#    #
#    #.##########
#### #$ $ $ #
   # #    # #
   # #  ### #
   # ####   #
   #      ###
   ########
Solution: undefined

;48
#######
#     #
#   # #####
##  #     #
 # ###### ####
##     ...   #
#   ##$$#$$# ##
# #   $...$   #
#   $$$.*.$$$ #
#####.###+#.###
    #       #
   ##. ######
   #   #
   #   #
   #####
Solution: undefined

;49
     ########
     #      ########
     # ####        #######
###### #  ######## #     #
#    #    #      # #     #
# $$$# #**    *  # #...  #
#@$      #######      .  #
# $$$# #  *    **# #...  #
#    # #      #    #     #
###### ########  # #     #
     #        #### #######
     ########      #
            ########
Solution: undefined

;50
 #####
##   #####
#  .  #  #
#  .$    #
###.###  ######
  # #   $     #
  # ##  ### # ###
  # #   # # $   #
 ##.### # # ### #
 # .$ @ # # #   #
 # .  # ### ## ##
 ###  # $   #  #
   ######## # ##
          # $  #
          #    #
          ######
Solution: 7-5r4,13-5l1,12-5l4,7-6u1,5-3l1,3-4u1,7-5u1,8-3l4,5-9l1,3-10u5,2-3r1,3-3d6,5-3l1,2-2r1d6,5-2l1,7-11r3,11-12u4,11-8u2,12-5l4,7-6u2,8-3l4,2-2r1d5,5-2l1,13-7l1,11-8u2,12-5l4,7-6u2,8-3l3,5-3l1,2-2r1,3-2d1,5-2l1,13-13l1,11-14u6,11-8u2,12-5l4,7-6u2,8-3l4

