;1
 #######
##  @  ##
# . $ $ #
# .$#$  #
# . ..  #
#  $#$  #
# .$.$. #
##     ##
 #######
Solution: 6-1d1,5-2l2d1,4-4l1,2-5u1,4-6l1u1,4-4l1,6-6l1u1,6-4l1,5-2d1,6-2d3

;2
 #######
##  @  ##
# .$  $ #
# .$# $ #
# .$..$ #
#  $# $ #
# . . . #
##     ##
 #######
Solution: 4-4l1,2-5u1,4-2l1d1,4-4l1d1,4-6l1,7-4l2,6-4d1,7-6l2,7-2l1d3,5-1d2

;3
   #####
  ## @ ##
### $.$ ###
# . . . . #
# $$$ $$$ #
# . . . . #
### $.$ ###
  ##   ##
   #####
Solution: 8-3d1,7-5u1,6-3r1,2-3d1,3-5u1,4-3l1,4-3d1,4-1d1,3-6r1,6-5u1,7-2l1,6-7u1

;4
#########
#       #
# .  $. #
# .$..$ #
# . .$. #
# $$$$$ #
# $...$ #
#      @#
#########
Solution: 4-3l1,3-6u3,4-2l1,1-6r1u1,4-4d1,6-4l1,7-3l2,4-2r1,5-6u2,7-6l1u1

;5
#########
#       #
#  $.*  #
# *$.$$ #
# ..*.. #
# $$.$* #
#  *.$  #
#      @#
#########
Solution: 6-2d1l1,2-2r1d1,2-6u1r1,6-6l1u1

;6
 #######
##  @  ##
# .$.$. #
# $###$ #
#  .#.  #
# $###$ #
# .$.$. #
##     ##
 #######
Solution: 6-6u1,7-4l1,4-6r1,2-6r1,2-4d1,2-2d1,1-4r1,4-2l1,6-2l1,6-4u1

;7
#########
#   @   #
# $$.$$ #
# ..$.. #
# .$ $. #
# ..$.. #
# $$.$$ #
#       #
#########
Solution: 5-5l1,4-4u1,4-4r1,4-4l1,5-1d1,6-1d1,3-1d1,2-1d1,5-7u1,6-7u1,2-7u1r1

;8
  #####
 ## @ ##
##  $$ ##
# $...  #
# .$*$. #
#  ...$ #
## $$  ##
 ##   ##
  #####
Solution: d1,2-2d1,3-5u1,6-6u1,5-3d1,4-7u1,3-7u1,5-1d1

;9
  #####
 ## @ ##
## $$$ ##
#  ...  #
# .$*$. #
#  .*.  #
## $ $ ##
 ##   ##
  #####
Solution: 3-1d1,3-5r1u1r1,4-4l1,5-1d1l1d1,6-6l1,4-7u1,3-7u1,2-2r1,4-1d1

;10
  #####
 ## @ ##
## $ $ ##
# $...  #
# .$*$. #
#  ...$ #
## $ $ ##
 ##   ##
  #####
Solution: 3-1d1,2-2d1,5-7u1,6-6u1l1,5-3d1,2-3r1,5-1d1,3-5u1,3-7u1

;11
    #####
#####   ##
#  # $ $ ##
#    ...$ #
#  #.$*$. #
##   ...  #
 #$##$ $ ##
 #    @ ##
 ########
Solution: 7-3d1,7-1d1,8-2d1,2-7u3,8-6l1,4-2r1,6-1d1,1-3r2,4-2d1,5-5u1,6-7u1,5-7u1

;12
  #####
 ## @ ##
##  $$ ##
# $...  #
# .$$$. #
#  ...$ #
##  $  ##
 ##   ##
  #####
Solution: 5-3d1,3-3d1,6-6u1,4-7u1,5-4l2,1-3r1,4-1d1,5-1d1

;13
#########
#...$...#
#$$   $ #
#. $$$ .#
#.$$@$$.#
#. $$$ .#
# $   $$#
#...$...#
#########
Solution: d1l1d2l2u5d1r1u1l1d5r2u2r1l2d1r1d1l1u3l1u2r2u1r1d1r2d1r1u1l1r1d4u1l1d1l3u1l1d1r3d1l1u2d1r3u4l3d3r2l3d1r1u1r1d1r1u4l2d1r2l2d1r2l4r1u2d1l1

;14
###############
#             #
# $$$ $$$ $$$ #
# $   $@$ $   #
# $   * $   $ #
# $$*.*** $$$ #
#....   ....  #
#.$$$ . $$$.$ #
#....   ....  #
#   .....     #
#    ...      #
#             #
###############
Solution: d6,7-1d7,6-9r1,4-6d2,4-4d3,3-6d1,2-6d1,3-4l1,1-3d4,3-3l1,1-2d4,3-1d2,4-4d1,4-4d1,4-4l2,1-3d2,2-4d1,3-4d1,7-5l1,5-4d5,7-3l1d6,9-4l1,7-3d5,6-1d7,5-2d6,10-6d1,9-6d1,8-6d1,13-7l6,11-4d3,13-5l1,11-4d2,13-4l1,11-3d2,10-4d1,11-3l1,9-2d3,8-4d1,9-2l1d2,7-1d3,4-1d4,1-2r2,5-1d1,4-1d3,11-1d1,12-3l6,5-1d3,11-2l4,6-1d3,13-2l6,6-1d2

;15
###############
#             #
# $$$ $$$ $$$ #
# $   $@$ $   #
# $   $.$   $ #
# $$$.***.$$$ #
# ....   .... #
# .$$$ . $$$. #
# .... $ .... #
#    .....    #
#     ...     #
#             #
###############
Solution: 7-4d2,6-8r1,8-7d2,9-6d1,10-6d1,11-6d1,9-7d1,7-6d3,5-6d2,4-6d1,3-6d1,7-4l1,5-3d4,7-1d7,6-4d5,9-4l1d4,7-3d3,10-4d1,11-4d1,13-4l1d3,12-1d5,10-4r1,12-3d2,3-4d1,4-4d1,1-4r1d3,3-3d1,4-5l1,2-4d2,7-2l1d6,11-3l1,9-2d5,11-1d3,12-5l2,9-4d1,7-3r1,9-2d2,9-2l1,7-1d3,11-2l2,8-1d3,4-1d1r2,7-1d2,3-3r2,6-2d2,1-3r3,5-2d3,2-1d4,2-2r2,5-1d3

;16
###############
#             #
# $$$ $$$ $$$ #
# $   $@$ $   #
# $ # $.$ # $ #
# $$$.***.$$$ #
# ....   .... #
# .$$$ . $$$. #
# .... $ .... #
#    .....    #
####  ...  ####
   #       #
   #########
Solution: 7-4d2,8-8l1,6-7d2,7-6d3,9-6d1,10-6d1,11-6d1,11-4d2,12-7l3,8-6d3,9-7d1,5-6d2,4-6d1,3-6d1,7-1d7,5-4r1d4,7-3d3,9-4l1d4,11-5l1,9-4d3,1-3r3,5-2d5,3-4d1r1,5-4d1,6-6l1,1-5r3,2-3d4,2-1d5,4-1d1,5-3l2,2-2d3,5-4d1,7-3d1,13-4l1d3,12-1d5,11-3d2,10-6r1,7-3r1,9-2d3,8-6r1,11-1d4,11-2l1,9-1d4,11-3l1,9-2d2,8-1d3,5-3r1,7-2d1,6-1d3,2-2r2,5-1d3

;17
###############
#             #
# $$$$$$$$$$$ #
# $    @    $ #
# $ ##$.$## $ #
# $  .***.  $ #
# ....   .... #
# .$$$ . $$$. #
# .... $ .... #
# $  ..... $  #
#### $...$ ####
   #       #
   #########
Solution: d3r1d1l1u1l1d3u2r1d2l3d2r1u1d1r5u1l1u2r3d1l2u1l6d1r1u1l4d1r3u1r2u2l1d1u1l1d1u1l1d1l2u6r2d4r1d2l2u1r2d1r2u1r1u1l1r1u2l1d1r1d3l6u3r1d3l1u5r1d4u3r1d2l1d1r1l1u5r1d4u4r4d7u7l2d1r1u1r1d5u4l4u1l1d4u2r4d1r1d1r1l1d1r2d1u1r1d1u1r1d1l2u1l2u2l1u2r1d2u1r1d5u5l1u2r1d3u3r3d4u4r2d5l3r3u2l1d1r1d1l2r2u4l1d4u1d2u4l1d2r1u4l2d1l2u1l1d2u1r4u1r1d5u4l3d1r2u1r1d3

;18
#########
#       #
# $...$ #
# $$.$  #
# ..... #
# $$$$$ #
# $...$ #
#      @#
#########
Solution: 7-2l2,5-4u1,3-4u1,1-3r2,5-6u1,3-6u1,4-6u1,7-6l1u1,1-6r2,2-4d1,1-6r1,2-1d2

;19
 #######
##  @  ##
# .$.$. #
# $$# $ #
# .. .. #
# $ #$$ #
# .$.$. #
##     ##
 #######
Solution: 6-6l1u1,6-4d1,6-2d1,4-2r1,2-2r1,2-4d1,3-7u2,2-4u1,5-3d1,4-4l1,5-6u1,3-2d1

;20
#########
#   @   #
# $$. $ #
#  .$.  #
# .$.$. #
#  .$.  #
# $ .$  #
#       #
#########
Solution: 3-3d1,4-4u1,3-1d1,2-1d2,4-6u1,5-5u1,6-1d2,5-7u1,1-6r2

;21
 #######
##  @  ##
# .$.$. #
# $$  $ #
# .. .. #
# $  $$ #
# .$.$. #
##     ##
 #######
Solution: 6-6u1,4-6r1,2-6r1,2-4d1,2-2d1,4-2l1d1,5-6u1,4-2r1,7-3l2,4-4u1

;22
#########
#       #
# .$ $. #
# .$..$ #
# ...$. #
# $$$$$ #
# $...$ #
#      @#
#########
Solution: 6-4u1,5-1d1,4-2l1,4-3l1,3-6u1,4-6u2,6-4l1,1-6r1u1,7-6l2,5-4d1,6-6u1

;23
 #######
##  @  ##
# .$ $. #
# $# #  #
# .   . #
#  # #$ #
# .$ $. #
##     ##
 #######
Solution: l2d2u2r2d5l1d1r3u2d2l2u1r1l1u4r1l2

;24
    ###
  ## @ ##
###  $  ###
#  $...   #
#   $*$   #
#   ...$  #
###  $  ###
  ##   ##
    ###
Solution: d1,4-3d1,5-7u1,6-5u1,8-5l1,2-3r1

;25
  #####
 ## @ ##
##  $  ##
# $...  #
#  $*$  #
#  ...$ #
##  $  ##
 ##   ##
  #####
Solution: d1,3-3d1,5-5u1,7-5l1,4-7u1,1-3r1

;26
   #####
  ## @ ##
### $ $ ###
# .$. .$. #
# $.   .$ #
# .$. .$. #
### $ $ ###
  ##   ##
   #####
Solution: 6-1d1,7-2d1,8-5u1l1,6-5r1,5-4r1,6-7u1,4-1d1,3-2d1,2-5u1r1,5-4l1,4-5l1,4-7u1

;27
 #######
##  @  ##
# ... $ #
#  $#$$ #
#   ..$ #
#  $#$$ #
# . . . #
##     ##
 #######
Solution: 7-4l2d1,3-4d1,4-6l1,6-6l1,6-4d1,7-2l4,5-4u1,6-2l1,6-2d1,7-4l1,3-4u1

;28
 #######
##  @  ##
# ...$$ #
#  $#$  #
#   ..  #
# $$#$  #
# .$. . #
##     ##
 #######
Solution: 3-4u1,6-1d1l1,2-6u3,4-6l1u1,2-4r1,5-4d1,6-6l1,6-2d3,5-2d1

;29
 #######
##  @  ##
# ...$  #
#  $#$$ #
# .   . #
#  $#$$ #
#  $... #
##     ##
 #######
Solution: 6-2l3,3-4u1,5-4u1,6-2l1,2-6r1u1,4-4l1,5-4d1,6-4d1,6-2d1

;30
#################################
#                               #
# $$$$ $    $$$$   $$$$      $  #
# $    $    $          $$$$   $ #
# $$$  $    $$$  $$$     ....   #
# $    $    $       ............#
# $$$$ $$$$ $      .###        .#
#        .         .     ###  . #
#     .......       ...$....... #
#.....       ......   . .     $ #
#. # #  ...    # # .  .$.       #
#.....       ......   . .     $ #
#     ....... . #.    .$. $$$ $ #
#       ...    .  .   . .  #  $ #
#               .  .  .$..$$$ $ #
# $  *  $$$ $$$... .  .  . #  $ #
# $ $ $ $ $  .*   .....$ .$$$ $ #
# $ $ $ $ $ ..$          .    $ #
# $  $  $@$.**$....$ $ $ . #  $ #
# $ $ $ $ $ *.       .....### $ #
# $ $ $ $ $ $..###...      #    #
# $ $ $ $ $ $  ...            $ #
# $  $  $$$ $$$   $$$$$$$$ $ $  #
#                               #
#################################
Solution: u7,30-2d2,29-1d3,30-10u2,29-12r1u3,31-13u7,29-19r1d1r1u13,28-13u4r1u1l1d2l3d3r1u4d2r2d1l1u1l2d2r1u3r1u1l1d1l1u1l3u2r2d1l1r1d2l1r1d2l1r1d2l2d1l2u1r1d2r1d1r2u1l1r1d4l1u4r1u1l1u11r4u2l4d6r1d1l1d10l2u5l1u1r1d6l2u7l1u1r3,17-3d4l1d1r4l3u5r1d4l1d1r2l1u5r1d3l1u5r1d4u4r1d3u3r1d3u3r1d3u1r1u1r1d2r1d1l1u3r1d1l1d1r3l2u1r1u1r1d1,11-3r14u1r1d2l1d1r2,28-15u4l1u1r1d1r1u2,28-17u8,23-6u1r1u2l2d1r3,26-15u5r1u1l2d1l1u4l1u1r3,26-17u7r1u1l2d1l1u4l1u1r2,28-14l3d1l1u9l1u1r1,28-16l3d1l1u12l1u1r1,24-23u17,23-23u17,31-17l5u1l1d1,30-19u1r1u1l5r5u1l5r5u2l5u1l1d1r4d2r1u1r1u1l5r4u1r1u1l6d1l1u4,26-22d1l1u3d3r3u1l3d1l1u13,30-22l5d1l1u12,31-21l6d1l1u10,21-23u3d2r2d1r1u10,19-23u2d1r4d1r1u9,17-22r6d1r1u8,18-20r5d1r1u1,20-19r2,11-21r10d1r1u2,12-23u1l1u1r9d1r1u2,13-23u1l1u1r5d1r1u1l5d1r6d1r1u2l9u2r7u1r1d1l8d1r2,9-21r7,7-21r8,8-23u1l1u1r7d2l5u1l1u1r4d1r1u1l1u2l1u2r2d1r4l4u2r7l9u2r1d1l1d1r8l7u2r1d1l1d1r6l4d1l1d1r3l2u1l3d1r4l2u3r5,9-15r8d1r1u1l1u1r1,9-22r2d1r1u4l1u1r3,9-18r3,9-19r2,7-18r4,9-17r3l3u1r8,10-21u2l1u1r1l3u2d1r4l4u1r6l6u1r9,4-18r5d1r1u2l1r1u1l1u1r6,4-15r10,5-16r7,6-18u3l1u1r10,5-23u9l1u1r13d1r1u1r1u1l1,1-15r8d1r1u4l1u1r9u1r2d2l1u1,15-1d7l1d1r3,13-3d5l1d1r4,14-3d5l1d1r2,14-1d7l1d1r1,13-1d7l1d1r1,7-20r1u6l1u1r10,9-21u7l1u1r6,5-20r1u8l1u1r12,7-21u9l1u1r10,6-22u10l1u1r10,3-17r1u5l1u1r11,5-18u2,11-5r1d5l1r1l1d1r2,13-4d6,12-3d8l1d1r2,11-2r1u1r1d7,10-5d2l1d1r2,9-5d2l1d1r2,8-5d2l1d1r2,6-2r2u1r1d6,6-3r2u1r1d4,6-4r1u1r1d5l1d2r2l2u2r1d1l1d1r1,6-5r1u1r1d7l1r1l1d1r4,7-4d7l1d1r4,3-21r6d1r1u9,3-20r6d1r1u7,3-19r5d1r1u7,1-22r7d1r1u9,1-17r1u5l1u1r1,5-16u4,2-17r2d1r1u2,1-18r6d1r1u6,1-19r6d1r1u6,1-20r5d1r1u8,2-22u10,4-5d5u4r3u1r1d4,1-5r6u1r1d3,2-5d3,3-5d3,4-3d5,5-1d7,1-3r5u1r1d5,3-3d4l1d1r3u1r1d4,3-4l1u1l1d7,3-1d3r1d1l2u2l1d6,3-2l1u1l1d7,3-2r2u1r1d6

;31
#################################
#                               #
# $$$$ $    $$$$   $$$$      $  #
# $    $    $          $$$$   $ #
# $$$  $    $$$  $$$     ....   #
# $    $    $       ............#
# $$$$ $$$$ $      .           .#
#        .         .          . #
#     .......       ...$....... #
#.....       ......   . .     $ #
#.      ...        .  .$.       #
#.....       ......   . .     $ #
#     ....... . #.    .$. $$$ $ #
#       ...    .  .   . .     $ #
#               .  .  .$..$$$ $ #
# $  *  $$$ $$$... .  .  .    $ #
# $ $ $ $ $  .*   .....$ .$$$ $ #
# $ $ $ $ $ ..$          .    $ #
# $  $  $@$.**$....$ $ $ .    $ #
# $ $ $ $ $ *.       .....    $ #
# $ $ $ $ $ $..   ...           #
# $ $ $ $ $ $  ...            $ #
# $  $  $$$ $$$   $$$$$$$$ $ $  #
#                               #
#################################
Solution: u7,30-10u2,22-8r7,28-13u4,27-13u4,26-13u4,29-23u14,29-21r1d1r1u16,29-19r1d1r1u13,30-2d2,29-1d3,23-2d2l1d1r5,24-2d1l1d1r4,25-2d1l1d1r2,26-2d1,27-9u3,26-9u3,27-15u6,26-15u6,29-14l3d1l1u10,27-17u1l1d1l1u11,29-16l3d1l1u8,28-15l2,31-14l5,22-14r1,31-13l6u1l2,31-12l6,31-11l6,22-10r1,31-16l5,31-17l5,31-18l5,30-16u6r1u1l6,25-23u3,24-16l1,22-17u3,23-19u3r1u1l1d1l1u1,21-19u2,22-23u7,23-23u3,24-23u3,28-22l5d1l1u6,18-18r3u1r1d1,21-23u3,20-23u2,19-23u2,18-23u2,17-3d4l1d1r7,18-3d1l1d1r6,19-3d1l1d1r4,22-1d3,21-1d3,20-1d3,19-1d4,11-21r5l5u1r4u1r1d1l1d3l2u2d1r1d1r1u1l1u1l2u1l1u4r8l6d1r5d1r1u1l3d2l3u2l1u1r5l4d2r4u1l6d1r5u1l5d3r2l2u1d1r1u1l1u1r4l2d3l2d1r1d1r1u2d1l1u5r1u3l1u1r4d1r1u1d1l4d1r5u1l3d2l3u1l1u1r7l10r1d1r7u1l9d1r8l6d4r3l3u1r5l5u1r3l3u1r4l2d7l2u8l1u1r7l11d1r10l7d1r5l5d1r4l4d1r5l2d1l1d3r2d1r1u4d3l3u1r2d1r1u2d1l2u2l1u1r1d5l3u1r1d1r1u9l1u1r9,7-20r1u6l1u1r7,9-21u9l1u1r13,8-22u9l1u1r6,13-3d7l1d1r5,13-1d7l1d1r9,14-3d6l1d1r8,14-1d9l1d1r3,15-1d9l4u5r6u1r1d3l1d1r4,12-5d2l1d1r9,11-3r1d4l1d1r8,13-2d4l1d1r6,14-11r1,12-1d8l1d1r7,4-22r4d1r1u9d1l4d1r4d1r1u3d1l5d2r2d1r1u4d9l3u3r1u7l1u1r6l4d4r1d5l1u8l1u1r4,6-22u9l1u1r4,5-19u7l1u1r10,3-17r1u5l1u1r10,5-18u6l1u1r8l4u1r1,3-20r1u7l1u1r5,4-22u9l1u1r4,5-21u5l2u2l2d2r1u5l1u1r7,1-18r1u7l1u1r6,1-20r1u7l1u1r5,1-22r1u9l1u1r4l1d5l1u5l1u1r2d8l1u7l1u1r1d6r1d4l1u9d1r1d9l1d1l1u11l1u3r10u1r1u3l3d3l1d1r9l8u3r7u1r1d3,6-5r9u1r1d4,7-5d3l1d1r8l3u4l3d3l1d1r6,6-3r6u1r1d6,7-3d4l1d1r5,7-1d6l1d1r4,1-5r8u1r1d3u3l5d4u3l1d3u3l1d3u3l1d3l1u5r7u1r1d4u3l5d4l1d1r5,3-3d4l1d1r5,5-1d6l1d1r2,3-4l1u1l1d7,3-1d6r1d1l2u1l1d2u1r1u3r1u3l1u1l1d7u7r3d6l1d1r2

;32
  #####
 ## @ ##
## $ $ ##
#  ...  #
#  $*$  #
#  ...  #
## $ $ ##
 ##   ##
  #####
Solution: 5-1d1,6-3l1,5-5u1,3-3d1,2-6r1,5-7u1,4-7u1,3-1d1

;33
 #########
##   @   ##
# $$   $. #
#   $$.$. #
# $.. . . #
# $ $$. $ #
# .... $  #
##       ##
 #########
Solution: 6-3r1,6-2r1,8-6u1,5-4d1,4-4d1,3-1d4,1-4r1d1,4-2d1r1,8-6l1,6-7u1,6-2d1,1-2r4,6-1d1

;34
#################################
#                               #
# $$$$$$$$$$$ $$$$$$$$$$$ $$$$$ #
#                               #
# $$$$$#$$$$$#$$$$$#$$$$$#$$$$$ #
#                               #
# $$$$$ $$$$$ $$$$$ $$$$$  ...$ #
#                     .....   . #
#  ###         ###   .       .$ #
#          .         .  ###  .$ #
#       .......      .       .$ #
# .......     ......  .. .....$ #
# .#####  ...  #@###.  . .    $ #
# .......     ......   . . ## $ #
# $      ..... .  .  # .#. ## $ #
# $       ...   .  .   . . ## $ #
# $ ### ### ###  .  .  . .    $ #
# $ #   # # #  ..  ..... ...  $ #
# $ ### ### # ..           .  $ #
# $          ... .....   ...  $ #
# $           ..       ..     $ #
# $            ..   ...       $ #
# $$$$$$$$$$$$$$$...$$$$$$$$$$$ #
#                               #
#################################
Solution: 21-23u1l1,23-23u1l2d1l1u1,23-22u1,25-23u2r1u1l1,25-23l3r3u1l2d1l1u1d1r9u4l11,26-23r2u3r1u1l8,26-23r1u3r1u1l6,26-23u3r1u1l1,31-21l4d1l1u2d2u1r4u1r1u1l3r3u1l3d5r1u4r2u2l11r10d2l1u1r1u1l9,30-23u5r1u1l9r9u2l1d1r1d1l8r8u4l1d3r1d1l5r4u3l1d2r1d1l3r4u6l5r3d5r1d1l2,25-10d4,30-11d4r1d1l5,15-23u1r2d1l3u4d2r2u1r1d1l2d2l3u3l1u1r3d1r1u2d3l3d1r3d1r1u1,1-19r16,1-20r13,1-21r13,2-23u3l1u1r15,3-23u3l1u1r12l1u1r1u1r1l1d1,4-23u3l1u1r10d1r1u2l1u1r1,11-23l6u3l1u1r9d1r1u1,11-23l5u3l1u1r8,11-23l3u3l1u1r5,11-23l1u2l1u1r4l3d3r1u10,7-23u9,8-22r2d1r1u7,10-15r8u1r1d1l1d1r4u1r1d1,1-15r15u1r1d1,2-15u1l1u1r4l4d3r1l1d2r1u4l1u1r3l2d4r1u3l1u1r1l1d6r1u5,2-5d7,2-3d8,2-1d9,6-5d5r1d1l3,4-5d1r1u1r1d5r1d1l2,3-7r2u1r1d4r1d1l1,2-6r4u1r1d5r1d1,6-3d7,8-5d7,8-3d7,8-1d8,9-5d8,9-3d6,11-11d3,10-5d9,10-3d10,10-1d10,8-2u1d1r1u1r1d8,11-5d8,11-3d8,11-1d8,12-5d9,12-3d10,12-1d10,3-3d3l1d1r8u1r1d2,4-3d3l1d1r8u1r1d3,14-5d7l1d1u1r1d1l1d1r1,14-3d9l1d1r1,14-1d11,5-3d3l1d1r8u1r1d7,4-1d5l1d1r10u1r1d4,3-1d5l1d1r10u1r1d3,5-1d5l1d1r9u1r1d3u4r4d5r1d1l3r2,18-3d7r1d1l2,18-1d9r1d1l1u1l2d4u4r2d1l1u1l1d2,16-5d1r1u1r1d5r1d1l2,15-7r2u1r1d4r1d1l1,14-6r3u1r1d5u5r2d9u1r2d2l3d1l1u1,20-3d11,21-15l1,20-1d14,18-2r1u1r1d11r1d1l3,16-3d3l1d1r3u1r1d4,16-4u1r1d3l1d1r3u1r1d6r1d1l2,15-3d3l1d1r5u1r1d6r1d1l1,6-1d5l1d1r14u1r1d5,23-5d10,23-3d11,23-1d12,21-5d4,21-3d5,21-1d6,22-5l1d1u1r1d5u3l1u4r1d3u2l1u2r1u1r1d11,16-1d1r6u1r1d10,14-2r8u1r1d9,6-2r16u1r1d5u1d1r2u1r1d1r1d1l1u1l2d1r2u1r1d5r1d1l2u1l1d2,27-3d8r1d1l2u1l1d1,27-1d10r1d1l2,25-2r1u1r1d9r1d1l2,26-2d4r1d1l1u4l2d3u1l1u3r2u1r1d5,15-3r11u1r1d8r1d1l1u8r2d7u6l1u1l1d7u3r4d1l1r1d1l1r1d1l1r1u4l2u1l1d5u3r3u4l1d3r1u5l1d4r1d1l3u1l1u4r1d4u4r1d4

;35
#################################
#                               #
# $$$ $$$ $$$ $$ $$  $  $$$     #
# $   $ $ $   $ $ $ $ $ $       #
# $   $ @ $$$ $ $ $ $ $ $       #
# $   $ $   $ $ $ $ $ $ $       #
# $$$ $$$ $$$ $ $ $ $ $ $$$...  #
#                     .....   . #
# ### ### ### #####  .       .  #
#          .         .  ###  .# #
#       .......      .       .# #
# .......     ......  ..#.....# #
# . ###   ...  ###  .  . .      #
# .......     ......# #.#. # #  #
#        ..... .  .  # . .  #   #
# $ $$$ $ ..*$$ .  .# #.#. # #$ #
# $ $   $   $    .  .  . .    $ #
# $ $$ #$ # $$ ..  ..... ...  $ #
# $ $   $   $ ..           .  $ #
# $ $$$ $$$ $...#.....#  ...  $ #
# $           ..       ..     $ #
#              ..   ...         #
# #$$$$$$$$$$$$  ...   $$$$$$$# #
#                               #
#################################
Solution: l1d1r1u1r1d6r1d1l7r2u4l4u2r3u1r1d6r1d1l2u2l3u4r2d1r1u1r1d4l1d1u1r1d1r1d1l1u1l4u3r3u1r1d4u5r3u1r1d6l1d1r9,25-5d2l1d1r2u1r1d3r1d1l2u1l1d4r1u3r1u3l2u2r1u1r1d6r1d1l2u1l1d2u2,23-5r3u1r1d7r1d1l2u1l1d1,23-6r6u1r1d1,23-3r5u1r1d8u4l6u2r5u1r1d6,25-1d6l1d1r2u1r1d4r1d1l2,25-2r1u1r1d9r1d1l2,23-2r5u1r1d7,21-6r5u1r1d5r1d1l1,21-5r5u1r1d6,21-4r6u1r1d7,21-3r8u1r2d1l1u1l1d5,19-6r9,19-5r8u1r1d1,19-4r7u1r1d2,19-3r6u1r1d4,21-1d5l1d1r4,17-6r5u1r1d9,17-5r5u1r1d9,17-4r6l6u1r5u1r1d10,15-3r7u1r1d9,15-4r7u1r1d7u7r1,15-5r7u1r1d2u3r1d3,15-6r6u1r1d5,17-1d5l1d1r5,17-2r2u1r1d10l13,7-5d1r1u1r1d5r1d1l2,6-7r2u1r1d4r1d1l1,5-6r3u1r1d7r1d1l6,1-6r7u1r1d7r1d1l5,7-1d5l1d1r2u1r1d3r1d1l1,11-3l1,9-1d11r1d1l4,13-5l3,9-4d5,11-5d1r1u1r1d4r1d1l3u1l2u2r3u1r1d5r1d1l3r1u1r1u4l4u2d1r3u1r1d6r1d1l2,11-3d1r1u1r1d8r1d1l1u5l3u2r2u1r1d5r1d1l2r1u3l4u3r3u1r1d6r1d1l1u9l2d5l1d1r2u1r1d3,13-6r5u1r1d5r1d1l5,12-5r6u1r1d4r1d1l8,13-4r5u1r1d7r1d1l4,13-3r5u1r1d7r1d1l5,14-1d5l1d1r5u1r1d4r1d1l3,14-1r6l6d1r6u1r1d8,11-2r9u1r1d7,9-2r11u1r1d6,7-3r11u1r1d8r1d1l2,7-2r11u1r1d9r1d1l1u1l1d2r1d1l4,5-4r13u1r1d7r1d1l1u1l1d2r1d1l3,5-3r13u1r1d8r1d1l1u1l1d2r1d1l2,5-2r13u1r1d9r1d1l1u1l1d2r1d1l1,1-4r17u1r1d7r1d1l1u1l1d3,1-3r16u1d1r1u1r1d8r1d1l1u1l1d2,3-1d5l1d1r16u1r1d4r1d1l1,3-2r15u1r1d11,1-2r17u1r1d9,31-16l7,30-14d1r1d1l5,31-17l3,31-18l3,31-19l3,31-20l4d1l1u3,24-23u5r1u1l1,25-23u5,26-23u3,28-23u2r1u1l3d1l1u1d3r4u2r1u1l5d3l2u2r5d1l5d1l1u1,3-23u1,2-21r18,4-23u1,3-21r16,6-23u1,5-21r10,13-23u1r5u2d2l3u1d2r4u3l1u1r2,15-21r3d1r2u2d2l2u1r1u1l7d1r6,7-23u1l1u1r11,5-23u1l1u1r12d1r1u2d2r1u2d2r1u2,11-23u1r7,9-23u1r8,6-22r10,10-21r5,8-21r6,6-16u2,9-16l1u2r1u1l1,11-19r3,10-18r4,13-16d3l1d1r2,9-18d1r4,8-20r5,11-17r10,13-16d1l2u1r8l6u1r5l4d1l3u2r3l3d1r4,6-16r10,7-18r6,7-19r5l4u3l1u1r4,3-16r10u1r1d1l1r1l1d1r7,1-16r13u1r1d1l1d1r5,3-18r8d1r1u1l1u1r7,4-18u1l1u1r11u1r1d1l1d1r1,6-18u1d1l1u1l1u1r10u1r1d1,2-16u3,4-16u1r6l7u1r9,5-20u1r3d1r1u4l1u2r1l1d1r1,5-19u4l1u1r7,4-20u5l1u1r7l9d4r2l1u4d3r1d2r1u4l1u1r6,1-20r7d1r1u6,1-19r6d1r1u6

;36
#################################
#                               #
# $$$$$$$$$$$ $$$$$$$$$$$ $$$$$ #
#                               #
# $$$$$ $$$$$ $$$$$ $$$$$ $$$$$ #
#                               #
# $$$$$ $$$$$ $$$$$ $$$$$  ...$ #
#                     .....   . #
#                    .       .$ #
#          .         .       .$ #
#       .......      .       .$ #
# .......     ......  .. .....$ #
# .       ...   @   .  . .    $ #
# .......     ......   . .    $ #
# $      ..... .  .    . .    $ #
# $       ...   .  .   . .    $ #
# $              .  .  . .    $ #
# $            ..  ..... ...  $ #
# $           ..           .  $ #
# $          ... .....   ...  $ #
# $           ..       ..     $ #
# $            ..   ...       $ #
# $$$$$$$$$$$$$$$...$$$$$$$$$$$ #
#                               #
#################################
Solution: 15-23u1r2,21-23u1l1,23-23u2d1l2d1l1u1,25-23u2r1u1l1d2l1d1l1r1u1l1d1l1u1d1r4u3r1u1l1d4r5u6l5r5u1l5r5u1l5r5u1l5r5u1l5r5u1l5r5u1l5r1l1d12r1u11r1u1l1r4d8l4d4r1u5r1u1l2r4d1l3r3d2l3d1l1u1d3r2u5r1u1l2r3d5l1u10r1u1l3r2d12l1u11r1u1l1r2u3l1u1l1d3u2r2d1l1r1d1l1,13-23u1r3l3r1u1r1l1d2l3u1r3d1r1u1l2u1l1u1r2l1d2l2u2l1u1r10,1-20r12,10-23u3l1u1r10,1-19r17,9-23u3l1u1r9,1-15r1u3l1d5r1u4l1d6r1u5d1r1d1r1u4d6l1u6,3-23u9,4-23u3l1u1r13,1-22r2d1r1u9,2-22u2l1u1r13,5-23u3l1u1r9,8-23l2u3l1u1r7,8-23l1u4l1u1r8,8-23u4l1u1r6,5-5d7,5-3d7,6-5d7,6-3d7,7-1d11,6-1d8l1d1r1u1r1d1,8-5d7,8-3d7,8-1d8,9-5d8,9-3d6,10-5d9,10-3d10,10-1d10,8-2r1u1d1u1r1d8,11-5d9,12-5d9,12-3d10,11-3d10,11-1d10,12-1d10,3-5d1r7u1r1d4,2-7r8u1r1d2,1-6r10u1r1d4,3-3d1r9u1r1d10,2-5r10u1r1d5,14-5d7,14-3d7,14-1d8,15-5d11,15-3d10,15-1d11,1-4r13u1r1d7,16-5d11,16-3d11,16-1d11,4-1d1r11u1r1d9,17-5d10,17-3d9,17-1d9,18-5d8,18-3d9,18-1d9,19-1d15,3-3r15u1r1d12,2-1d1r16u1r1d11,1-3r17u1r1d8,20-5d11,20-3d12,20-1d10,21-5d11,21-3d6,21-1d7,22-5d11,22-3d7,22-1d5,23-5d2r1d1l2r1u3r1d1r1u3l2d13u11l1u4r1d14u5r2u3l1u1l1d8u3r1u5r1u2l2u1l2d1r1u1r1d10,25-2l1u1l1d11,30-5d1,30-3d2r1d1l7u1l1d6,30-1d4r1d1l7u1l1d5,29-3d4,29-1d4u2l1d2r1u4l1d3r1d1l5u1l1d2u3r4d2u1l3u1l2d1r1u1r1d3u5r2d5u2r2u3d1l2u1l1d5

