;1
############
#@         #
# ... $ .$ #
# .#.$$ $$ #
# . . $. $ #
# ... $$$$ #
#          #
############
Solution: 7-2l4,2-1d1,5-4u1,6-2l3,7-3l2,10-2l6,7-4l4,7-6u1l4,7-3d1,10-4l5,9-4u1,10-2l5,8-4u1,7-6u1,9-6u1l5,9-3d1,10-5l5

;2
#############
#@          #
# $.$..$.*. #
# *.$$$$..$ #
# $....$$$. #
# .$*$*$.$. #
#           #
#############
Solution: r10d3l1u1r1u2l5d1r1u1r4d5l10u5r2d1r2l2d2r2u1l1u2l3d1r1l1d4r3u1l1d1l2u2r1l1d2r10u3l3r3d3l3u1r1d1r2u3l3d1r1d2l4u1d1r4u2l2r2d2l1u1r1u2l1d1l1u1r2d3l2u1l2r2d1r2u3r2u2l7d2r4d1r1d2l1u1r1d1r2u5l7d2r3d1u1l3u2r7d5l3u1l1u2r1d1u1l4u2r3d1u1l3d2r3

;3
###############
#@            #
# . $ .$   $. #
# . $ .$   $. #
# .#$$.#$$$#. #
# .$  .$   $. #
# .##$.## ##. #
# .  $.$   $. #
#             #
###############
Solution: r4d2l2u1l1d1u1l1d6r5u1l3d1l1u1d1r4u3l3r2l1u1d1r2u2l3u2r2d1l2r3d4u1l1d1r1d1l3d1r7u1l3d1l1u1r3u2l2r2d3l4u3l1u1r1u3r3d1l1r1d1l1r2d3u5r4d7l3u1l3r2u2r2l2d3r4u4l1d1l3u2r1d1l1d1r2l1u2r1l1u2r2d2l2u1r1u1r1d1l2d3l2u1r1u1d1l1u1l1u1r4l2d5r2

;4
################
#@             #
# $.....*....$ #
# .$$$$$$$$$$. #
# . $ $ $ $ $. #
# .$........$. #
# .$$$$$$ $$$. #
# .$ ..$.$..$. #
#              #
################
Solution: d7r3u1l1d1r8u1r1d1l4u1l2r3u2r3l1d1r1l1u3d1r1u1r2u1d6l5u5r3d2l2u1r2d4r2u4l3r3u1l1r1u2l1r1d3u3l1d2r1d5l2u4l1u1r1d2l3u1r1u1r1d1r1d2l1r1u1d1l1u1d1r1d2l3u2r1l1d2r1u2d2r2u1l1r1u2l1d1r1l3d1u2l2u1r1d1r1d1r3u3l1d1u1l2d1l1d2u1l2d1u1r1u2d2l2u2d1r1u1r1l1d2r2d1r1d2l6r1u2l1d2l2u4r2u1d1r1u1r1d1r1d2r1d2l4u4r1l3u3r1d3r2u1l1r5d1l5r4d4r2u2l1r1d2l2u2r1l1d2l3r3u2r1u2r4d4l8u2r1l2r3u1r1l1d1l2d2r3u2d1u1r5d2r2u7l8d3r4u1l3d1l1u1

;5
##############
#@           #
# $.$.  . $. #
#  $.. . $.  #
# $.$. .$.   #
#    $.$.$ $ #
#    $$. .$. #
#   $..$ $.$ #
#  $. . $.$. #
# $.     $ $ #
# . .   $ $  #
##############
Solution: r2d1r1u1l3d2r3l1d2r1u1d1l3u1r1l1u2r1u1r10l11d6u1r3u2r2d2u2l2d1r1l3d1l1d4r4u5d3l1r1u2l2d1r1l2d1r1l2d1r2d1r2u1l1r3u1d1l2d1l4u4r6u2d1u1l1u3r6d3l4r2u1l1d1l1u1r1u1r1u1r2d1l1u1d2r1d3l1u3r1d5l1u3r1d2l2r2d3l1u1l2d1l6r6u1r2d1l6r4u2l2u1d3r1u4r1u1d1u1r2d1l1r2d3l4u1r1l1u1r1d2r2u1l1r2u2l1d1u1r1u3l1d2r1u4l2d1

;6
#########
#@      #
# $.$.$ #
#.*..$. #
# $.$.$ #
#.$$$$$ #
# ...$. #
# . $.$ #
#########
Solution: r2d2u2r4d5l2d1l2r2u1r2d1l1u1l3u2d2u2d2r4u3l2d2u2r2d3u5l4d4l1r2d1r1l1u1l1u4r4d5l2r2u5l4d2l1r1d2l1u1r1u3r2d3l1r1u1l1r3d1l1r1d2l1r1u5l1d1r1d2l1u1r1d3l1u1r1u4l2d2l1d2r1u2r2d1l1d1l2r3u4l3d1u1r2d1u1l5d1r1

;7
   ########
####@     ###
#   .$$$$.  #
# $$.$..$$$ #
# *..#.#..* #
# $. . . .$ #
# $$$..$#$* #
# ..$*$$..  #
###       ###
  #########
Solution: undefined

;8
   ########
####@     ###
#  $.$$$$.  #
# $$.$..$$$ #
# *..#.#..* #
# $. . . .$ #
# $$$..$#$* #
# ..$*$$..  #
###   .   ###
  #########
Solution: undefined

;9
   ########
####@     ###
#  $.$$$$.  #
# $$.$..$$$ #
# *..#.#..* #
# $. .*. .$ #
# $$$..$#$* #
# ..$*$$..  #
###   .   ###
  #########
Solution: undefined

;10
###################
#                 #
# ######$######   #
# #. .  $  $  #. .#
# #     $  $ $    #
# #...# $ .#.$#. .#
# #. .  $  $ $ @  #
# ### # $ .# $#. .#
#       $  $ $    #
####  .####$  #####
   #   #  #   #
   #####  #####
Solution: d2r1u4l3u1l2r2d1r2d4u7l14d7r4u2r2u1r2u2l5r5d1l4u1l1d1r1d1l1d1r3u1r2d1l5r5d2l1u3r1u1l4u1l1d1r1d4u2r3d2l2d1l1u3d1u1r3u1d3l7u7r8l1d4r1u1l4d4l1d1r1u1r4u2l3r1d2l2u2r3u5r7d3l2u1l4r4d1r2u3l7d4r1d1l3r2u5r9d7l3r1u2l2u1l1u1d1r1d1r2u2l2u1l7r7d2l1u1r3u3l7d3r8u1r1d3l2u2l3r1u1l4r3d1r3u3l7d2l1d1r8u1r1d1l1d1r1d3l3u3d1r2u5l7d2r3d1r3l1d2r2u2d2l2d1l1u2r1u2l2d1r2d2r2u3d3l2u2r1l1d2u2l4d2r5l1d2r2l2u4r2d1r1u1l1u1r1d4l1u2d3l2d1l1u2r1u3l4d2r5l1d2r2u1r1u2l1d1r1u3l1d1r1u3l1d1u1l8r1d7r3l1u2r3d3u1d1l1u4r1u1l1u1l2d3l1d2r3d2l1u1r1u5l1u1l1d1l1d4r2d1r1u3

;11
###################
#                 #
# ######$######   #
# #. .  $  $  #. .#
# #   $ $  $ $    #
# #...#.$..#.$#. .#
# #. .$ $  $ $ @  #
# ### #.$ .# $#. .#
#     $ $  $ $    #
####  .####$  #####
   #   #  #   #
   #####  #####
Solution: u1d2u6l14d7r4u5r2d1l3d1l1u1r4d2l3r3d2l1d1l1u4d1r2u2l2u1l1d1r1d1l1r1u1r2u1d1u1r1l1d2r1l1d2r1u1r2u2l5u1l1d1r6u1l4r2d2u1r2d2l4r1d2l2u2r5d2l3r1u1d1l2r1u2l2d2l1d1r1u1r4u1r1u1l4r1d2l6u7r7d2r1d1l1u1l1d1r1d3r1u1d2u1l1u4r1d1u1l1u2r9d5l4r2u2l2u1l4r4d1r2u3l8r1d5r1d1l1u4r5d1r2d2l2u1d1u1l1u1d1r1d1r2u2l2u1l4r4d1r2u3l7d2r5d2l1u1r3u3l7d3r8u1r1d3l1u2l6d2l2u1d1r2u3l3d1r9u1r1d1l4u1l4r4d1r2u3l7d2l1d1r8d1r1u1l1u1r1d3l3u1d1r2d2l2u3l1u1r2l1d2r2u3d3l2d1l1u2r1u2l2d1r3l1d2u2l3d2r4l1d2r3u3l1d1r1u3l1d1r1u3l1d1r1d2l3d5l1u4r1u1l2u1l1d3l1d2r2l2u2r4d3l1u3r1u1d1l1u1r1u1l2u1l1d1l2d4r4d2l1u1r1u3l3d2r2d1r1u3

;12
###################
#              . .#
# ######$######$  #
# #.$.     $  #. .#
# # $ $ $# $ $  $ #
# #...#.$..#.$#.$.#
# #. .$ $  $ $ $$@#
# ###$#.$#.# $#. .#
#     $ $  $.$. . #
####  .####$  #####
   #   #  #. .#
   #####  #####
Solution: undefined

;13
     #########
     #   .   #
    ##.@$#####
    #    #
  ###    ######
  # .$$$$ . . #
  #        .  #
  ####  #######
     #  #
     #  #####
 #####$$$. .###
## ..#    .   #
#.      #######
#  $$$$##   ##
###    ##
 ##     ####
 #.  $$$$. ####
 #           ##
 #######. .###
       #####
Solution: d1r1u1l1u1r1d1l1d1l1d3u1l1r1d1r1u1r4l3u1d1l1u1r1u1l1d1l1u1d2r1d3l1u2r1u2l2d1r4l2d2l1d4r1u1r3l4u2r1d2l1d1r3l2d1l5r1d3r1d1l1u1r4d1r1l1u1l1u8r1u2l2d1r5l3d5l1d3l2u2d2r2u1l2d1l1u2d5r3u2d2l1u4r1d1l2u2r1d1r1u7r1u2l2d1r1u1r1d5l1d1r2l2d3l1d3r1u1d1r2d1r2u1l4d1r3u1r1d1u1l3d1l3u1r1u1r1d1l1d1r2u1r1d1l3u4r1d2l1d1r3

;14
     #########
     #   ....#
    ##.@$#####
    #    #
  ###    ######
  # .$$$$ . . #
  #        .  #
  #### $#######
     #  #
     #  #####
 #####$$$. .###
## ..#    .   #
#.      #######
#  $$$$##   ##
###    ##
 ## $   ####
 #.  $$$$. ####
 #       $   ##
 #######. .###
       #####
Solution: d1r1u1l1u1r4l4d4r4l4u1l2d1r4l3d1r1l1r4l4d2r1u6l1u1r4l2d2l3d2l1d1r1u1r2d2l1u1r1u1l2r2d4l1d2r1u9l1u1r3l2d9r3l3d2l5r1d3r1d1l1d1r1u3r2u9l1u1r2d1r1u3l1u1r1l1d11l4d2r2u1l1d1l1u2r2d1r1u10d10l2d4r2u11r1u2l2d1r1u1r1d5l1d1r2l2d3l2d2r1l1d2r2u11r1u2l2d1r1u1r1d6l1d1r3l3d5l1d1l1u5d5r4d1r2u1l5u2r2d1r1d1u1d1r2u1l4d1r3u1r1d1l3u2l4d2r4u1r1d1l4u1r4

;15
     #########
     #   ....#
    ##.$$#####
    #   @#
  ### $  ######
  # .$$$$ .$. #
  #        .  #
  #### $#######
     #  #
     #  #####
 #####$$$. .###
## ..# .  .   #
#.      #######
# .$$$$##   ##
###    ##
 ## $.  ####
 #.$ $$$$. ####
 #  .    $   ##
 #######. .###
       #####
Solution: undefined

;16
     #########
     #   ....#
    ##.$$#####
    #   @#
  ### $  ######
  # .$$$$ .$. #
  #      $ .  #
  #### $#######
     #. #
     #  #####
 #####$$$. .###
## ..  .  .   #
#.$ $   #######
# .$$$$##   ##
### .  ##
 ## $.  ####
 #.$ $$$$. ####
 #  . .  $   ##
 #######. .###
       #####
Solution: undefined

;17
 ##########
 #   @ #  #
 #.  $  . #
##*  #  * #
# *  $  * #
# *  #  * #
# ** $ ** #
#  *   *  #
## *   * ##
 #.**$**.#
 #  * *  #
 ## . $ ##
  ###   #
    #####
Solution: undefined

;18
 ##########
 #  #@ #  #
 #. .$  . #
##*$ # $* #
# *  $  * #
# . $#. * #
# ** $ ** #
#  * .#*  #
# #*   * ##
# .**$**.#
# $ * *  #
### . $ ##
  ###   #
    #####
Solution: undefined

;19
 #######
 # .   #
##.*...#
#  *  ##
#  *   #
#***** ###
#  * $   #
## *@$ $ #
 # * $ * #
 # * $ * #
 # ***** #
 #       #
 #########
Solution: undefined

;20
     ######
  ####    #
  #   .$. #
 ##.$ $$$.#
 # .$. .* ###
 # **$$.$ . #
##  $...*** #
# **$*$.$ . #
# $ $ $$$.###
# *.. $.. #
#  @#   # #
###########
Solution: undefined

;21
####################
#                  #
# $@  .......    $ #
#  #$##########$#  #
# $#            #$ #
#  #     .  .   #  #
# $#  #$######  #$ #
#  #  #   .  $  #  #
## #  # *.$. #  # ##
 ###  #.$$*$.#  ###
   #  # ..$. #  #
   #  # $$*. #  #
   #      .  $  ####
   #  ########  #  #
   #     . .    #. #
 ###               #
 # $$### ########  #
 # .   $$$         #
 ####         ######
    ###########
Solution: undefined

;22
####################
#                  #
# $@             $ #
#  #$##########$#  #
# $#   .......  #$ #
#  #     .  .   #  #
# $#  #$######  #$ #
#  #  #   .  $  #  #
## #  # *.$. #  # ##
 ###  #.$$*$.#  ###
   #  # ..$. #  #
   #  # $$*. #  #
   #      .  $  ####
   #  ### ####  #  #
   #     . .    #. #
 ###               #
 # $$### ########  #
 # .   $$$         #
 ####         ######
    ###########
Solution: undefined

;23
     #  #   ##  ##   #########
   # ###### #   #   ##    ## #
## ###   ####   ######  . .#.#
#  # . . . ## #  #  ## $.$.#.#
####        ######.. #.##  #.#
#@   . .$.$ $    #   #  #    #
######      $#    .. #. .$ $ ##
   # ####  #.$$$ $  ##### #####
 # #        $    $      #     #
 ### $$$$ #######$. . . # ##$##
   # $  $# ##   #  $$$$ # $   #
 ###     ##. . .# . . . #  #.##
 # # ##### $#$$ ######### $# #
   # #   # . . .#  #  # #  #.#
 ### ##  ##$  ### $#$ . # $# ##
  #        $               . .#
  #   $ ###$ # # #   # ## #####
  ## #$ # #   # #  #  ..#$    #
  # #   # #    #     #    #####
  #########################
Solution: undefined

;24
     #####
 #####   ####
 #     $   @#
 # $ $$$$$$ #
 # $#..#..$ ##
## $.....#$  #
#  $.#....$  #
# $$#..#..$$ #
#  $......$  #
## $..#..#$ ##
 # $#.#...$ #
 # $ $$$$$$ #
 #    $     #
 ####   #####
    #####
Solution: undefined

;25
 #############
 #  .     $  ##
 # $$$  # .$  #
####@##### .$ #
# .  .  .#$ . #
#  .$$.$$. $ .###
##. $. $ $. $. .#
 # .$$.$  $ .$. #
 #.  .  $. $ .$ #
 ################
Solution: undefined

;26
 #########
 #   #   ###
 #.$@# $   #
 #.$ # $.  #
 #.$ # $.  #
 #.$.#.$.  #
 #.$.$.$. ##
 #.$ $ $. #
##.$$$$$. #
# ....... #
#  $$$$$ ##
##     ###
 #######
Solution: undefined

;27
 ########
 #      ###
 ##$$$$   #
##   #@...#
#..  # $..#
#..  # $###
##$$$#  #
 #.. #  #
 #.. #  #
 #.. #  #
 ###$#  ###
 #   # $  #
 #   # $  #
 #   # $ ##
 ### # $ #
 #   # ###
 # $$$$$ #
 #     ..#
 #     ..#
 ###   ###
   #####
Solution: undefined

;28
 ########
 #      ###
 ##$$$$   #
##   #@...#
#.. $# $..#
#..  # $###
##$$$#  #
 #.. #  #
 #..$#$$#
 #.. #  #
 ###$#  ###
 #   # $..#
 # $ # $..#
 #   # $ ##
 ### # $ #
 #   # ###
 # $$$$$ #
 # .   ..#
 #.. $$..#
 ###   ###
   #####
Solution: undefined

;29
 ########
 #      ###
 ##$$$$   #
##   #@...#
#.. $# $..#
#..  # $###
##$$$#  #
 #.. #  #
 #..$#$$#
 #.. #  #
 ###$#  ###
 # . # $..#
 # *   $..#
 # $ # $ ##
 ### # $ #
 #   # ###
 # $$$$$ #
 # . $ ..#
 #.. $$..#
 ###   ###
   #####
Solution: undefined

;30
##################
#@               #
# $####$# $###$$ #
# $ $   ##  $  # #
# # ... .#$...$# #
# #$# .$##  #. # #
# #  #. #  # . # #
# #....$#$....$# #
# #  $     $   # #
# .#$##$$#$##$$# #
# .$.$.$.$.$.$.$ #
#       . . .    #
##################
Solution: undefined

;31
 ####### ####
##. #  ### .##
# . # @  # . #
#...#$ $$#...#
# . #  $ # . #
#...# $$ #...#
# . #    # . #
##.## $$ ##.##
 # $ $ $  $ #
 # ## $$ ## #
 #     $    #
 ### $$$$ ###
   #   $  #
   #  $$  #
   #      #
   ########
Solution: undefined

;32
  #### ######
###  ###    #
#  .   # $  #
# .... #$ $ #
# #.##   $@ #
#  .     $  #
## .   $$$ ##
 # #       #
 #   #######
 #####
Solution: undefined

;33
     #######
     # @   #
######.$.$.#
#     .$.$.#
#.$$$ *$.$.#
#.$.$ .$.$.#
#.$.$$*$.$.#
#.$.  . .$.#
#.$*$$*$*$.#
#          #
############
Solution: undefined

;34
   #######
   #     ##
  ##.$$$. ##
 ## $ ..$..##
 # $..$$$$$ #
## $ . .$  .#
# .. . .$.. #
#@#. $$$$$$.#
#  ..$  $   #
## $$$..$. .#
 ## .$ $$$$ #
  # .. . . ##
  ## $ . .##
   #  ## ##
   #######
Solution: undefined

;35
 ##########
 #  @#    #
## $ # .# #
#  .$#$.$ #
# .$.#... #
# $.$# .# #
#  $ # $$ #
####    $ #
# $  #$#$##
# .. # .$ #
# *$ #... #
# ..$ $.$ #
#    # .$ #
###########
Solution: undefined

;36
#############
#     #     #
# $.$. $.$. #
# .$.$#.$.$ #
# $.$.#$.$. #
# .$.$#.$.$ #
#   $ #     #
##### @ #####
#     #     #
# .$.$#$.$. #
# $.$.#.$.$ #
# .$.$ $.$. #
# $.$.#.$.$ #
# .$.$#$. . #
####      ###
   ########
Solution: undefined

;37
#############
#           #
# $$$$$$$$$ #
#   . @ .   #
#$####.####$#
#   .....   #
# $$$#.#$$$ #
# .$.$.$.$. #
#. . ... . .#
#############
Solution: undefined

;38
############
#@         #
# $$$*$$$$ #
# $  $   $ #
# #.#$$#.# #
# *..$ ..* #
# #.# $#.# #
# ...$$...##
###.  # . #
  #########
Solution: undefined

;39
############
#@         #
# $$$ * $$ #
# $  $ $   #
# #.#$ #*# #
# *..$ ..* #
# #.#$$#.# #
# .*. $.*.##
###.  # . #
  #########
Solution: undefined

;40
        ######
#########    #
#@.  . ..$$$ #
# *$. $$$$.$ #
# $. .$....$ #
# * $$$.  $$ #
# *$$.... .. #
#       ######
#########
Solution: undefined

;41
        ######
#########    #
#@.. . ..$$$ #
# *$.$$$$$.$ #
# $. .$....$ #
# * $$$.$.$$ #
# *$$.... .. #
#       ######
#########
Solution: undefined

;42
########
#...   ##########
# @#$$$*        #
#### $    $ $ $ #
#... # $$ #######
###*.***.$.#
  #      # #
  ######.# #
       #   #
       #####
Solution: undefined

;43
########
#...   ##########
# @#$$$.$       #
#### $    $ $ $ #
#... #  $$#######
###*.***.$.#
  #  $.. # #
  ##$ ##.# #
   #       #
   #########
Solution: undefined

;44
########
#...   ##########
# @#$$$.$       #
#### $    $ $ $ #
#... #  $$#######
###*.***.$.#
  #   ..$# #
  ##$ ##.# #
   #  #    #
   #########
Solution: undefined

;45
########
#...   ##########
#  #$$$.$       #
#### $    $ $ $ #
#... #  $$#######
###*.***+$.#
  #   ..$# #
  ##$ ##.# #
   #  #    #
   #########
Solution: undefined

;46
  ######
  #@   ###
 ##$$$$  #
##     #$##
# *#.$$#. ###
#  ..#..$ . #
##$#. ...$.##
#. $.$##$###
#   $ $  #
###     ##
  ####.##
     ###
Solution: undefined

;47
         #####
##########   ##
#      @    # #####
# $$$$$$$$#       ##
#      #. #  .     #
##$$$$ #. #  .#    #
 #    ##. #.....   #
 #$$$ $ . # ....  ##
 #     #.$$  #    #
 ####   . # ...  ##
    ## $$$#  .   #
     #           #
     ###        ##
       ##########
Solution: undefined

;48
         #####
##########   ##
#           # #####
# $$$$$$$$# $   . ##
# $  @ #. # $.    .#
##$$$$ #. # $.#... #
 #    ##. #.....  .#
 #$$$ $ . # .... .##
 #    .#.$$ $#  ..#
 #### . . # ...  ##
    ## $$$#$$*$$$#
     #           #
     ###        ##
       ##########
Solution: undefined

;49
         #####
##########   ##
#         . # #####
# $$$$$$$$#.$   . ##
#.$. @.#. # $.$$$ .#
##$$$$.#* # $.#.*. #
 #..  ##. #..... $.#
 #$$$ $ . #$....$.##
 #..  .#.$$ $#$$..#
 #### . . # ...  ##
    ## $$$#$$*$$$#
     #           #
     ###        ##
       ##########
Solution: undefined

;50
 ########
 #  . . ##
 # $$*$. ##
 #  # .$. ##
 #     .$. #
## . . $#$ #
# .#*#.  . #
#  . . #$$ #
#######  @ #
# $ $ $  $ ##
#      #$#  #
#### ###   ##
#          #
############
Solution: undefined

