;1
################################################################
#                                                              #
# $ $        $$    $       $ $$$$$$   $     $    $$    $     $ #
# $ $       $  $   $       $ $        $     $   $  $   $     $ #
# $ $      $    $  $       $ $         $   $   $    $  $     $ #
# $ $     $      $  $     $  $         $   $  $      $ $     $ #
# $ $     $      $  $     $  $          $ $   $      $ $     $ #
# $ $     $      $  $     $  $$$$       $$$   $      $ $     $ #
# $ $     $      $   $   $   $           $    $      $ $     $ #
# $ $     $      $   $   $   $           $    $      $ $     $ #
# $ $      $    $     $ $    $           $     $    $   $   $  #
# $ $       $  $      $ $    $           $      $  $    $   $  #
# $ $$$$$$   $$        $     $$$$$$      $       $$      $$$   #
#                                                              #
#                                                              #
#                                                              #
# ..    ......    .    ....    ..... ....  . .    .    .    .  #
# . .   .        . .   .   .   .     .   . . .   .    . .   .  #
# .  .  .       .   .  .   .   .     .   . . .  .    .   .  .  #
# .   . .      .     . .   .   .     .   . . . .    .     . .  #
# .   . ....   .     . ....    ...   ....  . ..     .     . .  #
# .   . .      ....... . .     .     . .   . . .    ....... .  #
# .  .  .      .     . .  .    .     .  .  . .  .   .     .    #
# . .   .      .     . .  .    .     .  .  . .   .  .     .    #
# ..    ...... .     . .   .   ..... .   . . .    . .     . .  #
#                                                              #
#                                                              #
#                                                              #
#           $     $       .     .       $     $                #
#          $ $   $ $     . .   . .     $ $   $ $               #
#         $   $ $   $   .   . .   .   $   $ $   $              #
#         $    $    $   .    .    .   $    $    $              #
#         $         $   .         .   $         $              #
#          $       $     .   @   .     $       $               #
#           $     $       .     .       $     $                #
#            $   $         .   .         $   $                 #
#             $ $           . .           $ $                  #
#              $             .             $                   #
#                                                              #
################################################################
Solution: u11l13d5l1d4r3u1r15l15u1r14l7u2l8d1r14l15d1r14l15d1r14l10d1r14l14d1r14l15d1r14l15d1r14l15d1r14l15d1r14d2l15u1r14l15u1r14d1l15u2r14d1l15u2r14l15u1r14l10u1r9l9d1l5u1r11d1r1u1l1u1r8l6d1l13u1r14l1d1l9u2r14l7d1l11u1r14l11u1r14l6d1l10u1r14l13u1r14l13u15l1u2l2d19u19l1d19u19l1d19u19l1d19u19l1d19u7r1u22l3d1r1u1r1d27u27l2d2r2u1r1d26u27l3d3r1u1r1d23l1d1r2u1r1d2u27l4d4r3u1r1d23l1d1r1u1r1d1u23l5d1r3u1r1d21l1d1r2u1r1d2u10l6u6r3u1r1d14l1d1r3u1r1d5u10l6u5l1u4r3u1r1d17l1d1r3u1r1d1u1l6u12l1u5r3u1r1d17r1d1l1u21l4d1r3u1r1d20u20l4d2r2u1r1d16l1d1r2u1r1d2u17l4d15r1d1l2u8l2u5r1d11u1l1u12r1d12u2l1u14d2r1d13l1u15r1d14l1u18d2r1d15l1u17r1d16r2u1r1u13l1u1d1l1u1l1d14u15r2d4l1u1l1d11u5r1d13u2r1u4r1u9l2d7u1l2u7r2u1r1d16r5d5l1u9r1u1l4r4d11l2u9r1u1l2r1d10l1u8d4l2d6r1u7d7r1u9d9r1u8r1u1l1r1u1r5u10r1u3l2d1l1d15r1d1l3r1u13r1u1r1d13r1d1l3u9r1u7l1d15u6l2u10r1d15r1d1l1u10r2u7l1d15r1d1l2r1u5l2u12r1d15r1d1l1u18r1d16r1d1l2r1u11r1u1r2d15r1d1l2u16l2u5r1d16l1d1r1u1r1d4u14r2d4r1d1l1u1l1d10u9r3u3l7u1l1d8u17r4d18r1d1l3r1u19r2d18r1d1l3r1u19r2d13r1d1l3u1l1d5u2r2u3r4u4l8u1l1d8u16r7d14r1d1l7u1l1d1r2u15r6d14r1d1l8r2u2r7u5l8u1l1d7u4r9u3l7u1l1d8r8u8l6u1l1d9r7u9l5u1l1d10r6u10l4u1l1d11u5r2d3r2d1r6u6d1l7u1l1d10r1d12l6u3l1u1r5d1r1u6d9l6u2l1u1r6d1r1u6d8l8u1r7d1r1u7d9l5u4l1u1r5d1r1u4d8l6u3l1u1r6d1r1u4d7l7u4l1u1r8d1r1u6d11l9u4l1u1r10d1r1u7d10l11u3l1u1r12d1r1u7d10l14u1r15d1r1u3r1u1l1d1l1u7d3r1u8r2u4r1u3l3u1l1d6l1d1r2u1r1d8u9r2u3l1u1l1d12u8r1u7l1d14u10r1u5l2d14u5r1u11l1d7l1d1r1u1r1d9u15l2d9l1d1r2u1r1d5u16l2d14l1d1r2u1r1d1u17l2d16l1d1r1u16l1d10r1d1l2u1l1d5u4r10u2l9u1l1d4l1d1r1u1r1d2u2r9u4l6u1l1d7u1r5u8l4u1d1l1u1l1d9u1r9u5l3u1l1d15u8r4u7l3u1l1d15u14r4u1l3u1l1d15u14r4u1l3u1l1d15u14r4u1l4u1l1d9l1d1r1u1r1d6u12r5u3l4u1l1d15u10r5u5l4u1l1d15u16r5d1l4u1l1d15u1r13u4l12u1l1d5r1u4r6u1l5u1l1d10u8r6u2l5u1l1d7u4r10d2r1d1l9u1l1d7u9r4d3r1d1l4u1l1d5u8r5d2r1d1l5u1l1d2u4r6d3r1d1l5u1l1d8u12r7d3r1d1l7u1l1d8u6r8u3l7u1l1d8u8r5u3l4u1l1d8r7u9l1d4r1d1l5u1l1d13r1u11r5u6l3d5r1d1l3u1l1d7u8r5u4l1d5r1d1l4u1l1d6u3r4u7l3u1l1d10u3r8u12l1d14l1d1r1u15l1d14l1d1r1u15l1d13l1r1d1l1d1r1u15l1d14l1d1r1u4r1u11l2d11l1d1r1u1r1d11u22l3d1r1u1r1d10l1d1r1u1r1d11u21l3d2r2u1r1d19u18l3d1r2u1r1d17u17l3d2r2u1r1d15u14l3d1r2u1r1d13u3r6d1r5u4l10u1l1d6u3r12u3l11u1l1d6u3r11u3l10u1l1d6u1r12u5l5u1l1d11r1d1l5r10u12l4u1l1d12r1d1l5r5u2r2u13l1u2r1d20r1d1l9r7u14r1u4l3u1l1d18r1d1l4r6u10l1u8r1d17r1d1l6r4u17r1u3l1d19r1d1l4u23d2r2d10r1d1l1u1l1d10u12r3u9l1d13r1d1l2u1l1d7u21r1d14r1d1l1u1l1d6u9r6u5l5u1l1d14u11r6u3l5u1l1d14u11r7u3l6u1l1d14u9r7u5l6u1l1d14u16r8d1l7u1l1d15u15r8d2l8u1l1d7l1d1r1u1r1d6u1r5d10r1d8l3u15r1u1l2r1d14l1u2l1u1r1d1r1u11r1u1l1d14r1u13r1u1l1d15r1u7r1u1l1d1l1u6d16u5l4d6r2u14r1u1l1d17r1u16r1u1l1d16r1u17d16l4u3r3d1r1u13d12l4u1r2d1r1u11d11l3u1r1l1u1r1d1r1u9d16r3u9r1u1l2d1l1u6d15r4u1l2d1l1u14r1u1l1d11r3u1l2d1l1u9d7r3u15r1u1l1d13l1d9r1u13r1u1l1d1l1u7d13r2u8r1u1l2d1l1u4d17r2u11r1u1l2d1l1u5d15r4u1l2d1l1u23l1u2r1d9r1d1l1d5r3d3l3d1l1u7d4r5d3l4d1l1u7d2r6d5l5d1l1u7d1r6d6l6d1l2u1r1d1r1u7d11r4u12r1u1l2r3d10l1u8r1u1l3r4u16l1d13r1d1l4r3u12l1d10r1d1l3r1u2r1u10l1d10r1d1l2r2u12l2d11u5l3u7r2d11u7r2u1r1u4l2d11r1d1l1u3l2u10r1d11u12r1d11r1d1l1u15r1d19u18r1d15r1d1l1u1l1d1u12r3d10r1d1l2u1l1d5u20r1d16r1d1l1u9r2d4r1d1l2u1l1d9u14r3d4r1d1l3u1l1d4u15r1d22u22r2d1l1r1d1l1u1l1d13u12r2d20u21r2d3l1u1l1d18u18r2d2l1u1l1d16u15r2d1l1u1l1d14u13r2d1l1u1l1d12u12r2d2l1u1l1d10u3r7l1u5l1d7r1d1l4u1l1d3u2r3u2r1u4l1r1u1l1r1u2l1d11r1d1l2u5l1u6r1d10u6l1u6r1d9r1d1l2r3u11l1d13u14l1d10r1d1l1u6l3u6r2d10l1d1r1u11r1d1r2u2l1d12u9r2d16u14r1d5l1d1r1u1r1d9u4r1u8l2u2r1d11u10l2d12u10r4u4l1d11r1d1l1u6l2u7r1d11u5r2u7d1l4u1l1d14u11r5u4l1d5r1d1l1u1l1d7u4l1u9r1d12r2u13l2u1l1d9l1d1r1u1r1d4u5r2u6l3u1l1d18u20r3d1r1d1l4u1l1d15u6l4u7r4u1r1d17u19l4d1r3u1r1d18u18l4d2r2u1r1d13l1d1r1u1r1d3

