;1
  ########
 ## .#.  ######
####$#$### . .#
#        # $$ ##
#@##### $#*$  .#
# $.  ##   $.###
#  .$ ##.#######
# *#$  #######*#
#* .$*#####*#**#
# $*.  ###*#*###
#  .$ ###*######
#  .   ###*#####
################
Solution: undefined

;2
  #####
  # . #####
###$*  #####
#  * .$###*#
## * *  #####
#       #####
# ###########
#  @##########
###     #*####
###.#  .####*#
###$## ##*#*##
## $   .####*#
## $#  ##*#*##
##    ########
#######
Solution: d1r3d4l1d1l3u2r4u3l3d2u2r2d1r1d3l1d1l3u2r3d1r1u2d1l3u3r2d1r1d3l1d1l2u3d1r3u3l3u1l2u2r3u2r1u1r1d1l2d2l2u2d2r4u1d1l2u1r1u3l1d2r1d2l3u2r2l2d2r3u2l1u2l1d1r1d1r1d2l3u2r1l1d2r3u2d2l2u2d2r2u2l1r1d1l1u3r1d2l1d2l1r2u1d1r2u1l1d1l2u3r2d1u1l2d1r1l1d2l2u2r1l1d2r2u2r1u2l2d1u1r2d2l1u1d3r1u1d1r2u1l1d1l4u2r1u1r3d1u1l3d1l1d2r4u1l1d1l3u2r1u1r3d1u1l3d1l1d2r3u2r1u1l1d3l3u2r2l2d2r1u1d1r2u1l1r1d1r2u1l1

;3
  ######
 ###  ###
##    ###
##  *. ##
 ## **  #
  ##  $ #
 ##   ###
 ## #####
 ##@ ##
  #  ##
###$ ###
## $   #
## .** #
## *  ##
#  .###
#   #
#####
Solution: undefined

;4
        ####
   ##  ##  ##
   ######. ####
  ###   $**  ##
 #### $$ .   #
###   @# . ###
# $  ###  ###
#  **  #####
## .*  ##
###   ##
  #  ##
  ####
Solution: undefined

;5
#######
##@* .###
## *$ $ #
##.#. $ #
##      ##
####### ##
#.$ ### #
#   #   #
# # # # #
#  *$.$ ##
###. .####
#  *$.  #
# # #$# #
#       #
#########
Solution: undefined

;6
  ############
  ####   . . #
###    # #$*$##
# $@$### $.   #
# #. $ # * $$ #
#    # ### *..#
##$. ..###    #
##  ###########
 ####
 ###
Solution: undefined

;7
#############
##*#######*##
#*#*#####*#*#
##*##########
#*##   ##*#*##
#*# $# ###*#*##
##  .$. ########
##  .$.  #*#####
###$*#*  ##*####
###    @##*#####
##### ##########
#####   *..    #
##**###..**$*. #
####*## $$ $ # #
#######      $ #
###*######  ####
################
Solution: undefined

;8
##########
##      ##
 # $#$ * #
##  * ## ######
 ###..$  # * .#
###.*.#*   @ $#
 ###..$  # # .##
##  * ## #   $##
 # $#$ * ##  * #
##      ###    #
################
Solution: undefined

;9
##############
#.  #     ####
# $   $@# ####
## ### ##   ##
#    * ###$ ##
#  #** .##  ###
##*     #  $  #
##  ##  # #   #
#########.*.*##
#*##*##*##   ##
##*##*##*#  ##
##############
Solution: undefined

;10
##########
#**##    ##
#*###*##  #
#*## ..   #
##*#  #$$ #
#*##    ###
##*### ###
#####@  ##
#    $#  #
#.  # .$ #
##$# **. #
#  #$ . ##
#  $  # #
# .##   #
#########
Solution: undefined

