;1
######
#  @ ##
# $$  #
# # * #
#   $##
##...#
 #####
Solution: d2,5-3l1,4-5u2,2-4r1,3-2d1,5-2l1,4-5u2,3-3d1,4-5l1,4-1d3,3-1d3,1-2r2,4-1d1

;2
    ####
#####  #
#   *$.###
#   #@$  #
#####  #.#
    #    #
######## ##
#         #
#   ###   #
##### # ###
#   # # ####
#   ###    #
##         #
 #  #####  #
 ####   ####
Solution: r1,5-1d1l2,5-1d2,8-3l1,6-4u1,6-1d2,5-5u2,6-3d1,5-4r1l1d1r2,8-3d4,9-8l1,7-7d4,8-12l5,2-13u1,1-11r1,3-10d1,2-12r6,9-13u1,10-11l2,7-12u4,8-7l5,5-1d2,1-2r4,6-1d1,5-3r1,5-5u2,6-2l1,8-3l1,6-4u1,1-7r6,8-8u3

;3
 #####
 #   #
 #@$.#
 #  *#
###$.#
#   *#
#  $.#
## $.#
 #   #
 # ###
 #  ##
## $.#
# $$.#
#  $.#
# $ .##
####. #
 # $. #
 #    #
 ######
Solution: d1r1d1r1d2l1u1r1l3d1u1r3u2l1r1d2l3d1r2u1r1u2l1d1r1d1l1r1u2l2u2r2d1u1l2r2d2u2l2d1r1u1r1d1l2r1d4l1d2r1u5l1u1r1d4l2u1r2l1d6r1l1d1l1d2r1u7d6r1u1r1l1r1d3r1d2l1u4d4l2u1r1d1r2u2l1u2l2d1r1u1r1d1u1l2u3r1d3l1d1r1l1u6r1u3l1d7l1d1r2

;4
#####
#.. #
# @$##
# $  #
##   #
 #####
Solution: 1-3r1,4-3l1,2-4u1,3-1d1l1,1-3u1,4-3l1,2-4u2

;5
######
#  ..#
# $  #
# $* #
##@ ##
 ####
Solution: 3-4u1,1-3r1u1r1,1-1r1,3-4u1,4-3u1l1,2-1d1,1-3r1

;6
##########
#        #
# $.$.$. #
# .$.$.$ #
# $.$+$. #
# .$.$.$ #
# $.$.$. #
# .$.$.$ #
#        #
##########
Solution: u1l2,2-5d1r1u1,7-4u1,7-6u1,3-8u1,4-5d1,3-5d1,6-5d1,6-3d1,7-3d1,4-3d1,3-3d1,1-3r1d1,3-4u1,2-1d1,4-1d1,6-1d1,3-6u1,5-6u1,7-6u1,7-8u1,5-8u1,3-8u1

;7
 ####
##  ###
#@$   ##
# **.  #
##* .  #
#  $ ###
#   ##
#####
Solution: undefined

;8
######
# @ .#
# *  #
##$#####
#      #
#      #
#####  #
    ####
Solution: l1d1r1d2l1d1r3u1r2d2l1u1r1u1l2d1l2u4r2d1l1u1l1d3l1d1r3u1r2d2l1u1l1u1l1d1l1u3l1u1r2l1d4r4u1l3d1l1u2

;9
    ####
  ###@ #
###    #
# $$#. #
#.    ##
# $ # #
###  .#
  #####
Solution: d3l4d1r1u1r3d2l2u1l1u1r2l1d2r2u3r1u2l1d1l2d2r2d2l2u1l2u2r1l1d2r2d1r2u2l3r3u1r1u2l1d1l2d1l1d2r1d1r2u3r1u1l1d4l2u1l1u1r2l1d2r2u3r1u2l1d4u1l2u2r1l1d3u1r2u1r1u2l1d1

;10
 #######
 # .   #
 # #.$ #
##$  .$#
#   #$.#
# $.#@ #
#  #####
####
Solution: undefined

;11
   ####
####  #
#  $  #
# .*.$##
##...$ #
 #  $$@#
 #    ##
 ######
Solution: undefined

;12
   ####
 ###  #
## $ $#
# ....##
# .$ . #
# $$ $@#
#  #####
####
Solution: undefined

;13
####
#  #####
#  $   #
# $..  #
##  ####
### ##
# $  #
#.@$ #
## .##
 ####
Solution: d1r1u4l1u1l1u2r1d1r1d5u3l1u1r3u1l1d1l1d4l2u1r1d1r1u3l1u1l1u2r1d1r1d4r1d1l2r1u5d1r2u1l1d1l1d1l1u1l1u2r1d1l1d1r3u1l1r3d1l1u1l2d1l2u2r1d1l1d1r1

;14
####
#  ###
#  . #
# ** #
#@$  #
##$###
## $ #
#  $ #
# .. #
# .  #
######
Solution: undefined

;15
#######
# .$  #
# $.. #
# $.* #
#  $ ##
# @###
####
Solution: undefined

;16
 ####
 #  ###
##$.. #
# *.* #
#  $$@#
#     #
#######
Solution: u1d2l4u2d2r4u3l2d1u1r2d3l2u1d1r2u1l1r1u2l1r1d2l2r2u2l2d1u1r2d3l4u2r1l1d2r4u3l2u1l1r1d1r1d1l1r2d2l4u2r2u2l1r1d1u1l1d1r1u1d1r2d3l2u2d2r2u2l1r1d2l1u2d2l3u1r2d1r1u1

;17
####
#  ###
#    ###
# .*$. #
##$#  @#
 #     #
 ###  ##
   ####
Solution: undefined

;18
  ####
###  #
#   *#
# # .#
#  @$##
### * #
  #   #
  #####
Solution: undefined

;19
   ####
   #  #
 ###  #
 #    #
 # .$#####
###.$    #
# @.$#   #
#    #####
######
Solution: undefined

;20
#########
# @ #   #
# .***$ #
##    # #
 ###    #
   #  ###
   ####
Solution: undefined

;21
#########
#  ##   #
# .@    #
# $*$####
### . #
  # # #
  #   #
  #####
Solution: undefined

;22
    #####
    # . #
    # * #
  ### $##
  #   $ #
### @#* #
#     . #
#   ##  #
#########
Solution: undefined

;23
#########
#  ##   #
#   $$  #
# @#$. ##
##  ..##
 #  ###
 ####
Solution: undefined

;24
########
#   #  ##
#     $ #
##### * #
# . # * #
# * # * #
# * # . #
# *@## ##
# $     #
##  #   #
 ########
Solution: undefined

;25
#####
#   ######
#     *  #
######.# #
##  ##$  #
#@    * ##
#  ###  #
#  # #  #
#### ####
Solution: undefined

;26
####
#  #
#  #
#  #
## #####
 #  $+.#
##  #$ #
#   #  #
#   ####
#####
Solution: undefined

;27
 #####
 #   ##
 #  $.#
 ## $.#
  ##$.##
### $. #
#      #
#  @ ###
###  #
  ####
Solution: undefined

;28
#########
#   #   ##
#        #
#######  #
      #@##
####### #
#     $$##
#   # #  #
##### .. #
    ######
Solution: undefined

;29
######
#    ######
#    ##   #
### @ #   #
  #  .#  ##
  # #$#  #
 ## #.#  #
 #   $   #
 #  ###  #
 #  # ####
 ####
Solution: undefined

;30
 #####
 #   ###
 # @$. #
 ###.$ #
#### ###
#    ######
#         #
####  #   #
   ########
Solution: u1r1d4l1d1r4d1r2u1l6r1u4r2d1l1u1l1d3l1d1r4l3u1l3d1u1r3d1r3d1r2u1l4d1l1u4r1u1l1u1l2d1r2d3l3d1r6d1r2u1l4d1l1u3

;31
    #####
#####   #
#  @$ # #
# #.*.  #
# # $####
#    #
#   ##
#####
Solution: d1r2u2d1l2r2l1d1l1d2r1u1l1u2r2d1l1r1u2r2d2l2u1l2d2r1d1l1u3r1d1l1d3l2u4r3d1r3u2l2d1l2d3r1u1l1d2l2u1r1d1r1u2

;32
      ####
  #####  #
  #@ ##  #
###      #
#  $##. ##
#  $  .##
#  ##  #
########
Solution: undefined

;33
      ######
      #    #
    ### #$$##
    #    $  #
    # # #$#.#
#####   # ..#
#  .#####  .#
# #    #  @##
# $  #   # #
####   #   #
   #########
Solution: l2d1l2u1l3u1l2d2r2u1r3d1r2u1r1u2r2u2l4r2d3r1d3l2u2r1l1d1l2d1l2u1d1r2u2l2d1l1u1d1r1d1r2u1r2u1d2r2u2l1r1u1l1u3l2u2r2d5u5r1d1l1d4r2u3l1r1d3l2u3d3r1d3l1r1u3l1u1r1d1r1u1d1l1d3l2u2r1l1d2r2u3l1u1r1l1u2r1u2l1d5r1d3l2u2r1l1d2r2u2l1u1r1l1u3l2d2l2u2r3l1u2r2d5r1d3l2u2r1l1d2r2u3

;34
  ######
  #    #
### #$$##
#    $  #
# # # #.#
#   #  +#
#####  .#
   #   ##
   # # #
   #   #
   #####
Solution: u2l4u2r2d5r1d3l2u2r1u6r1d1l1d3r2u2l1r1d2l2u2d4l1d2r2u3l1u1r1d1r1u1l2u2r1u2l1d5r1d3l2u2r1l1d2r2u3l1u1r1l1u3d1l2d2l2u2r3l1u2r2d5r1d3l2u2r1l1d2r2u2l1u1r1

;35
      ####
      #  #
    ###  #
  ### @  ##
### $* #  #
#   *.    #
# ## ######
#    #
######
Solution: l1r1d2l2d2l3u2r5u2l1d1r1d1l3u1r2d1r1l2r3l3d2l3u2r2l2d2r3u2r1u2r3d1r1d1l6u1d1r1d2l3r3u2r2u1l1u1r2l1d2r2u2d2l4d2l3u2r5l3u1r1d1r2u2r2d2l3r3u2l1u2r1d3r1d1l3

;36
#####
#   #
#.#$####
#. $   #
#.#$#  #
# @    #
#  #  ##
#######
Solution: l1u2r2d1u1l2d2r3d1r1u1l4u4r2d2l2d2r5u2l4r4d2l5u2d2r2u1d1r3u2l4r3d1r1d1l4d1l1u1

;37
#####
#   ##
#    ###
# #  . #
#  $*$@#
###. ###
  #  #
  ####
Solution: undefined

;38
              #####
           ####   #
       #####   $# #
####  ##      #.  #
#  #  #  *$.* # ###
#  #  #   ##  #  #
#  ####  ####### ##
## $ ##########   ###
# $*. #  #   #    . #
#  . @#### #$   $*$ #
####  #  #  .###. ###
  ## ##  ### # #  #
  ##  #  #   # ####
  ### ##$$   #
  #  .#. $####
  # #$ .. #
  #   #   #
  #########
Solution: undefined

;39
########
#      #
#    # #
###*$@ #
 # .#$##
 # .  #
 #  ###
 ####
Solution: r1u2l3d3l1d2r1u3r1u1l1u1r3d2l2u1l1d2l1d2r1u1r2u1d1l2u2r1u2l1d3u3r3d2l2u1l1d1u2l2d1r1u1r1d1

;40
 ####
##  #
#   ####
#  *$  #
## *@  #
 # .#  #
 #  #  #
 #######
Solution: undefined

;41
   ####
 ###  #
##    #
# $* @#
# #. ##
#  .$#
###  #
  ####
Solution: undefined

;42
 ####
 #  #
 #  ###
 # *$@#
## *. #
#  * ##
#    #
######
Solution: undefined

;43
#####
#   #
#   ####
#  *$@ #
#  .*  #
###  ###
  ####
Solution: undefined

;44
 ####
 #  #
 #  #
 #  #
### ######
#  $$    #
#@. $#   #
##.. #####
 #####
Solution: r2u3d2r3l3d1u1r3d1r2u1l5d2r1u1l1u1r3l3u2l1u2r1d5l2u1r1d1r1u3d2r1d2l1u4l1u2r1d4r1d1l1u1r3d1r2u1l4d1l1u3l1u2r1d5

;45
####
#  ###
#    #
#  .$###
## .$  #
 ##.$# #
  ##@  #
   #####
Solution: r2u2l2r2d2l2u1l1u1l1r2d2r2u2d2l2u1l1u1l1u2r2d1l1d1l1u1d1r1d1r1u1l1u2r1l1d3r1d1r2u2l2d1l1u1l1u1l1u2r1d1r2d2r2d2l2r2u2l2u2l1d2r3d2l2u1d1r2u2l2u2l3d1r1

;46
 ####
##  #
#   ####
# $    #
# *##  #
#@.    #
#####  #
    ####
Solution: u2r1l1d2r1u2l1u1r1l1d3r4u2l2r2d2l4u3r1d2l1d1r3l2u2r4d3l1u1l4u3r1u1r1d1l1d3r4u2l3u1l1d1r3d1r1d1l3

;47
####
#  #
#  ####
#  $  #
##$*. #
#  . ##
#  @ #
######
Solution: l1u3r1d1l1d1r1u2l2u2r1d3r3u1l2d3l2u1r1u2d3r1u1l1u2l1u2r1d3r1d2l2u1r1u2r3d1l1u1l2d3r2u1

;48
  ####
  #  #
###  ###
# $**. #
#      #
###   ##
  ##@ #
   ####
Solution: u2l1u1r1u2l1d2r1d2r1u1r1u1l1d1l1u1d2u2l1u2r1d3r1d2l1u1l1u2d1l2u1r3d1u3l1d1r1d2l1d1u1r2d2l1u2

;49
  ####
  #  #
  #@ #
###$*###
#  *.  #
#      #
#  #####
####
Solution: r1d2l1d1r1l1u2d2l2u1r1d1r2u1r2d1l3r1u2l1d1l2d2r1u1l1u1r3d1l1r1u4l1d3r1d1r2u1l1d1l1u2d1l3d2r1u1l1u1r1d1r2u1r2d1l3r1u2l1d1u3r1d1l1d2l2d2r1u1l1u1r3d1l1u1l2d2r1u1l1u1r1d1r4u1l1

