;1
       ###
########.#
#..    $.#
#  #$ ## #
# $ $  $$#
#  ##.#@ #
#####.####
    ###
Solution: r1u3l6d1u1r6d2l2r2u2l3d3u3l3d1l1d2r1u1r3u2l3d1u1r3d2l1r1u2l3r3l3d1l1d1r3l2u2r3d2r2d1r1u2d1l4u1r1u1l2

;2
 #####
 #...#
##..##
#...###
#     #
#  #  #
#   $####
# $$$@$ #
###     #
  # $$$##
  ##   #
   #   #
   #####
Solution: d1l2u1d1r2u1l1u2r1u1l2u1l2d2r1u1l1u1r1d1r1u2l1u1r1d3r1d4r3u1l2d1l1u3r1u1l2u1l2d2r1u1l1u1r1d1r1u2d2l1d2r1d1r1u2r1u1l2u1l2d2r1u1l1u1r1d1r1u1d1l2d3u1r3d3u1r2d1u1l2d1l1u2r1u3l2d2r1d1r1u2r1u1l2r1d2l2u2l1u1r1d3l1d1r1u1r2d2l1u1r1u1l2d1l1u3d3r4d1r1d1l1d2r1u3r1u1l3d1l1u1r1u1l1d1l1u5d5r1d2r1u1r2d3l2u6r1u1l2r1d2l2u3d4r4d3l1u2r1u1l2d1l1u1r1u1l1d1l1u3

;3
     ###
    ##.###
   ##... #
   #.....#
##### #  #
# $  $@$ #
#  $ $# ##
# $ $ #  #
#  $ $   #
##  # #  #
 ##   ####
  #####
Solution: l1u2r2d4r1d2l1u6r1u1l1d1l1u1d1l1r2d5l2u5d3l2u1r1d1r1u2d1r2u2l2d7l2u1l1u1l1u3r5l1u2r2d4r1d2l1u5r1u2l2d1r1u1r1d1l1d3u1l6d3r1d1r1u3d2l2u3r5l1u2r2d4r1d2l1u5d1l2r2u1d1l2u2r1u1r2d1l1d2l4d3r3l1u3r2d2r1d2l1u6r1u1l1d3l3d2l1d1r3l1u3r2d2r1d2l1u6d2l6d2r3u1r1d1l1d1r2l1u3r2d2r1d2l1u5d1r1u1d1l7d2r1u1l1u1r3d1r1u2

;4
         ####
     #####  #
     #  .   #
###### #.#. #
#   ##$$.#. #
#  $ #@#.*..#
##$ $  $  ###
 # $ ###  #
 #  $ ##  #
 ###  ##  #
   #  #####
   ####
Solution: undefined

;5
 #######    ####
 #  #  ######..##
 #     $   ##.. #
##$##$$ $#   .. #
#   #  # #####..#
#  $#$ # #  #.. #
###@   # #  #.. #
 ##$#$   #  #..##
 #    $####### #
 # $ $   #     #
 #### $# #  #  #
    #    $  ####
    #  ###  #
    #  # ####
    ####
Solution: undefined

;6
   ########
 ###......####
 # $.......$ #
 #  .....### #
 ###.####  # #
   # ####    #
   # ## $$$ ##
####    $    #
#   $## $ $  #
# ## @## #$$##
# $ $$#     #
#  $  $   ###
# $$  #####
# $   #
##  ###
 ####
Solution: undefined

;7
  #####
  #   #
  # # ###
### $ $ #
#   $$$ #
# #  $  #
# ###  ##
# # #@ ####
# #### #. #
# ## .. . #
# #.  ##  #
#  .      #
####     ##
   #######
Solution: undefined

;8
#############
#..         #
# .# ##$# # #
#..$ $      #
#. # ##########
#.## #        #
#.## # # ## # #
#.## #     $  #
####$#$####$###
 #    $ #@ $  #
 # # ##   # # #
 #   ######   #
 #####    #####
Solution: undefined

;9
  ####
  #  #
  #  ##
###@$ ####
# $   #  #
# ## ##  #
# #  $   #
#   ###.###
### #  *  #
  #    .  #
  #####.###
      ###
Solution: undefined

;10
 ####
 #  ########
 #$ ##   ..#
 #  $  # ..#
##.# ####..###
#..  $ ##..  #
#### # ##$## #
   # $@$     #
   ######$$$###
        # $   #
        # $   #
        #   ###
        #####
Solution: 6-5l4,6-7r3u3,8-3r1,9-7d2r2,2-1d3,3-3r1,6-3l3,2-2d1,11-7l2,10-9u1,9-7r1,7-7r1,9-6d1,9-9u5,12-7l2,9-6d1,10-2d2,8-3r1,10-2d1,9-9u2,9-7u2,9-5u1,8-3r1,9-11u1,9-8d1,9-11u1,9-10u6,9-4u1,8-2r1,11-10l1,9-11u3,9-8u5,13-9l1,12-9l2,9-10u6,11-7d1,12-9l2,9-10u3,9-7u2,4-7r4,8-7r1,11-7l1,9-8u2

;11
 ##############
##   #  ..#   ##
# $$ . @..$  $ #
#  $$#..###$$  #
#    #.## #    #
########  ######
Solution: l3u1l2d1r4d1r1u1l1u1r2l1d1r4u1r2d1l5u1l2d2r1u1l1u1r1d1l6d2r1u1l1u1r5u1r1d1u1d1l5d2r1u1l1u1r9u1r2d1l6u1l1d2u2d1l3d2r1u1l1u1r8u1r2d1l6u1l1d1r8d2l1u1r1u1l8r7d2l1u1r1u1l4r3d2l1u1r1u1l2

;12
    #######
    #     #####
  ### # # #   ##
  # $ $ $ #  $ ###
###   ##### $  $@#
#.##  #   #  $ ###
#..   #   $ $ ##
#..$..##$## # #
#.. ..#  ##   #
### ..#   #####
  # ### $   #
  #     $## #
  #  ##     #
  ###########
Solution: undefined

;13
       #####
       #   #
      ##   ##
    ###.....###
    #.........#
######### #########
#   $         $   #
#  $#####@#####$  #
##  #  $   $  #  ##
 #  # $ $ $ $ #  #
 ## #  #####  # ##
  # #$ #   # $# #
  # $  #   #  $ #
  #   ##   ##   #
  #####     #####
Solution: undefined

;14
 ###########
 #     ##  #
 # # #  $$ #
 #..   $$@ #
##.. #   #$###
# .. #  $    #
# ..## $ $ # #
##..##  $ $  #
 #..### $$ ###
 #### #   ##
      #####
Solution: undefined

;15
        ####
 ########..##
 #          #
## ## #  .. #
#    $ # ####
# # #$ # #
# # # $  #
#   $@# ##
### ### #
  #     #
  #######
Solution: undefined

;16
   #######
   #     #
 ###     #
##    #..###
#  # #...  #
# ##$##.*$ #
#  $  ###.##
## $$ @$ . #
 # $ $ #   #
 ##  #######
  ####
Solution: undefined

;17
########
#   #  #
#  $@$ ##
# $***$ #
#  ...  #
# $...$ #
#  ###  #
#### ####
Solution: d2u2r1d2r2u1l2r2d3l1u1r1u2l2d1l4d1r1l1u3r1l1d2r4u2l2d1u1r1d1r3d2l1r1u2l1d1l1u3r1d1l1d2r2u1l1r1d3l1u1r1u1l1u2l3u1l2d2r2u2l1d1l1d1r1

;18
###########
# $.....$ #
#  ##$##  #
# $##  #$ #
#    $  $ #
# $# @ #  #
#  ##$##$ #
## .....  #
 ##########
Solution: r1u2l1u1d1r1d2l2u1l3u3r2l2d3r1u2l1u1r1d3r2d1r2u1r1l1d1l2u1l3d2r1d1r7u6l2r2d3l1u2r1u1l1r1d6l7u1l1u2r3d1r2u1r1l1d1l2u1l3d2r1d1r7u2l1u1r1l1u1d1l2r3d3l7u4d1r5l6u3r1d2l1d1r3l2d3r7u2l1d1r1d1l5r5u4l1d2u1l2d1l1d1u1r1u1r3d3l4r4u3l1d2r1d1l2r2u6l1d5r1d1l1u3l2u1l1d3

;19
 ##################
 #. .      . .    #
 #. .      . .    #
 #.#.# ####.#.#####
 ###              #
   ##  #########  #
################$##
#  $   $   $      #
#  #   #   #  $   #
## #############  #
#   #   #   #   ###
#   $   $   $     #
#  #############  #
###   ##   #   # ##
#@$   $    $   $ #
###############  #
              ####
Solution: undefined

;20
###############
#. . . . . . .#
##$#$$#$$#$$# #
 #     @      #
 ##############
Solution: undefined

;21
            ####
#############  #
#              #
#  # # # # # # #
##.$.$.$.$.$.$ ##
 #$#$#$#$#$#$#  #
 # . .@. . . .  #
 ########### # ##
           #   #
           #####
Solution: undefined

;22
###############
#             ##
# $ $ $ $ $ $  #
##.#.#.#.#.#.# #
 #.$.$.$.$.$.@ ##
 #$#$#$#$#$#$#$ #
 # . . . . . .  #
 ########### # ##
           #   #
           #####
Solution: undefined

;23
######
#  @ #
#  # #
#.$$.#
#  # #
#.$$.#
#  # #
#.$$.#
#  # #
#.$$.#
#  # #
#.$$.#
#  # #
#.$$.#
#  # #
#    #
######
Solution: undefined

;24
   ####     ####
   #  #######  #
   #     #  #$ #
   #$ #    $@$ #
   #  # ### ## #
   #$   $  ..# #
####  #### *.# #
#  $$ # #..$## #
# $#  # #.. ## ##
#  #$ # ###..   #
##    #   #..   #
 ######   #######
Solution: l1,12-6l1,10-5d1,11-6d3,10-6d1,11-8l1,11-3l3,7-5r3,11-4d1,12-6l1,10-5d1,11-7l1,7-2d2,6-5r4,11-4d1,12-6l1,10-5d2,14-3l3,13-1d1,12-3r1,14-2d7,15-10l2,9-3r4,14-2d2,14-6u1,14-3d3,14-6d2,15-9l2,4-4u1,4-6u1,4-8u1,2-7r2,5-8u3,4-5d1,4-3d2,5-3d1,4-5r6,11-4d2,11-6d2,3-7r1,5-8u3,5-3d1,4-5r6,11-4d1,12-6l1,10-5d1,2-9u1,1-7r3,5-8u3,5-3d1,4-5r6,11-4d1,10-6r1,4-5d1,3-7r1,5-8u2,4-5r7,4-10u1,4-9u1,3-7r1,5-8u2,4-5r6,11-4d1,4-1d5,3-7r1,5-8u2,4-5r6

;25
#####         ####
#   ###########  #
#  $             ##
## #############  #
#.  . . . . . .$@ #
## # # # # # ######
 #  $ $ $ $ $ #
 #  # # # # # #
 ##           #
  #############
Solution: 16-4l2,14-4l1,13-4l4,9-4l7,5-6l2,2-7u1,7-6l3,9-6l2,11-6l2,13-6l2,2-2r12,14-2r1,16-1d2,17-4l10,7-4l2,2-6u3,1-2r3,4-2r1,5-2r1,6-2r9,16-1d2,5-4l1,17-4l10,7-4l1,4-6l1,2-7u4,7-6l3,9-6l2,11-6l2,1-2r4,5-2r10,16-1d2,17-4l9,4-6l1,2-7u4,1-2r14,16-1d1,16-2d1,17-4l7,7-6l4,2-7u4,1-2r5,6-2r9,16-1d1,16-2d1,17-4l5,9-6l3,6-6l3,2-7u4,1-2r9,10-2r5,16-1d2,17-4l2,10-4r1,8-4r1,6-4r1,4-4r1,2-4r1

;26
        ######
        #    #
        # $$ ##
        # $   #
####### # $$$ #
#     ##### $ #
#     #   # $ #
#     #       #
##  ###@# #####
 #  ........#
 #  #########
 ####
Solution: 11-3d3,12-7l4,7-6d2,8-9l4,4-9l1,2-10u3,1-6r2,11-1d5,12-7l4,7-6d2,8-9l3,5-9l2,2-10u3,1-6r1,9-2r1,11-1d5,12-7l4,7-6d2,8-9l5,2-10u3,9-3r1,11-2d4,12-7l4,7-6d2,8-9l5,2-10u2,9-4r1,11-3d3,12-7l4,7-6d1,3-5d3,1-7r2,1-6r1,3-10u1,7-7d1,8-9l5,2-10u3,13-4l1,11-3d3,12-7l3,7-7r1,9-6d2,8-9r2,13-6l1,12-4d2,13-7l4,7-7r1,9-6d2,8-9r1,11-5d1,12-7l1,11-7l2,7-7r1,9-6d2,3-7d1,2-9r5,3-5d3,2-9r4,5-7l1,3-6d1,3-7d1,2-9r3,5-6l1,3-5d3,2-9r2,1-6r1,3-5d3,2-9r1

;27
#####
#   #
# # ###
#   ..#
#.... ######
#.##.###   ##
#.## ### $  #
#.## @## $$ #
####     $  #
 #  $#$$$ ###
 # $   $  #
 #   ######
 #####
Solution: 4-8d1,4-11u3,4-8u4,5-3l3,1-2d1,1-3d2,1-5d1,2-10r1,4-11u7,5-3l1,4-3l2,1-2d3,8-8r1,8-10l2,6-10l1,4-11u2,4-7d1,4-10u3,4-7u1,4-6u2,5-3l3,1-2d2,7-10u1,8-8l3,4-9u5,5-3l1,3-2d1,4-4l2,6-10u1,7-8l2,4-9u5,5-3l1,3-2d1,4-4l1,8-10u1,9-8l4,4-9u5,5-3l1,3-4u1,11-8l6,4-9u5,3-3r1,3-1d2,10-6d1,11-8l6,4-9u5,10-7l1,9-5d3,9-10u2,9-6d1,10-8l5,4-9u4,8-6d1,9-8l4,4-9u3

;28
##########
#    #+  #
#     *$ #
###$## # #
  #   *. #
  # # ####
  #   #
  #####
Solution: undefined

;29
       #####
   #####   #
####     # #
#..# #$$##$#
#..# # @   #
#..    ###$#
#.$  # ### ###
#..  #   #   #
#..#$$$$$$ # #
###          #
  #  #########
  #  #
  ####
Solution: 2-5d2,10-4d3,4-9u2,4-7u1,5-5l2,2-4d2,6-7d1l1,4-9u3,7-9l2,5-5l3,1-4d3,4-8d1,4-11u2,4-9u3,5-5l2,2-4d1,1-6r1,8-7d1l3,4-9u3,5-5l3,1-4d2,9-9l4,4-8d1,4-11u2,4-9u3,5-5l3,1-6u2,10-7d1,11-9l6,4-8d1,4-11u5,5-5l3,1-6u1,4-6l2,10-8l2,6-8r1,9-8l4,4-9u3,5-5l3,10-2d4,10-6d2,11-9l6,4-8d1,4-11u5,5-5l2,2-6u2,6-2d5,7-8l1,6-8l1,4-9u3,5-5l2,2-6u1,7-2d1,8-4l1,6-3d3,6-6d1,7-8l2,4-9u3,5-5l2

;30
       #####
########   #
#     ## # #
# $$  $@ $ #
##$ $###$###
 #   ##...#
 #   $... #
 ###$##...#
   # #### #
   #      #
   ########
Solution: undefined

;31
 ####
 #  #####
 #  $   #
 # #   $#
 #.# $  ###
 #.#$  $#.#
 #.# $$ $*#
 #.#$  $#.#
 #.# @$ #.#
##.#    #.###
#  ######.  #
#           #
########  ###
       ####
Solution: undefined

;32
 ######
##    #
#  ## #######
#.....  $@$ #
#..##.# $ $ #
#####.# $ $ #
  #  .# $ $ #
  #  .#     #
 ### ########
 # $$  #
 # $ # #
 #     #
 #######
Solution: l3,6-3l3,2-2d1,11-3l9,1-2d1,4-8d1,4-11u2,4-9u2,3-6r1,5-7u4,5-1d1,4-3r3,2-10r1,4-11u1,4-10u2,4-8u1,3-6r1,5-7u4,2-9r1,4-10u3,9-3l7,5-1d1,4-3r3,3-6r1,5-7u4,5-1d5,9-3l3,6-3l1,3-3r1,5-2d1,5-3d2,9-6l1,7-7u3,8-3l2,6-3l1,3-3r1,5-2d2,9-5l1u1,9-3l4,3-3r1,5-2d1,7-6u2,8-3l3,5-3l2,11-4l3,7-5u1,8-3l4,11-5l3,7-6u1,7-5u1,8-3l3,11-6l3,7-7u2,7-5u1,8-3l2

;33
 #####
 #   #
## # #
# $  ####
# $# #..#
# $  #*.#
# @$$$..#
# $  #*.#
###  #..#
  #  $  #
  ####  #
     ####
Solution: undefined

;34
    #######
 ####     #
 #    $ # #
## ###    #
#    $$## ##
# #$$$@#  .#
#  $ ###  .#
##       #.#
 ######  ..#
      #  ..#
      ######
Solution: undefined

;35
     ######
     #    #
 #####    #
 #   ##$# ##
 #   $..$  #
######..#  #
#    $.. $ #
#   ##$##  #
#####  #@  #
    #  #####
    #  #
    ####
Solution: undefined

;36
           ####
 ###########  #
 #            #
 # $ $ $ @### ####
 ###### ###      #
 #      ##  # ## #
 # ####$## #...# #
## ##    #  ...  #
# $##    ###...###
# $  $$$ # ##  #
#   #    #  #  #
##########  ####
Solution: 6-3r1,7-5d2,8-8l1,7-10u7,6-2r6,13-1d4,14-6l1,5-8r1,7-9u6,6-2r6,13-1d1,13-2d3,13-5d1,12-7r1,14-8u1,5-10u1r1,7-10u7,6-2r6,13-1d6,12-8r1,14-7d1,1-9r5,7-10u7,6-2r6,13-1d5,12-7r2,2-7d1,1-9r5,7-10u1,7-9u6,6-2r6,13-1d3,13-4d2,14-7l1,5-7d1,4-9r2,7-10u7,6-2r4,10-2r1,11-2r1,13-1d6,14-8l1,14-10u1,16-7l1,9-3l1,7-2d5,7-9u5,7-4u1,6-2r6,13-1d4,13-5d2,4-3r2,7-2d4,7-8u5,6-2r6,13-1d5,2-3r4,7-2d4,7-8u5,6-2r6,13-1d4

;37
 #####
 #.. #
 #.. #
 #.. ##########
 #.....       #
### ########  #
#@       ### ##
## $ $ $  ## ###
 ## $ $ $ ##   #
  ## $ $ $   # #
   ## $ $ ##   #
    ##    ######
     ######
Solution: undefined

;38
       #######
    ####..   #
    #   .... #
    # # #...##
    # $ ##..#
 ####  $   ##
##    #$$ ##
#  ##$#@# #
# $   $$# #
#  # $$   #
####   $###
   #    #
   ######
Solution: undefined

;39
    ####
    #  ###
 ####    ##
##   $ $  #
#  $ $$$ $#
# #### ## #
# .##...#.#
# .##..##.#
# .#...##.#
## ##@#####
 #$ $$$ $ #
 #  $ $   #
 ##     ###
  ###   #
    #####
Solution: undefined

;40
   #######
 ###     #
 #   $ $ #
##  $######
#  $ #....#
# $ $$...####
##$ @#....  #
 # $ #.#..# #
 #  $#### # #
 # $ $ $  $ #
 #     ##   #
 ############
Solution: undefined

;41
########
#  #   #
#  #   ####
# $$$$$#  #
#  #   @  #
#  #$$$#  #
#  #   #..#
## # ###..#
 #      ..#
 #######..#
       ####
Solution: undefined

;42
         #####
 #########@  #
 #       #$# #
 # #####   $ #
 # #   # $ # #
 # #   # $## #
 # #   #  $  #
## #  ## #####
#...  #  $  #
#...  #$    #
##.# ## $ $##
 #  .      #
 ## .##   ##
  #########
Solution: undefined

;43
###########
#    #    #
#    #    #
#   ###   #
##... ...##
### ###$##
# $$$@  #
# $ $ ###
#     #
#######
Solution: undefined

;44
####
#  #
#  #
#  ##
##$ #
# $ ####
#..  $.#
#.## $ #
###  $ ###
  # ## $ #
  #  .   ##
  ######  #
      #. @#
      #####
Solution: undefined

;45
######
#....##
#..*..##
###....##
  ## $$ ##
   ##    ##
    ## $$ ##
     ##    ##
      ## $$ ##
       ##    ##
        ## $$ ##
         ##    ##
          ## $$ ##
           ##    ##
            ## $$ #
             ##  @#
              #####
Solution: undefined

;46
   #######
  ## ... ##
 ## ...#  #
## ... ## #####
# ...$###$$   #
# $  $ $      #
##  ## #$######
 ####  # ##
   ##@##  ##
   #   # $ #
   # $ #   #
   #  $$$  #
   #   #  ##
   ########
Solution: undefined

;47
######
#    ######
#         #
## #####  #
## #  ## ##
# .$ .   #
# $##$## #
##@##.## #
 #    ##.#
 ###  ##$##
   # $.   #
   ####   #
      #####
Solution: undefined

;48
####  ######
#  ####  @ #
#  #   $$$$#
#  #  #  $ ######
#     #$   #    #
#  # ## ## # ## #
#... #    $   # #
#... #  $##   # #
#... ### ###### #
####    $       #
   #  #         #
   ##############
Solution: undefined

;49
##############
#            #
# ## # # # # #
# $     ...  #
## #######*###
 # #  #.... #
 # #  ### # ###
 # #  #   $   ###
 # #  # # ###@  #
 # #  # $  $ $# #
 # #  ##### # # #
 # #      #   $ #
 # ######## ## ##
 #         $   #
 #  ############
 ####
Solution: undefined

;50
   ###### ######
 ###    ### #  ##
##   # # #      ##
#  $  #  # $ $$  #
# $ $    #$ $  $ #
##   $$..#..  $ ##
 ## $ ...@...$ ##
  ## $$..#..  ##
   ##   .#.  ##
    ##   #  ##
     ##  # ##
      ## # #
       #####
Solution: undefined

;51
       ####
   #####  #   ####
 ###      #####..#
 # $  ##@$ $ #...#
 # #  # $$ # #...#
 # ####  $ # ....#
## ##  $# ## ...##
# $ $$#    $  .##
#      $ #  # ##
#####  $ # $  #
  #  $ $ #  ###
  #   #  ####
  ########
Solution: undefined

;52
    ##########
   ##        ##
  ##  $$$$$$  #
  #           ##
  #$$$$$$$$$$$ #
  #     @      #
 ## ############
 #..##.    #
 #..##.    #
##......   #
# ..####   #
#...     ###
#  #  ####
#######
Solution: undefined

;53
           ###
          ##.#####
          #......#
  ##########.....#
  #  ##        ###
  # $      ##  #
  # $##$$  ##  #
  #  $@ $$ ##  #
### $$### ######
#  $ $    #
# # $   ###
#   ##  #
#########
Solution: undefined

;54
 ######
 #    #
## #$$##
#   $  ##
# ##$$  #
#    @  #####
# ##### #   ##
#...  # $ $  #
#.#.# # # $  #
##  # # ### ##
 #  # $ # # #
 #  ### ### #
 #  ....    #
 #  #########
 #  #
 #  #
 ####
Solution: undefined

;55
 #########
 #   #   #
 #   #   #
 # $$#$$ #
##   $@$ ##
#  $$ $$  #
#  $ #  $ #
##   #   ##
## $$#######
# $  ##....#
#   $$ ....#
# #  # ....##
# ## ## #...#
# $     #...#
######  #####
     ####
Solution: undefined

;56
 #####
## @ ###
#  #$  #
# $  $ ###
## $ #$  #
 #$  $ # #
 # $ $   #
## #$######
# $  #....#
#    # #  #
###    ...#
  ######  #
     #....#
     #    #
     #    #
     ###  #
       ####
Solution: undefined

;57
#########
#       #
# $ $@$ #
#   #####
### #####
  # ##  #####
  #$##$     #
  # .$ $$ $ #
  # .#$ $$ ##
  # .# $   #
  #..#    ##
  #..## # #
  #.....  #
  #. ######
  ####
Solution: undefined

;58
     #######
 #####  #  #
 #    $ $  ##
## $$$ $ $  #
# $ #  $    #
#  $$ ###$ ##
##  # ..#  #
 #  # ..####
 ###..@  ..#
   #..   ..#
   #########
Solution: undefined

;59
#####
#   ##
# #@.#
#  ..###
## ..  #
 # ..  #
 # ##$ #
 #    ##
 #   ##
 ## #####
  # ##  ##
  # ##   #
 ## $  $ ##
 #  #$ $  #
 #  $ #$  #
 #  #     #
 ##########
Solution: undefined

;60
    #####
 ####   ##
 # @# #  #
##  ..   #
#  #..# ##
#   ..#$#
####..  ###
   #### $ #
    #  $$ #
   ##$    ##
   #  $ $  #
   # # #   #
   #   ##$ #
   ######  #
        ####
Solution: undefined

;61
     ######
######    #
#   ## ##$#
#  $@     #
## ### ##$#
 # #    # #
 # #      #
 # #*.## $#
 # #....# ####
 # #####     #
 #       $   #
 #  ##########
 ####
Solution: undefined

;62
   ########
 ###      #
##  $$# # #
#        .#
# $$$$#$#.#
###  @  #.#
 ########.#
 #     ##.#
 # $$$$##.##
 # # # ##..#
 #       ..#
 #######  .#
       #####
Solution: undefined

;63
   ####    ###
####  ##   #.##
#  # $ #####..#
# $  $ #   #..#
#  #   $   $..###
#   #$###$##..  #
###  $ @# ## .  #
#    $  #      ##
#  # $##########
##    #
 ######
Solution: undefined

;64
   ####
####  #
#   $ #
# ### #######  ####
# #   $ $ $ ####..#
# # # # # #     ..#
# #$# # # # # $ ..#
#.$ . . . . $  @..#
# # # # # # # #####
# # #$# # # #$$  #
# # # # # # #    #
#.  . . . .  $ ###
###$#$#$#$# #$ $ #
  #         #    #
  ################
Solution: undefined

;65
 #####
##   #####
#  #$    #####
#  $  $$ #   #
#  #         #
##$####$###$##
# @  $   ## ###
#   ##   ##   #
########### # #
 #   ...  # # #
 #  ....    $ #
 ####.. #######
    #####
Solution: undefined

;66
    ####
   ##  ##
   # $  #
   # $$ #
####  # ########
#     # #  ..  #
# #$ $# #@ ..# #
#  $   $ ..### #
#  $  #  ..##  #
#####$#..###  ##
    # #..#  $ #
    # #### $  #
    #   $   ###
    #  ######
    #  #
    ####
Solution: undefined

;67
##############
#   ##   #   #
# $    $   $ #
##$####$ #####
 #..  .@.  ..#
 #..$ ... $..#
###$###### ###
# $ $ $ $  $ #
#            #
##############
Solution: undefined

;68
            ####
######### ###  ##
#       ###.#$  ##
# ##$$#   #.# $  #
#   $ # $  .#  $ #
# $$ .#####.#$   #
# $ #.# ..*..  $ #
#   #.# #@#.## $ #
#####.# ###.##   #
  #...$ # #.#### #
  ###.#####$ ### #
  ###.# # $   $  #
  #   # #   $ ####
  # $$# ###   #
  #   #   #####
  #####
Solution: undefined

;69
########
#  ....#
# #...##
#  ..######
###       #
  # ## ## #
  # ## ## #
  #   @## #
  #### ## ###
     #  $   ##
     # $$ $  #
     ### $$$ #
       # $ $ #
       #     #
       #######
Solution: undefined

;70
        ######
        #    ##
   #### #$##  #
   #..### ##$ #
####...$ $ #  #
#  ....# $   ##
# $ ..## $ # ##
# # #.## # $  #
# $ #### # #$ #
###      # #  #
  # ###### #$ #
  # ##        #
  #$   ########
  #@####
  ###
Solution: undefined

;71
 ################
 #              #
 # $ $ $ $ $ $  #
 #$############ #
## #.*.. $  ..  #
#  $....#  #..###
# $####### #..#
#   #    $ #..#
# $ #$##   $..#
#  $$..$ ###  #
#   #..#@####$####
## ###$#  ..#    #
 #    $  #..  $$ #
 #  #### # ## $  #
 ####  #     $ $ #
       ######    #
            ######
Solution: undefined

;72
     ####
 #####  #
 #   $$ #
 #  $   #
 # $ @$ #
 #$  $  #
 # #### #
##.*..* #
# ....*##
# #### ##
#       #
##      #
 ########
Solution: undefined

;73
             ###
             #.#
             #.#
          ####.#
    #######   .#
    #         .#
    #  ###### .#
    ##$$    ####
    # $  @$ #
 ####    $$##
##  ######  #
#   $       #
# $$$#####  #
# $  #   ####
#.#  #
#....#
######
Solution: undefined

;74
  ####
 ##  #######
##         #
#  $ $#$ $ #
#  $ $@$ $ #
### ..#..###
  ##..#..#
   #######
Solution: undefined

;75
 #######
 #     #
## #@# ##
#. #$#  #
#.$ $ $.#
#  # # .#
##   ####
 #####
Solution: undefined

;76
        ###
        #.#
#########.####
#     .......#
# # #  # .  ##
#    #   # ##
#### ##  # ##
#   $   ##  #
# #$   $ #  #
#   $ #  #  #
###$$ # $ $ #
#@$  $  ##  #
###  #  #####
  #######
Solution: undefined

;77
             #####
  ############   #
###...##  $ $  # ##
#  ...#  $$@#  $  #
#  .... $ $$ # ## #
#  #..#  $  $ $   #
######## $  ## ## #
       ## ###     #
        #     #####
        #######
Solution: undefined

;78
  ####
  #  #
  #$.#
  #  #
  #$.#
  #  #
  #$.#
  #  #
  #$.#
  #  #
  #$.#
  #  #
###$.###
#   @  #
# #$.  #
#   ####
#####
Solution: undefined

;79
 ####
 #  #
 #  ####
 # ..$ ##
 ## ..$ ##
  # #..$ ##
###  #..$ ##
#   $ #..  #
# # $@ # # #
#   $$$  # #
### $ ##   #
  #   ######
  #####
Solution: undefined

;80
      ########
 ######  #   #
 # $        $#
 # $ ##$###  #
 # $ #..# #$ #
 # ###..###  #
 # $..$$..#$ #
## #..$@..#  #
#  # #..### $##
#  $ #..#  $  #
## $ ##$      #
 #   ##  ######
 #########
Solution: undefined

;81
#############
#           #
#   ###     #
#  ##.##    #
# ##...##$  #
# #.....    #
# ##...##   #
#    .## $  #
# $#@ #     #
#  ####  $  #
#     #  #$ #
# $ $ ####  #
# $#  #   $ #
#  #### $ $ #
# $ $ #  #  #
#     ####  #
#######  ####
Solution: undefined

;82
##############
#    ##......#
# $   $ $ ####
#  $ ###  #
### #####$###
  #   # #   ###
  # $ # #@    #
  # $$#####$# #
  #  $ .....  #
  #  $#########
  #   #
  #####
Solution: undefined

;83
     ####
     #  ######
     #       #
  #### ####  #
  #  .....# ##
  # #.  ### ##
  #....@## $ #
##########$  #
#    ##  $   #
# $    $  $ ##
#  $$##  ####
# $$ #####
#    #
#    #
######
Solution: undefined

;84
     ####
     #  ###
     # ...#
     # ...#
  #####...#
  #  ..$####
  #  ..$@$ #
 ### ### # #
##    ##   #
# $$  $ ####
#   #$$  #
##$      #
 # $ $$ ##
 ##   $ #
  ###  ##
    ####
Solution: undefined

;85
      #####
      # ..#
    ### ..#
    #  ...#
   ## #...#
   #  ## ##
####$     #
#     # $ #
#  $ $  $@#
#  $  #$###
###$$##  #
  #   $  #
  #   #  #
  ########
Solution: undefined

;86
#############
#    #..  ..#
# $  ## # # #
#  $$#      ##
# $  $  #  ..#
# $ $#..@ ####
# $$ $ ## ###
#    #... ..#
####$### ####
   #    $#
   # # $ #
   #    ##
   ######
Solution: undefined

;87
 ###############
 #   ##.#. ##  #
## $ #.. ..$   ##
#    $  #  #$$  #
# $$ #.. ..#    #
## $ ##.#.##   ##
 # $ #### ##   #
 #   ##@$ ##  ##
 ###### $$#####
      #   #
      #####
Solution: undefined

;88
 #####
##   ##
#   $ #
# $   #
#  $$ #
#  $  #
##$####
#...####
#..@$  #
#...#  #
### #$ #
  #    #
  ######
Solution: undefined

;89
    #####
#####   #####
#...     ...#
#...........#
###### ######
   #      #
   # # #  #
  ##  $  ##
### $ # $ ###
#    $$$    #
#  $     $  #
# $$ $$$ $$ #
#  #$# #$#  #
####    @####
   #######
Solution: undefined

;90
  ####
  #  #####
  #  $   #
  #  #   #
#### # # ##
#   $     #
#   $$#$# #
## $  $@# #
 #$ $##$# #
 #     $  #
####  #####
#.....    #
#......   #
#####   ###
    #####
Solution: undefined

;91
      ####
 #### #  ###
##  ###    #
#...     # #
#...###$ $$##
#...#  $ $  #
#  ## ##$## ##
#  ##  #  #  #
#  ## $   $$ #
#####  # ##  #
    #    ## @#
    ##########
Solution: undefined

;92
 ##########
 #    #   #
 #  $ # $ #
##$ ### # ####
#    *.*.*   #
# $$#.#@#.#$ #
#   #.# #*#  #
# $ #*....   #
#   # $#######
#  $   #
#####  #
    ####
Solution: undefined

;93
  #########
###  ##   #
#      $  #
#  $ $$ ###
# ## $ $#
#   $$#@#
###$$ #####
  #   $   #
 ## $#### ##
 #...   ...#
 #...#  ...#
 ###########
Solution: undefined

;94
 ##############
 #     ...... #
## ### #####. #
#      #   #.##
#   # $    # #
###$  ###$## #
 #   $#      #
 # $$ # # #  #
 ##@$ $ # ## #
  ##  ###    #
   #### ######
Solution: undefined

;95
  #####
###  .####
#   ..#  ###
#  ..##$   #
## ###@$ # #
 # # $$$ # #
 # #       #
 # ## #### #
 #         #
 #  ########
 ####
Solution: undefined

;96
#########
#    ...#
#   $...#
###$ #@##
#   $...#
#    ...#
######$###
# $  $ $ #
# $  $ $ #
#  $  $  #
##      ##
 ########
Solution: undefined

;97
   #####
  ##   ####
  # $ $ $ #
###   #.$ ##
#  $ $#... #
#  $$@$... #
## $ ##...##
 #   ######
 #####
Solution: undefined

;98
        #####
####  ###   #  ####
#..## # $ $ # ##  #
#...###     ###   #
#....## $ $ ##  $ #
##... ### ###  $ ##
 ##.*   $  $ $$ ##
  ##.  $$$$    ##
   ##### @######
       ####
Solution: undefined

;99
  ######
  #    ###
  # $  $ #
  # $$   #
  ## #   #
   # ## #####
   # #@$$.  #
#### #  #.# #
#  . # $ .# #
#  . ### .  #
#  . ########
###.$ #
  #   #
  #####
Solution: undefined

;100
     ####
     #  #
 #####  ####
 #...     .#
 # ### ###.#
 # # $$$ #.#
 # #     # #
 #$$$ @ $$$#
 # #     # #
##.# $$$ # #
# .### ##  #
# .     ...#
#########  #
        ####
Solution: undefined

