;1
   ############
   #      .   #
 ###$.###  $  #
 #    #### #.##
##$.* ##  $#.#
#  $#$## $ #.#
# * ... #@##.#
# .$ $  # # .#
# .#$#$##$#$.#
# *    $  $  #
##.######  ###
# .      $ #
#   ####  ##
#####  ####
Solution: undefined

;2
      ####
 ######  #
##       #####
# $# #@# #   #
#   $ # *  . #
##$# . . #$.##
 #  # ..##  #
 #  # .. #$ #
 # $#*$ $   #
 #    #######
 #  ###
 ####
Solution: u1r2l6d1l1d1r1d2r1d2l1d2r1u1r2u2r1u2r2l1u1r3u1r2l2d1l3d1l1d2u1r1l1u1l1r2d1l1d1r1u1l1d1r1u1l1d1u1r1d1l1u2l2u1d1r2l2u1r1d1r3u3l6d4r1d1u1l1u4r6d3l1d3u1l2r1u2l2u1r1d1r3l1d2l2d2l3u2r1l1d2r3u2r1u2l1u1d1r3u3l6d4r1d2l1d1r1u3l1u4d6u6r6d3l3u1l2r2d1r3u3l6d4u2r2d1r2d2l1u1r2u2r1u2l6d2r2d1r2l2u1l2u2r6d2l1d1l1d2l1u3l3u2r6d3l3d3u4l3d2r1d2l1u4r2l2d4r1d2l1u2r1u2l1u2r3d5l2r2u2r2d1l1u1l1u3l3d2r1d3r2u3d3l2u3l1u2r2d1u1r1d1r3u1d1l1d1l1d1l1u1d3l2u3l1u2r2d1r1d1r2u2r1u2l4d1u1r4d3l1d1l2u2l1r1d1r1l2u3r4d2l1d1l2d4l2u3l1u2r1l1d2r1d3r2u4l1u1d1r4u1r2u1r2d1l1d4l5u3l1u1l3d2r1d3r2u2r1u2r2u3l4d1u1r4d3l3u1l1r1d1r1d2l1u1d3l2u2d2r2u3r1u1r2u3l4d3u1r1d1r1d3r2l3u1d2l2u3l1u2r1l1d2r1d3r2u2r1u2l2u1d1r2d2l1u1d2r3u1l1d1l2u2r1u1r1d1l2d3l2u3l1u2r2d1r1d1r2u2r1u2l4d1u1r4d3l1d1l2u2l1r1d2u1r1l2u3r4d2l1d1l2d3r1u1d1r5u2l1r1d2l6d1l2u3l1u2r1l1d2r1d3r2u4l1u1d1r4u1r2u1r2d1l1d2l1d1r1d1l5u1l1u3l3d2r1d3r2u2d2l2u3l1u2r2d1r4u1r2d2u2l3d1l2r3u3l4d1u1r4d3l3u1l1r1d1r3u1r2d2r1d2u2l1u2l2d1l2r2u1r2d2r1d2l5r2u1l1r1d1r3u2l1u2l3d2u2r3d2r1d2l6u2d2r6u2l1u2l2u2l4d3r2l2u3r4d2l1d1l2d4l2u3l1u2r1l1d2r1d3r2u4l1u1d1r4u3l6d2r2u1d1l2u2r5u1r1d2u1l1r1d1u1l4d3r3l2d3r6u3l1u2r1d1l1d2r1d2l6u3r2u1r3d2r1d2u1d1l6d1l2u3l1u2r2u2l2d1l1d1r2l1d2r1d3r2l2u3l1u2r1l1d2r1d3r2u4l1u2d1l2u2r4l2d3r4u1r2u1r2d1u1l2d4r1d1l5r4u4l3d1l3u1l2d2r1d3r2u3d3l2u3l1u2r2d1r1l1r1d3r5u5r2d1l1u1l1d3r1d2l6u3d3r6u2l1u2l2d1l1u1r4l3r3l3u1d1r2d2r1d2l6d1l2u1l1u3d2r1d2r2u5l1u2l2d1l1d1r2l1d2r1d3r2u4l1u1d1r1d3r6u2l1u2l2d1l2r2u1r2d2r1d2l6d1l2u3l1u2r3l1d1r2l1d4u1r6u2l1u2l2d1l2r2u1r2d2r1d2l6d1l2u3l1u2r3d1r3u1r2d2r1d2l1r1u2l1r1d2l6d1u1r2l2d1l2u3l1u4r5u1r1d2u1l6d2r3d1r2u1r3d2r1d2l6u2d3l2u3l1u2r2d1r2l1d4u1r1l1u3d3r4l4u4l1u1d1l2u2r5u1r1d1u1l1d1l3d3r1d3r6u2l1u2l2d1l2r2u1r2d2r1d2l6d1l2u3l1u2r3d1r1l2u1l2d3r1d3l1u6r2u2l2d1l1d1r2l2r1d5r3u1r6u2l1u2l2d1l4u1d1r4u1r2d2r1d2l6d1l2u3l1u4d2r3d1r3u1r2d3r1d1l4r3u4l2r2u1r2d1l1u1l1d3u2l3d1l2u1l3u2r6d1u1l6d2r3d1r2u1r3d2r1d2u2l1u2l3d1l3u1l2d2r1d3r2u3d3l2u3l1u2r2d1r2l2u1l2u2r6d2r2d2r1d2l5r5u2l1u2l2u2l6d7r3u3d2r6u2l1d1r1d1l5r4u4l2u2l6d2r2u1d1l2u2r5u1r1d2

;3
     ######
     #    #
     # $ $####
     # $     #
     # # $## #####
     # $  ##$$ $ #
     ###$ #.     #
#### ###. #.*   ##
#  # #. .##.#$###
# $###....+.. #
#     .*#$ $$ #
#######      ##
      ########
Solution: d2l3u1l6u2r1d1l1d1r5u2r2d1l1r3d2l3u1l1r1d1r3u2l2u1l2d1u1r1d1r1u2r1u2l1u2r4d1u1l4d2r1d2l1d2r4l1u3d1r2l2d2l4u1r1u1r1u2l1u2r4d3l1d3l3u2r1u2l1d3l1d1u1r1u5r4d3l1d3l1d2l3u2d2r3u2l2u1l1d1r4u2d2l1d2r1u2r2d1l2u1l3u6r4d3l1d3l2r2u3d3r1d2l2r2u2l4u8l2d4r1l1u4r2d7u5r4d3l1d3l4r1u8l2d2r1l1u2r2d7u5r4d3l1d3l3u3r1u2d3l1d2r3u3r1u3l3d2l3u4r2d2u2r1d1l1d1l2d2r2d4r4l1u3r1u3l3d4l1d2r4l2r1u3r3u1l1d1l2d3l3u3r1u3r3d2r1l1u2l3d4l1d2r4d2l2u1r1l1r1u4r1u3l3d4l1d2r2d2r2u1d1l1u1l1u1l2u3r1u3r3d3l1d3l1d2u2r1u3r1u1r2d1l1d1l1r1u2l1d1l1r5u1l1d1l4r1u3l3d4l1d2r2d2r2u1r1u2d2l1d1l2r2u1r1u1l1d2l2u2l2u3r1u3r3d2r2l2u2l3d4l1d2r2d2r2u1r1u4d3l1d2l2u2d2u2r1l1d2r2u1l1r2u1d1l2d1l2u1d1r2u1r2u4l1u3l3d4l1d2r1d2r2u1r2u4l2d2u2r3u1l1r1d1l1d1l1u1l1d1u1d1r2d3l2d1l2u2l1u2r1u4r3d3r1d1l1u1r3d1l2r2u1r1u1l3d5l2d1l2u2l1u3r1u3r3d2r1d1l1r1d4l3d1l1u1d1r3u1r1u4l1u3l4d5u3l2u2r1l1u2r2d6u2l2u3r1u1r1d5

;4
             ###############
  ######     #             #
  #    #     # $ $$$$$$$## #
  # ## ##  ###$   $ $   $  #
  #     #### $        $ $$ #
  # # #    # $   $ $ $   $ #
  # #    # #     $@$ $ $ $ #
  #.#  #   ####    $ $ $ ###
  #.####    # #   $ $ $  #
  #.#  ## # ### # ########
 ##.### #         #
 #....### # #######
##......#   #
#. .....# ###
#. .....  #
##......###
 ########
Solution: l2,15-5d4,16-10l6,9-11u3,10-7l1,8-8u2,9-5l1,7-4d1,8-6l2,5-7u2,6-4l2,3-3d8,3-13u1,2-11r2,18-5l2,15-4d5,16-10l6,9-11u3,10-7l1,8-8u2,9-5l1,7-4d1,8-6l2,5-7u2,6-4l2,3-3d8,3-13u1,2-11r1,12-5r2,15-4d5,16-10l6,9-11u3,10-7l1,8-8u2,9-5l1,7-4d1,8-6l2,5-7u2,6-4l2,3-3d8,2-12r4,15-1d8,16-10l6,9-11u3,10-7l1,8-8u2,9-5l1,7-4d1,8-6l2,5-7u2,6-4l2,3-2d9,2-12r3,12-4r2,15-3d6,16-10l6,9-11u3,10-7l1,8-8u2,9-5l1,7-4d1,8-6l2,5-7u2,6-4l2,3-3d8,2-12r2,14-2d3,13-6r1,15-5d4,16-10l6,9-11u3,10-7l1,8-8u2,9-5l1,7-4d1,8-6l2,5-7u2,6-4l2,3-3d8,2-12r1,19-3l3,15-2d7,16-10l6,9-11u3,10-7l1,8-8u2,9-5l1,7-4d1,8-6l2,5-7u2,6-4l2,3-3d9,4-13l1,2-14u2,21-3l5,15-2d7,16-10l6,9-11u3,10-7l1,8-8u2,9-5l1,7-4d1,8-6l2,5-7u2,6-4l2,3-3d9,4-13l1,2-14u1,20-5l4,15-4d5,16-10l6,9-11u3,10-7l1,8-8u2,9-5l1,7-4d1,8-6l2,5-7u2,6-4l2,3-3d9,4-13l2,20-6l4,15-5d4,16-10l6,9-11u3,10-7l1,8-8u2,9-5l1,7-4d1,8-6l2,5-7u2,6-4l2,3-3d10,4-14l2,20-7l4,15-6d3,16-10l6,9-11u3,10-7l1,8-8u2,9-5l1,7-4d1,8-6l2,5-7u2,6-4l2,3-3d11,2-15r4,19-8l3,15-7d2,16-10l6,9-11u3,10-7l1,8-8u2,9-5l1,7-4d1,8-6l2,5-7u2,6-4l2,3-3d11,2-15r3,17-1d6,18-8l2,15-7d2,16-10l6,9-11u3,10-7l1,8-8u2,9-5l1,7-4d1,8-6l2,5-7u2,6-4l2,3-3d11,2-15r2,18-1d6,19-8l3,15-7d2,16-10l6,9-11u3,10-7l1,8-8u2,9-5l1,7-4d1,8-6l2,5-7u2,6-4l2,3-3d11,2-15r1,23-4l7,15-3d6,16-10l6,9-11u3,10-7l1,8-8u2,9-5l1,7-4d1,8-6l2,5-7u2,6-4l2,3-3d11,22-5l6,15-4d5,16-10l6,9-11u3,10-7l1,8-8u2,9-5l1,7-4d1,8-6l2,5-7u2,6-4l2,3-3d10,4-14l1,2-13d1,22-6l6,15-5d4,16-10l6,9-11u3,10-7l1,8-8u2,9-5l1,7-4d1,8-6l2,5-7u2,6-4l2,3-3d9,2-13r4,22-7l6,15-6d3,16-10l6,9-11u3,10-7l1,8-8u2,9-5l1,7-4d1,8-6l2,5-7u2,6-4l2,3-3d9,2-13r3,21-8l5,15-7d2,16-10l6,9-11u3,10-7l1,8-8u2,9-5l1,7-4d1,8-6l2,5-7u2,6-4l2,3-3d9,2-13r2,24-6l8,15-5d4,16-10l6,9-11u3,10-7l1,8-8u2,9-5l1,7-4d1,8-6l2,5-7u2,6-4l2,3-3d9,2-13r1,24-7l8,15-6d3,16-10l6,9-11u3,10-7l1,8-8u2,9-5l1,7-4d1,8-6l2,5-7u2,6-4l2,3-3d10,2-14r4,23-8l7,15-7d2,16-10l6,9-11u3,10-7l1,8-8u2,9-5l1,7-4d1,8-6l2,5-7u2,6-4l2,3-3d10,2-14r3,19-1d6,20-8l4,15-7d2,16-10l6,9-11u3,10-7l1,8-8u2,9-5l1,7-4d1,8-6l2,5-7u2,6-4l2,3-3d10,2-14r2,20-1d6,21-8l5,15-7d2,16-10l6,9-11u3,10-7l1,8-8u2,9-5l1,7-4d1,8-6l2,5-7u2,6-4l2,3-3d10,2-14r1,21-1d6,22-8l6,15-7d2,16-10l6,9-11u3,10-7l1,8-8u2,9-5l1,7-4d1,8-6l2,5-7u2,6-4l2,3-3d10,22-1d6,23-8l7,15-7d2,16-10l6,9-11u3,10-7l1,8-8u2,9-5l1,7-4d1,8-6l2,5-7u2,6-4l2,3-3d9,23-1d6,24-8l8,15-7d2,16-10l6,9-11u3,10-7l1,8-8u2,9-5l1,7-4d1,8-6l2,5-7u2,6-4l2,3-3d8,25-3l3,21-2d5,22-8l6,15-7d2,16-10l6,9-11u3,10-7l1,8-8u2,9-5l1,7-4d1,8-6l2,5-7u2,6-4l2,3-3d7,24-5u1,25-3l9,15-2d7,16-10l6,9-11u3,10-7l1,8-8u2,9-5l1,7-4d1,8-6l2,5-7u2,6-4l2,3-3d6,26-4l10,15-3d6,16-10l6,9-11u3,10-7l1,8-8u2,9-5l1,7-4d1,8-6l2,5-7u2,6-4l2,3-3d5,26-5l10,15-4d5,16-10l6,9-11u3,10-7l1,8-8u2,9-5l1,7-4d1,8-6l2,5-7u2,6-4l2,3-3d4,26-6l10,15-5d4,16-10l6,9-11u3,10-7l1,8-8u2,9-5l1,7-4d1,8-6l2,5-7u2,6-4l2,3-3d3

;5
#####                                   ######
#   #####################################    #
# .             @                         ## #
## ###################################### ## #
 # ##         . . . . . . . . . .        . # #
 # ##                                      # #
 # ##.###################################### #
 # #  . . . . . . . . . . . . . . . . . . ## #
 # #                                      ## #
 # ###################################### ## #
 # ## . . . . . . . . . . . . . . . . . .  # #
 # ##                                      # #
 # ## ###################################### #
 # #  . .################################### #
 # #                                      ## #
 # ###################################### ## #
 # ###################################### ## #
 # ##                                     ## #
 # ## ###################################### #
 # ## ###################################### #
 # ##                                      # #
 # ####################################### # #
 # ##                                      # #
 # ##$$$$$$$$$$$$$$$$$$$$$$$############## # #
 # ##                       ############## # #
 # #                                       # #
 # #                                     ....#
 # ###$#$$$$$$$$$$$$$$$$$$$$$$$$$$$#$#$#$# # #
## # #                                     # #
#  ######################################### ##
#                                           $ #
#  ########################################   #
####                                      #####
Solution: 45-30l42,2-31u28,1-2r39,41-1d3,42-5l36,5-4d3,4-8r36,41-7d3,42-11l36,5-10d2,4-13r3,5-22d3,4-26r39,44-25d4,45-30l42,2-31u28,1-2r39,41-1d3,42-5l36,5-4d3,4-8r36,41-7d3,42-11l36,5-10d2,4-13r1,6-28u1,5-26r38,44-25d4,45-30l42,2-31u28,1-2r39,41-1d3,42-5l36,5-4d3,4-8r36,41-7d2,42-10l35,6-22d3,5-26r38,44-25d4,45-30l42,2-31u28,1-2r39,41-1d3,42-5l36,5-4d3,4-8r36,41-7d2,42-10l33,7-22d3,6-26r37,44-25d4,45-30l42,2-31u28,1-2r39,41-1d3,42-5l36,5-4d3,4-8r36,41-7d2,42-10l31,8-28u1,7-26r36,44-25d4,45-30l42,2-31u28,1-2r39,41-1d3,42-5l36,5-4d3,4-8r36,41-7d2,42-10l29,8-22d3,7-26r36,44-25d4,45-30l42,2-31u28,1-2r39,41-1d3,42-5l36,5-4d3,4-8r36,41-7d2,42-10l27,9-22d3,8-26r35,44-25d4,45-30l42,2-31u28,1-2r39,41-1d3,42-5l36,5-4d3,4-8r36,41-7d2,42-10l25,10-22d3,9-26r34,44-25d4,45-30l42,2-31u28,1-2r39,41-1d3,42-5l36,5-4d3,4-8r36,41-7d2,42-10l23,11-22d3,10-26r33,44-25d4,45-30l42,2-31u28,1-2r39,41-1d3,42-5l36,5-4d3,4-8r36,41-7d2,42-10l21,12-22d3,11-26r32,44-25d4,45-30l42,2-31u28,1-2r39,41-1d3,42-5l36,5-4d3,4-8r36,41-7d2,42-10l19,13-22d3,12-26r31,44-25d4,45-30l42,2-31u28,1-2r39,41-1d3,42-5l36,5-4d3,4-8r36,41-7d2,42-10l17,14-22d3,13-26r30,44-25d4,45-30l42,2-31u28,1-2r39,41-1d3,42-5l36,5-4d3,4-8r36,41-7d2,42-10l15,15-22d3,14-26r29,44-25d4,45-30l42,2-31u28,1-2r39,41-1d3,42-5l36,5-4d3,4-8r36,41-7d2,42-10l13,16-22d3,15-26r28,44-25d4,45-30l42,2-31u28,1-2r39,41-1d3,42-5l36,5-4d3,4-8r36,41-7d2,42-10l11,17-22d3,16-26r27,44-25d4,45-30l42,2-31u28,1-2r39,41-1d3,42-5l36,5-4d3,4-8r36,41-7d2,42-10l9,18-22d3,17-26r26,44-25d4,45-30l42,2-31u28,1-2r39,41-1d3,42-5l36,5-4d3,4-8r36,41-7d2,42-10l7,19-22d3,18-26r25,44-25d4,45-30l42,2-31u28,1-2r39,41-1d3,42-5l36,5-4d3,4-8r36,41-7d2,42-10l5,20-22d3,19-26r24,44-25d4,45-30l42,2-31u28,1-2r39,41-1d3,42-5l36,5-4d3,4-8r36,41-7d2,42-10l3,21-22d3,20-26r23,44-25d4,45-30l42,2-31u28,1-2r39,41-1d3,42-5l36,5-4d3,4-8r36,41-7d2,42-10l1,22-22d3,21-26r22,44-25d4,45-30l42,2-31u28,1-2r39,41-1d3,42-5l36,5-4d2,4-7r35,23-22d3,22-26r21,44-25d4,45-30l42,2-31u28,1-2r39,41-1d3,42-5l36,5-4d2,4-7r33,24-22d3,23-26r20,44-25d4,45-30l42,2-31u28,1-2r39,41-1d3,42-5l36,5-4d2,4-7r31,25-22d3,24-26r19,44-25d4,45-30l42,2-31u28,1-2r39,41-1d3,42-5l36,5-4d2,4-7r29,26-22d3,25-26r18,44-25d4,45-30l42,2-31u28,1-2r39,41-1d3,42-5l36,5-4d2,4-7r27,27-22d3,26-26r17,44-25d4,45-30l42,2-31u28,1-2r39,41-1d3,42-5l36,5-4d2,4-7r25,9-28u1,8-26r35,44-25d4,45-30l42,2-31u28,1-2r39,41-1d3,42-5l36,5-4d2,4-7r23,10-28u1,9-26r34,44-25d4,45-30l42,2-31u28,1-2r39,41-1d3,42-5l36,5-4d2,4-7r21,11-28u1,10-26r33,44-25d4,45-30l42,2-31u28,1-2r39,41-1d3,42-5l36,5-4d2,4-7r19,12-28u1,11-26r32,44-25d4,45-30l42,2-31u28,1-2r39,41-1d3,42-5l36,5-4d2,4-7r17,13-28u1,12-26r31,44-25d4,45-30l42,2-31u28,1-2r39,41-1d3,42-5l36,5-4d2,4-7r15,14-28u1,13-26r30,44-25d4,45-30l42,2-31u28,1-2r39,41-1d3,42-5l36,5-4d2,4-7r13,15-28u1,14-26r29,44-25d4,45-30l42,2-31u28,1-2r39,41-1d3,42-5l36,5-4d2,4-7r11,16-28u1,15-26r28,44-25d4,45-30l42,2-31u28,1-2r39,41-1d3,42-5l36,5-4d2,4-7r9,17-28u1,16-26r27,44-25d4,45-30l42,2-31u28,1-2r39,41-1d3,42-5l36,5-4d2,4-7r7,18-28u1,17-26r26,44-25d4,45-30l42,2-31u28,1-2r39,41-1d3,42-5l36,5-4d2,4-7r5,19-28u1,18-26r25,44-25d4,45-30l42,2-31u28,1-2r39,41-1d3,42-5l36,5-4d2,4-7r3,20-28u1,19-26r24,44-25d4,45-30l42,2-31u28,1-2r39,41-1d3,42-5l36,5-4d2,4-7r1,21-28u1,20-26r23,44-25d4,45-30l42,2-31u28,1-2r39,41-1d3,42-5l33,22-28u1,21-26r22,44-25d4,45-30l42,2-31u28,1-2r39,41-1d2,42-4l27,23-28u1,22-26r21,44-25d4,45-30l42,2-31u28,1-2r39,41-1d2,42-4l25,24-28u1,23-26r20,44-25d4,45-30l42,2-31u28,1-2r39,41-1d2,42-4l23,25-28u1,24-26r19,44-25d4,45-30l42,2-31u28,1-2r39,41-1d2,42-4l21,26-28u1,25-26r18,44-25d4,45-30l42,2-31u28,1-2r39,41-1d2,42-4l19,27-28u1,26-26r17,44-25d4,45-30l42,2-31u28,1-2r39,41-1d2,42-4l17,28-28u1,27-26r16,44-25d4,45-30l42,2-31u28,1-2r39,41-1d2,42-4l15,29-28u1,28-26r15,44-25d4,45-30l42,2-31u28,1-2r39,41-1d2,42-4l13,30-28u1,29-26r14,44-25d4,45-30l42,2-31u28,1-2r39,41-1d2,42-4l11,31-28u1,30-26r13,44-25d4,45-30l42,2-31u28,1-2r39,41-1d2,42-4l9,32-28u1,31-26r12,44-25d4,45-30l42,2-31u28,1-2r39,41-1d2,42-4l1,33-28u1,32-26r11,44-25d4,45-30l42,2-31u28,34-28u1,33-26r10,36-28u1,35-26r7,38-28u1,37-26r4,40-28u1,39-26r1,9-5l3,5-4d1,39-4r1

;6
##########
#   ##   #######
#      $    $  #
## ### ##$#.#  #
# . ## #  #.  ##
#.**##   $$*.$#
#  .####  #.. #
### ##### #.# #
#    #  $ #.#$#
#  $  $ # @   #
######  #######
     ####
Solution: undefined

;7
  ##############
  #            ##
  #   @    ###  #
  # #####    #$ #
  # #   # $  #  #
  # #   ### ##  #
### #   ##  ##$##
#.. ## ##   ## ##
##*  # #    ##  #
#..  # #   ###$ #
#..  # ## ###   #
######  #  $    #
        # $  # ##
        ###    #
          ######
Solution: 10-11r3,14-10d1,14-8d2,14-5d3,9-4r1,11-5u1,12-3l2,9-4u1,2-9u1,3-7l1,10-2l6,3-1d6,4-8l1,2-9u1,9-12r1,11-13u1,12-11l2,9-12u3,8-8r1,10-9u1,9-7r1,11-8u4,12-3l2,9-4u1,10-2l6,3-1d7,3-10u1,4-8l1,15-11l5,9-12u3,8-8r1,10-9u1,9-7r1,11-8u4,12-3l2,9-4u1,10-2l6,3-1d7,4-9l2,14-13u1,15-11l5,9-12u3,8-8r1,10-9u1,9-7r1,11-8u4,12-3l2,9-4u1,10-2l6,3-1d7,4-9l1,14-8d2,15-11l5,9-12u3,8-8r1,10-9u1,9-7r1,11-8u4,12-3l2,9-4u1,10-2l6,3-1d8,4-10l2,14-2d8,15-11l5,9-12u3,8-8r1,10-9u1,9-7r1,11-8u4,12-3l2,9-4u1,10-2l6,3-1d8,4-10l1

;8
    ######  ######
 ####    #  #    ####
 #   $## ####$ #. $ #####
##$   ##.   $  #$#  #   #
#  ## ## # ## #     $ # #
#. ##  $   ##   ###     #
# $## #################$#####
# ... ................. .  .#
# ###################### # ##
# $      $  $            # #
###### ####.$  # ##$### $  #
#@ ###       # # ##   ## ####
## ##  # $  ## . ####       #
 # ## $####$ ##$ #  ## $ #$ #
 # $   #  #     ##   ###  $ #
 # #$# #  # #$  #      #$# ##
 #     #  #    ##      #   #
 #######  ######       #####
Solution: 11-9r3,23-7u2,13-3l3,5-1d2,11-12d1,13-10l1,8-9r4,1-9r6,23-10r1,27-14l1,24-16u8,23-7r3,26-10l1,24-9d5,5-5u2,2-5d1,3-7l1,1-8u2,2-2d4,1-7r23,5-1d5,6-7l3,8-5l2,5-4d2,6-7l2,10-3l1,8-2d2,9-5l3,5-4d2,6-7l1,13-1d1,14-3l5,26-7l19,23-3d3,24-7l16,19-4r1,21-3d1,20-5r2,23-4d2,24-7l15,16-2d1,15-4r5,21-3d1,20-5r2,23-4d2,24-7l14,19-2l2,19-11u1,18-9r5,24-10u2,25-7l14,14-9r9,24-10u2,25-7l13,12-9r11,24-10u2,25-7l12,7-9r16,24-10u2,25-7l11,6-14u4,5-9r18,24-10u2,25-7l10,2-14r3,6-15u5,5-9r18,24-10u2,25-7l9,4-16u1,3-14r2,6-15u5,5-9r18,24-10u2,25-7l8,11-11u1,10-9r13,24-10u2,25-7l7,11-15u5,10-9r13,24-10u2,25-7l6,13-16u1,14-14l2,11-15u5,10-9r13,24-10u2,25-7l5,15-14u1,8-12r2,11-13u2,24-16u8,25-7l4,26-14l1,24-15u7,25-7l3,22-13r1,24-14u6,25-7l2,26-14u1,27-12l2,24-13u5

;9
####################
#..      $      $..#
## ####### ###### ##
##$ ###### ######  #
# $       $        #
#  .#####   #####  #
## ############## $#
 #   $.$.  $.$.  $.#
 #  $. $. $. $. $. #
 # $.  $.$.  $.$.  #
## ############### #
#   . . . .$. .### #
# $$$$$$$$$ $$$.##.#
#@ . . . .#. .######
###############
Solution: 10-11r3d1r1,12-13u1,9-11d1r1,11-11d1,8-13u1,7-11d1,6-13u1,5-11d1,4-13u1,3-11d1,18-5d6,17-6d1,16-9u1,15-7r2,14-9r1,9-4r1,15-1r2,12-4l1,9-4r7,17-3d1,7-11r2,5-11r2,3-11r2,2-13u1,1-11r2,10-1l8,1-4r1u2,3-3d1,17-6u4,3-8r1,6-7r2,9-8r1,12-9r1,12-8r1,12-7r1,10-7r1,8-9r1,6-7l2,10-7l4,6-8r1,6-9r1,4-7r3,2-7r3,2-9r1

;10
         #####
         #   #
         #$. #
       ###.$.#
       # .$.$###
       # $# .$ #
       # .$.$. #
   ##### $# *$ #####
 ###     .$. .     ###
##.$.$.$.$. #$.$.$.$.##
# $.$.$#@. $ . #$.$.$ #
# .$.$.$* $ $ .$.$.$. #
# $.$.$.$.$ $. #$.$.$ #
##.$.$.$.$. .$.$.$.$.##
 ###     .$* .     ###
   ##### $.$#$ #####
       # .$.$. #
       # $.$.$ #
       # .$.$. #
       ##$.$.$##
        #.$.$.#
        ##   ##
         #####
Solution: undefined

;11
  ##############
  #            ##
  # $ @ $ $###  #
  #$#####    #$ #
  # #   # $  #  #
  # #   ### ##  #
### #   ##  ##$##
#...## ##   ## ##
##*. # #    ##  #
#... # #   ###$ #
#... # ## ###   #
######  #  $    #
        # $  # ##
        ###    #
          ######
Solution: 3-2d7,4-10l2,2-7d1,3-9l1,5-2l1,3-1d7,4-9l1,2-10u2,3-7l1,9-2l5,3-1d6,4-8l1,2-9u1,10-11r1,14-8d1,9-12r2,13-11l3,9-12u3,14-9d2,14-5d4,9-4r1,11-5u1,12-3l2,9-4u1,10-1d1l6,3-1d7,4-9l1,2-10u1,11-3l1,9-4u1,10-2l6,3-1d7,4-9l1,8-8r1,10-9u1,9-7r1,11-8u4,12-3l2,9-4u1,10-2l6,3-1d8,4-10l1,14-9d1,15-11l5,9-12u3,8-8r1,10-9u1,9-7r1,11-8u4,12-3l2,9-4u1,10-2l6,3-1d8,14-13u1,15-11l5,9-12u3,8-8r1,10-9u1,9-7r1,11-8u4,12-3l2,9-4u1,10-2l6,3-1d7,12-13u1,13-11l3,9-12u3,8-8r1,10-9u1,9-7r1,11-8u4,12-3l2,9-4u1,10-2l6,3-1d6,14-2d8,15-11l5,9-12u3,8-8r1,10-9u1,9-7r1,11-8u4,12-3l2,9-4u1,10-2l6,3-1d5

;12
             ###############
  ########   #             #
  #      ##  #  $ $ $ $ ## #
  # ## #  ####  $$ $ $ $   #
  #     # ##  $  $$ $ $ $  #
  # # #    # $$$ $   $ $ $ #
  # #    # #   $@$  $ $ $  #
  # #  #   ###  $$ $ $ $ ###
 ## ####    ###   $ $ $  #
 #. ....#   ### # ########
 #. ....#         #
 #. ....# # #######
##. ....#   #
#.  ....# ###
#.  ....  #
##. ....###
 ########
Solution: d1,17-8l1,15-7d2,16-10l6,9-11u3,10-7l1,8-8u2,9-5l1,7-4d1,8-6l2,5-7u2,6-4l2,3-3d9,4-13l2,17-2l1d5,17-8l1,15-7d2,16-10l6,9-11u3,10-7l1,8-8u2,9-5l1,7-4d1,8-6l2,5-7u2,6-4l2,3-3d10,4-14l2,13-4r2,16-3d4,17-8l1,15-7d2,16-10l6,9-11u3,10-7l1,8-8u2,9-5l1,7-4d1,8-6l2,5-7u2,6-4l2,3-3d6,2-10r4,7-11u1,14-6u1r1d4,16-10l6,9-11u3,10-7l1,8-8u2,9-5l1,7-4d1,8-6l2,5-7u2,6-4l2,3-3d6,2-10r3,6-11u1,13-4r1,15-3d6,16-10l6,9-11u3,10-7l1,8-8u2,9-5l1,7-4d1,8-6l2,5-7u2,6-4l2,3-3d6,2-10r2,5-11u1,12-5r2,15-4d5,16-10l6,9-11u3,10-7l1,8-8u2,9-5l1,7-4d1,8-6l2,5-7u2,6-4l2,3-3d6,2-10r1,4-11u1,15-1d8,16-10l6,9-11u3,10-7l1,8-8u2,9-5l1,7-4d1,8-6l2,5-7u2,6-4l2,3-3d6,2-10r4,19-2l3,15-1d8,16-10l6,9-11u3,10-7l1,8-8u2,9-5l1,7-4d1,8-6l2,5-7u2,6-4l2,3-3d6,2-10r3,21-2l5,15-1d8,16-10l6,9-11u3,10-7l1,8-8u2,9-5l1,7-4d1,8-6l2,5-7u2,6-4l2,3-3d6,2-10r2,23-2l7,15-1d8,16-10l6,9-11u3,10-7l1,8-8u2,9-5l1,7-4d1,8-6l2,5-7u2,6-4l2,3-3d6,2-10r1,18-3l2,15-2d7,16-10l6,9-11u3,10-7l1,8-8u2,9-5l1,7-4d1,8-6l2,5-7u2,6-4l2,3-3d7,2-11r4,20-3l4,15-2d7,16-10l6,9-11u3,10-7l1,8-8u2,9-5l1,7-4d1,8-6l2,5-7u2,6-4l2,3-3d7,2-11r3,22-3l6,15-2d7,16-10l6,9-11u3,10-7l1,8-8u2,9-5l1,7-4d1,8-6l2,5-7u2,6-4l2,3-3d7,2-11r2,24-3l8,15-2d7,16-10l6,9-11u3,10-7l1,8-8u2,9-5l1,7-4d1,8-6l2,5-7u2,6-4l2,3-3d7,2-11r1,18-5u1,19-3l3,15-2d7,16-10l6,9-11u3,10-7l1,8-8u2,9-5l1,7-4d1,8-6l2,5-7u2,6-4l2,3-3d8,2-12r4,18-4l2,15-3d6,16-10l6,9-11u3,10-7l1,8-8u2,9-5l1,7-4d1,8-6l2,5-7u2,6-4l2,3-3d8,2-12r3,18-6l2,15-5d4,16-10l6,9-11u3,10-7l1,8-8u2,9-5l1,7-4d1,8-6l2,5-7u2,6-4l2,3-3d8,2-12r2,16-4d1,18-5l2,15-4d5,16-10l6,9-11u3,10-7l1,8-8u2,9-5l1,7-4d1,8-6l2,5-7u2,6-4l2,3-3d8,2-12r1,21-4l5,15-3d6,16-10l6,9-11u3,10-7l1,8-8u2,9-5l1,7-4d1,8-6l2,5-7u2,6-4l2,3-3d9,2-13r4,23-4l7,15-3d6,16-10l6,9-11u3,10-7l1,8-8u2,9-5l1,7-4d1,8-6l2,5-7u2,6-4l2,3-3d9,2-13r3,25-4l9,15-3d6,16-10l6,9-11u3,10-7l1,8-8u2,9-5l1,7-4d1,8-6l2,5-7u2,6-4l2,3-3d9,2-13r2,22-5l6,15-4d5,16-10l6,9-11u3,10-7l1,8-8u2,9-5l1,7-4d1,8-6l2,5-7u2,6-4l2,3-3d9,2-13r1,24-5l8,15-4d5,16-10l6,9-11u3,10-7l1,8-8u2,9-5l1,7-4d1,8-6l2,5-7u2,6-4l2,3-3d10,4-14l1,2-15u5,26-5l10,15-4d5,16-10l6,9-11u3,10-7l1,8-8u2,9-5l1,7-4d1,8-6l2,5-7u2,6-4l2,3-3d10,4-14l1,2-15u4,17-6l1,15-5d4,16-10l6,9-11u3,10-7l1,8-8u2,9-5l1,7-4d1,8-6l2,5-7u2,6-4l2,3-3d10,4-14l1,2-15u3,21-6l5,15-5d4,16-10l6,9-11u3,10-7l1,8-8u2,9-5l1,7-4d1,8-6l2,5-7u2,6-4l2,3-3d10,4-14l1,2-15u2,23-6l7,15-5d4,16-10l6,9-11u3,10-7l1,8-8u2,9-5l1,7-4d1,8-6l2,5-7u2,6-4l2,3-3d11,2-15r4,25-6l9,15-5d4,16-10l6,9-11u3,10-7l1,8-8u2,9-5l1,7-4d1,8-6l2,5-7u2,6-4l2,3-3d11,2-15r3,18-7l2,15-6d3,16-10l6,9-11u3,10-7l1,8-8u2,9-5l1,7-4d1,8-6l2,5-7u2,6-4l2,3-3d11,2-15r2,20-7l4,15-6d3,16-10l6,9-11u3,10-7l1,8-8u2,9-5l1,7-4d1,8-6l2,5-7u2,6-4l2,3-3d11,2-15r1,22-7l6,15-6d3,16-10l6,9-11u3,10-7l1,8-8u2,9-5l1,7-4d1,8-6l2,5-7u2,6-4l2,3-3d10,4-14l1,2-13d1,24-7l8,15-6d3,16-10l6,9-11u3,10-7l1,8-8u2,9-5l1,7-4d1,8-6l2,5-7u2,6-4l2,3-3d10,2-14r4,19-8l3,15-7d2,16-10l6,9-11u3,10-7l1,8-8u2,9-5l1,7-4d1,8-6l2,5-7u2,6-4l2,3-3d10,2-14r3,21-8l5,15-7d2,16-10l6,9-11u3,10-7l1,8-8u2,9-5l1,7-4d1,8-6l2,5-7u2,6-4l2,3-3d10,2-14r2,23-8l7,15-7d2,16-10l6,9-11u3,10-7l1,8-8u2,9-5l1,7-4d1,8-6l2,5-7u2,6-4l2,3-3d10,2-14r1

