;1
    ###
    #.#
    # #
    # #
#####$#####
#.  $@$  .#
#####$#####
    # #
    # #
    #.#
    ###
Solution: l3r6l3u3d6

;2
####################
#@$.#.$           .#
## ###$######## # ##
 # #.$ # .... #   ##
 # #   # $$$$ ###$##
 # # #.#       .# ##
 # # ###      $## ##
 # # ##       $.# ##
 # # #. #     $## ##
 # # #$ #      .#  #
 # # # #  ######## #
 # # # .# #    #.$ #
 # # # $#   #  #.$ #
 # # #  ##$# $##.$ #
 # # $ .#.    .#.$ #
 # ############### #
 #$  $ $        .. #
 #.#               #
 ###################
Solution: r1d15r2d1r2u1r10l1d1l11u1r11d1r3u3l1r1u1l1r1u1l1r1u1l1r1u2l1u7d1l2u2r2l11d3u1l1d1l1d10r2u1r1u1l1u3r1u2r2u3d1r1u1d1r1u1d1r1u1d3r2u1l1u1r1d3l1d1r1l5d3r1d1u1r1u1r2d2l1d1r1l3

;3
####################
#     .###  ####*.##
#     $#.$$ .### $##
#.##  .##.$ .###  ##
#     $ #    ###  ##
##$                #
#       #    #     #
# #######$######## #
# ..$   $@     $.# #
# ###   #$######## #
# ####### #        #
#     #   # $.#  $ #
# $ $ # # ## #     #
#  $  #   .#     ###
# $ $ ######    ####
#     .....#. ######
####################
Solution: r6l6d4u1l2d2r2,9-8l2,5-8l2,8-8l4,9-8u2,9-3r2,10-1d1l1,9-3r1,11-4u1,10-2r1,9-6u2,17-3u1,11-11r1,18-11l2,15-10d2,16-13l1,14-12d1,15-14l2,12-13d1,6-3u1,6-5u1,2-6u1,1-4r2,4-5u2,5-2l3,1-1d1,4-13d1r1,3-15r6,2-13d1,1-15r7,4-11d3,3-15r4,3-12d2,2-15r4,2-11d3l1d1r4

;4
####################
## ##############  #
##@$.              #
##$# #$###########.#
## # # #############
## # # #         ..#
## # # # #### ######
## # # #       $   #
## # # ###### #### #
## # # #  $        #
## # # # #### ######
## # # #           #
## #$# ##########  #
## #   .#.....  #  #
## # #  #$$$$$#   $#
#  # ## #.....  #  #
#    .# #$$$$$# #  #
#######         $..#
      ##############
Solution: d13l1d1r3,2-2r15,18-1d1,4-13u7,6-2d10,4-13r2l2u10,9-15u1,10-15u1,11-15u1,12-15u1,13-15u1,9-17u1,10-17u1,11-17u1,12-17u1,13-17u1d1r3,18-12d4,16-7l2,13-8u2,11-5r6,9-9r3,13-10u4,12-5r4

;5
####################
# ...           ...#
# $  # $ $ $       #
#  $ #             #
#   $# #############
#    # #   # #   # #
# #### # # # $ $ $ #
#    # # # # . . . #
#### #   # # # . . #
#### ##### # # # . #
#.      .# # # # # #
#   $    # #   # # #
# ## ##  # #     # #
# ## ##  # #       #
#$  $  $ # #       #
# ## ##  # # $ $ $ #
# ## ##  # ## # ####
#.  @   .#         #
####################
Solution: 1-16u5r3d5u2r3u1r1d3l1d1l5r2u6r3d1r1u1,4-5u3l1u1r3l3d1r1d2l1u2d1l1u1d1r2u2r2d2r3u1l1u1r9l12r1d2r1u1l1u1r10d1l2d1l3u1l1u1r5l6d1l3d6r2u3r2d12r3u2d2r2u3l1u7l2u1r1d1r3u2l1d2u1r1d1r2u1l1d1l2u2r1d1l1d1r1u1r1d2u1l1u1l1d1l2u1r1d8r2u1l1d1l1u6d5r2u6l2d5l2d2r3d1r1u7d4l2u5r2u1r1d1r1d8l2u1l3d3r2u4l1u1r1d1r1u5d4l2u5r2u2l1d1

;6
###################
###################
######  ####  #####
####            ###
#### .        . ###
####.#$######$#.###
#### $   .    $ ###
#### #   $  $ # ###
#### # .$@$.. # ###
#### #   $    # ###
#### $   .    $ ###
####.#$######$#.###
#### .        . ###
####            ###
######  ####  #####
###################
###################
Solution: l1d2l2d2l2u4d4r2u8d2r7u2d8u2l2u4r1d1l3d1r1l1d1l3u2r2d1r1u1l3u1l1r1d6l2u6r2d4l1r1u4l2d4r2d2r1d2l1u1r1u1l1r6d2r1u1l1u1r1u2r1l1u6r2d6u6l2d2r1l1d4r2u4l2u2l1u2r1d1l1d1r1l6u2l1d1r1d1l1

;7
###################
#                 #
#  ######.  ####  #
#  #.    #    .#  #
#  #           #  #
#  #  ### ###  #  #
#  #  #  $  #  #  #
#     # $ $ #     #
#  .#  $ @ $  #.  #
#  ## # $ $ # ##  #
#  #  #  $  #  #  #
#  #  ### ###  #  #
#  #           #  #
#  #.    #    .#  #
#  ####  .######  #
#                 #
###################
Solution: l1d1r1d1u1r1u2d1r1,8-8u1,7-10r1,7-7d1,11-8r1,13-9u4,12-4r1,14-3d3,13-7r2,16-6d1,17-8l1,9-7u2,10-4l5,4-3d3,5-7l2,2-6d1,1-8r1,7-10u1,8-8l2,5-7d5,4-13r3,8-12d1,7-14r1,11-6l1,9-7u2,8-4r4,13-5u1,14-3l3,10-4u1,11-2l1,7-6r1,9-7u2,8-4r5,14-5u1,11-10u1,10-8r2,13-7d5,12-13r1,10-10l1,9-12u7,11-4l6,4-5u1,7-10r1,9-9d2,10-12l5,4-11d1

;8
###################
###################
##### ###### ######
#### #      # #####
### #  $   $ # ####
####  $ ### $ # ###
#### $  ...  $ ####
####    ... #  ####
####  # ...    ####
#### $  .+.  $ ####
### # $ ### $  ####
#### # $   $  # ###
##### #      # ####
###### ###### #####
###################
###################
###################
Solution: r1u2r1d1r3u2l5d1l5u2r1d1u2r1d1u2r1d1u1r4d1r1l1d1u1l6d2l1d1r5d1r4u2l3r1u2r1d1r1d1l2r1u2l6d2l1d1r3l2u3r1d2l1d1r1l3d1r1l1d1r5u1r5d2l1u1r1u1l5r3d1r1d2l1d1l1u3r1u1l2r2d1r1d2l1u2r1u1l2d3l2d1l2u1l1u1l1u1r3l2d2r1u1l1u1r1

;9
###################
###################
###################
###################
########      #####
######## #### #####
#######. .#.# #####
########$$$   #####
#####  .$@$.#######
##### ##$$$   #####
##### #. . .# #####
#####    # ## #####
##########    #####
###################
###################
###################
###################
Solution: r1d1r1u2r1l1d1l2r1l2r2d2l1r1u2l2d1u1r2d2l2r3u1r2d3l3u1d1r3u3l2u1l3d2r2u2l1d1l1d2l3u3r3u2d3r2l2r1l1u1r1l1u2r1d1l1d2r4l1u2r2u3l5d1,9-6l1d3r3u2d2l2u2d1r1l1u1l1u3r5d3l4,8-6d1r1d1l1

;10
###################
###################
###################
###################
###            ####
###  ########  ####
###  #.    .#  ####
### .# $ *  #. ####
##@  *  * $ $  ####
###  # * $  #  ####
###  #  * $ #  ####
###  # $ *  #  ####
###  #  $ * #  ####
###  # $ *  #  ####
### .#.    .#. ####
###  ########  ####
###################
Solution: r2u3d3r2u2r2d1u1r2d2r2,13-7d6,8-13r2,11-14u5,10-8r2,13-7d4,8-7r2u1r1d1l1d1r2,13-7d2,8-13l1u1l1d1,8-7l1,6-8u1,10-11d2l1d1r1,7-10d1r1d1,7-13r1u2l2d1r3,11-10d1l2u1r1d1r1u2,10-8r2,13-9u1l2d2l1u3l1u1r1d4l1u2d1l1u1l3,4-7d6,8-6d1,9-8l4,4-9u1,7-10u1,8-8l2,9-11l1d1l1u2,8-9d1l1d1r1,7-8d1l1d1r1,13-11u2r1u1l3,10-7d1r1d1l3,13-13u4r1u1l5

;11
####################
#.#        #  #    #
# ##  #    #       #
# #     # ## # #   #
# #  #   # #     # #
# #    #   # ### # #
# #  #   # # #   # #
# # #      # # # ###
# #    #   # #     #
# #  #   #     #   #
# # #      # # ##  #
# #   ## # # #     #
# #    #     # #   #
# # # #    # ### # #
# #      #     #   #
# #  ##### #  ## $ #
#    #     #  ##   #
#    # # # ##### @ #
####################
Solution: u2r1u1l1d2l1u4,15-11r1,17-12u3,18-8l1,16-9u6,17-2l4,12-1d7,12-8d4,12-14u5,12-7d1,13-9l2,10-8d3,11-12l2,8-13u5r1u1l2r1d2l2u5r1u1l2u1l1d2u1r2d2l2u1l1d11r1d1l2d1l1u15

;12
####################
## $     .##########
## ## ##############
## #.     #        #
## #  #   #    # # #
## #  #   #   $#.# #
##.$  #   #    # # #
## #  #        # # #
## #  # ###### # # #
#  #  #          # #
#  #  # $@$  # # # #
##.$  #      #   # #
## #  #      ## $# #
#  #  ###### #   # #
#.* $ #   #     #  #
## #.        # .$  #
##  ##### ## ### .##
###       ##########
####################
Solution: 15-15r1,17-14d1,4-15u1,3-14l1,2-1r6,9-10l1,7-11u7,8-3l2,5-2d4,4-6l1,4-11l1,4-12d1r1d1l2,5-6d8,6-15l1,11-10l1,8-10r3u1r1d4,11-14r3,15-13d1,16-13u7,14-4d4,15-9l7,7-10u6,8-3l3

;13
###################
######### .########
#########$ ########
#######     #######
####### $#. #######
####### . $ #######
####### $#. #######
####### . $ #######
##### $ $@. $ #####
#####.  . $  .#####
####### $#. #######
####### . $ #######
####### $#. #######
####### . $ #######
###################
###################
###################
###################
Solution: r2u5l4d6r2u1r2u2l1u1d1r1d3r2u1l2u3l4d4r5l5u2r1d1l1d1l2u1r2u1r2d2l3r1d2u1d3r1l1u4r3d2l2r3u4l1d2l3u2r2d2l3u1r1u3r3d2u1r1u3l1d2u4l1d1r1d3l3u2r2l2d2r3u3d3l2u1l1u1r2u1r1d1l2d1u1r1l2d4r1u1d1l1d2r1u1l1d3r1u1d1l1d2r1l1r1u1,11-13l2

;14
###################
##       .       ##
## #### $ $ #### ##
##$#### ### ####$##
## #### ### #### ##
## ###       ### ##
#      . # .      #
#  ###  $ $  ###  #
#  ### # @ # ###  #
#       $ $       #
## ### . # . ### ##
## ###       ### ##
## #### # # #### ##
##$#### # # ####$##
## ####     #### ##
##     .....     ##
###################
Solution: u1l1d2r2u2l1d1l1d1r1l2d6l5u6l1r1d6r14u6l5r1u2l2d3u1l3d2r3u1r1d4,12-15l2,8-9d1,9-11l1,7-10d4,6-15r1,6-7r1u1r1d4,7-11r3,11-10d4,12-15l1,2-7d1,1-9r6,8-8d2,9-11l1,16-7d1,17-9l6,10-8d2,9-11r1,16-2d4,2-2d5,7-10d4,11-10d4,2-7d1,1-9r6,8-8d2,9-11l1,7-12u1,10-5d5,9-11r1,11-12u1,16-8u1,17-6l5,9-2r1,11-3u1,12-1l2,9-2l1,7-1d4

;15
####################
####################
####################
#..# #   #   #    .#
#..$ # # #         #
# $# # # #### ## # #
## $ $  $## # ## #$#
#   .#   ##   #.   #
# ####  $@ $  #### #
#   .#   ##  ##.   #
#$# ## # ##$  $ $ ##
# # ## #### # # #$ #
#         # # # $..#
#.    #   #   # #..#
####################
####################
####################
Solution: l1d1l2d3l3u3l2d3u5r1u3d3r2u3l2d1l1u1r1d3r2u1l1d1l1u2d1r2u2l2,6-6l1,4-5d1,8-8l1,6-9u2,7-6l4,2-7u2,10-8r1,13-8l6,6-7d4,5-12r2,9-12l5,3-13u3,2-9r1,18-7u3,15-12r2,17-10d2,18-11d1,15-10r1u1r1d2,16-12r1,13-10r2,17-10l1,15-11u1,11-11u2,12-8l3r3l4,6-8r5u1r1d2,11-10r5,17-9d2,8-5d2,7-8r4d1r1u1l1u1r1d1r1u3,14-4l2u1l2d1r5u1r1d3u2r2d3l2

;16
###################
#####   ####  #####
##### .  $   .   ##
#####  #.####  # ##
###### # .###.## ##
######$#  .##    ##
###### #$$$.#$ # ##
###### #  $ . #  ##
###### ##@$$$.  ###
###### ##   $ .####
###  # ## #.$$$####
##     ## ##.  ####
#   #$       . ####
#  .  ########.####
###################
###################
###################
Solution: 5-13u1r1u1l2u1l1d1,6-6u3,8-2r4u1r1d1,13-4u1,14-9d3,3-11d1,8-7u3,9-7u2,13-7u2,13-9d2,11-10r2,14-11u1,11-9u2,11-8r1d2,9-7r2l1u1d2l1d1r1u1r1d1

;17
####################
##.$   $         ..#
#.  $   #########  #
## ### #.######### #
#  #     ######### #
# ##$### ######### #
# ## ###     .#### #
#    #.#$# ## #### #
## #. $    ## $ ## #
##  ## ### #. $ ## #
#.#        ##.$  $.#
# ####$$ #   .## # #
#$##     # ##    # #
#.   . .## ####### #
# # # # ## ##### $ #
# $    .## ##### # #
#$#$# ####         #
#@$  .$.############
####################
Solution: u2r5l1d2r1l1u4l4u2d2r2d2l2d1u1r2l2d2u2r4d2l2u2l2d2r3l1u2r2u2l4d2r2u1d1l2u2r3l2r1d4l2u3d1r2u2r1u1r4u2l1d2u2l1u2r4d3r3d1r3u2l1u1l2r2d1l1u1d1r3,18-11u9l1r1d9u1l4u1l1d1r2u2l1,13-7d2r2d1u2l2u2l3d2l2u4l4d3l2d2r1d1r4l4u1l1u2l1u3r1u2r2u1l1r3d1l4,6-12u1,5-10r4,10-11u4,9-6r3,16-14r1,18-15u4,6-1r10

;18
####################
#.#..   $   $      #
#.# #     ### #### #
# ###  #         # #
# #.#  ## ### ##$#$#
# # #   #  #   # # #
#      #    #      #
#$# #  .#  # # # # #
# # # #$# ## . # # #
# #$# #  @.#   # # #
# # ##  ####   ###$#
# # # # .  #   #.# #
#   $   $  .#$     #
# # #    #     # # #
#$# ## ###### ##$# #
# # .    $       # #
# #### ###### ####.#
#       $        ..#
####################
Solution: undefined

;19
###################
###################
###################
####### # #   #####
###### # # #  #####
##### #     $ .####
#### #  $ $  # ####
###  ..# $ # $ ####
##  ...  @#  # ####
###  .###$ # $ ####
## # #  $ $  #.####
### #.$   #   #####
#####.$$$$ $$$#####
##### ....#...#####
###################
###################
###################
Solution: u1l1d1l2u2r1u1r1d2r1d1l4r3u3r3d1r1d3u4d5u1r1l1u4r2d4u4l2d6r1d1u1l1d1u1l1d1u2r1u4l1u1l3d3r1d2l1d1l2r2d1u1l1d1l1r5l3u2d2r3u1r2d1l6u1l1d1r2u2r1u3r1u1r1u1l1d2l2u2r1l1d2r2u1l1u1l1d2r1d1l3u1l3d2r1u1l1u1r2d1r3u2r4d6l3u4l1u2r2d1l1u1l1d1r1d1l4u1l2d2r1u1l1u1r1d1r5d4r3u1l1u1l1r1d2l2u4l1u2r2d1l1u1l1d1r1d1l4r1,12-3d8r1d1l3r1u2l3d1l2u1r2d1u1d1r1u3l1u2r2d1l1u1l1d1r1d1l3r3u3r2d1r1u1r1u2l1d7l1d2r2u1l1d1l1u1r1u1l2r1d2l2u4l1u2r2d1l1u1l1d1r1d1l2r2d2l2d2r1u1r1d1u3d1r3u3r1l1d2r2u3

;20
###################
###################
###################
######.##.##.######
######$##$##$######
####.$.  .  .$.####
###### #   # ######
######  $$$  ######
####.$.#$@$#.$.####
######  $$$  ######
###### #   # ######
####.$.  .  .$.####
######$##$##$######
######.##.##.######
###################
###################
###################
Solution: undefined

;21
####################
# ##### .. ######..#
# #...#  $ #. $ # .#
#     .$ .      # $#
#$#  ##  $ #$   #  #
# #   ### ##    #  #
# #.#    $  $ $ #$ #
# #    ## ##    #  #
# #   #.  .##   #$ #
#.## ##  @ ### ##  #
#   $    .    $    #
# ## ###   ### ##  #
#      #$ $#    #  #
# # $  # $ #   .#  #
# #..$ #$ $#   $   #
# # $. #   #. $.#  #
# ######. .###### $#
#   $    .        .#
####################
Solution: undefined

;22
####################
#######  #.$.$.$.$ #
##.$. $  #.$.$.$.$ #
##    #   # .$.$.$ #
##.$.$#   ##.$.$.$ #
##$.$.  ####  .$.$ #
##  # # #### #.$.$ #
####### ##   ## .$ #
# .####         .$ #
#.$ #############  #
#$   ############# #
#.$.  #####        #
#$.$.  #### ########
#. .$.  #    $ ..###
#$.$.$.   # ###$..##
#.$.$.$. ##   # $.##
#$ $ $ $      # $$##
#.     $ @         #
####################
Solution: undefined

;23
###################
######          ###
#   $    $..### ###
# $ #####$..  # ###
#   $  $  ..    ###
##### #### ### ####
####  .$.......####
##   # #$$#$#  ####
## #$#  $ @  $ ####
##   # # # ##  ####
#### # #$# ###$####
#### #$#.# ### ####
#. $ # ## $ ## ####
#.   .  $     .####
###################
###################
###################
###################
Solution: undefined

;24
####################
########. ##########
# $              $ #
# .  #     #     . #
#  ##### ##### ##  #
#  ##### ##### ##  #
#  #####$##### ### #
#  ##### ##### ##  #
#  ##### ###   ##  #
#.   $    ## # ##  #
#  ######@  $     .#
#  #####  # ## ##  #
#  ##### $  ## ##  #
#  ###### #    ### #
#  ###### #### ##  #
# .   #     #    . #
# $              $ #
#########. #########
####################
Solution: undefined

;25
####################
#..      $      $..#
## ####### ###### ##
# $ #   #   #   #  #
# $       $        #
#  .#   #   #   #  #
## ############## $#
#    $.$.  $.$.  $.#
#   $. $. $. $. $. #
#  $.  $.$.  $.$.  #
## ############### #
# $ . . . . . .. . #
# $$$$$$$$$$$$$.  .#
#  . .$. . . . .   #
# ###############$##
#  .#  .#  .#  .#  #
# $$ .$$ .$$ .$$ . #
#@  #   #   #   #  #
####################
Solution: undefined

;26
####################
#.$               .#
#  ####### ##### #$#
# #.$           .# #
# # ############$# #
# # #.$       .# # #
# # # #.# # ##$# # #
# # # # #   ## # # #
# # # # ###### # # #
#     # #####  #   #
# # # #$      .# # #
# # #   ######## # #
# # # #.       $ # #
#   #$########## # #
# #  .         $.  #
# #$############## #
#$#.             $.#
#@#                #
####################
Solution: undefined

;27
###################
#                ##
#    $ $....$ $  ##
# #              ##
# #  ##########  ##
# #  .        .  ##
# # ###$###$#### ##
# #..   $ $    ..##
# ### ### #########
# $  .  $@$  .  $ #
# ####### ### ### #
# #               #
# # ######### ## ##
#           $.$. ##
#   $.$.$.$.$.$.###
# #$.$.$.$.$.$.$.##
#   ###############
###################
Solution: d2l6r1l1d2r2d1l1u1r3d1l1r1u1r2d1l1u1r3d1l1u1l6d1l1u3r14l4d3l1r1u1l1r1d1r1l1u1r1d2r1l1u1l2d1r1u5d1l10d2r7d2r1l1u2l2d2r1l1u2l2d2r1l1u2l2d2r1l1u2r8l2d1r2l1u1l3d1r2l1u1l3d1r2l1u1l3d1r2l2u1l3d2u1r2u1r1d1l3d2r2u1d1l2u2r3l3u13r5d1r2u1l4d1r3u1r6d1u1l12d1r3d3l1d2r4u1,8-5l4,3-6u3,2-2r3,11-7u1,12-5l8,3-6u3,2-2r2,9-7r6,7-7r7,11-9l1,9-10u2,10-7l6,7-9r1,9-10u2,10-7l5,1-9r3,17-9l3,5-1r8d1u1l8d1u1r2d2l2u1l1d2l1d1r10l9u4r2d1r1d1l2u1l1d2l1d1r1,13-2l2u1r4d1l3

;28
####################
#  $          ..# .#
#    # #######  # $#
#  @ #.        $#  #
## # # #  $ $...#. #
##$# # #$##### $# ##
## # # #.    $ .#$.#
## # #$# # $ ...# .#
## # # #$# ######$$#
#    # # #$#       #
# ## # # # #       #
# .# #   # # ####. #
#  # # $.# # ####$ #
#  # #     # ####  #
# $# ####### ####  #
#            ####  #
#.$ #            . #
#     $     .      #
####################
Solution: undefined

;29
###################
#...$..  .   ##   #
# # . $ . ## ##  $#
# $$#$.  $## ## $.#
#     #   ## ## # #
# $$$$$$ @      $.#
#     #   ##      #
# $ # .  $##$ # $.#
# #$.$$ . ## $# # #
#...$..  .##$.# $.#
# ###### ###. ###.#
# $       ##$.  # #
## # # #   #.$# # #
## #.# # # # .  # #
## # # # # # #### #
## $ $ $ $    ....#
####  #############
###################
Solution: undefined

;30
###################
###################
###################
########   ########
#######.. ..#######
#######$ $ $#######
#####   . .   #####
##### ## # ## #####
#####   $ $   #####
##### #$ . $# #####
#####  .$#$.  #####
########   ########
#########@#########
###################
###################
###################
###################
Solution: u1l1u1l3u4r2u1d1r4u1d1r2d2l2d1l1u4d1l2u2r1d1l1d1l3d2r3l2r1l2d2r3u5d4r2u1d1l2d2r2u3l1d1l1d1l3u2r2d1u1l2u2r3d2l1d1r1u4r2d1l1r4d2l3u1

;31
####################
#     #.##  ##    .#
#$      ## $##  ####
#     # ##  ###$####
#.    #     $     ##
## #### ## .#.  $ ##
##.####    #########
## #######$####  ###
# $ ###.$.  ### $###
#@ $ .    . ###  ###
##$######$#####  ###
## #   ## .#### .###
##.# # ##  ####$####
#. #       $      ##
#$ ### ## $##.  $  #
#  #.  ##  #### ####
#  #$#  ###   $  .##
#  #.   ###   #.####
####################
Solution: undefined

;32
###################
###################
####           ####
####           ####
####  .......  ####
####  $$$$$$$  ####
####  $.....$  ####
####  $.$$$.$  ####
#### .$.$@$.$. ####
####  $.$$$.$  ####
####  $.....$  ####
####  $$$$$$$  ####
####  .......  ####
####           ####
####           ####
###################
###################
Solution: undefined

;33
###########
#.   . . .#
#    #    #
# $ $#$ $ #
#    #    #
#.###@###.#
#   $ $   #
# $  #  $ #
#  $ # $  #
#. . .   .#
###########
Solution: d1r2l1d3u3l3r1d3l3u5r3u2l1u1r4d3l1u2r1u1l1d1r3u1l1d1l1d1r1d1r1u2d1l1r1d5l1d1l7u5r2u1l1d1l1u2d7r3u3l2r1d2l2u2r2d1l1u1l1d2u1r3d1u2r4l1d2r1d1l2r3u3l1d2l1d1r1

;34
###################
#.      .#.#.  #..#
#  #$#$# # #.$.#  #
#.$ .$  .#        #
#  # # # #$#$#$#$ #
#   $  #     #    #
#### ########### $#
####              #
#########@####### #
#.        # $.#.$ #
# ###$$$$   # # # #
#         #.$ $ $.#
#..###$$$ ### # # #
#         #.$ . $.#
#. .###$$   # # # #
#         # $. .$ #
#....###  #########
###################
Solution: d5l1d1r1d1l5d1l2u2r1d1l1d1r1u1r5u2l1d1r1d1l4r3u2l5d3r1u1l1u2r7u2l1d1r1d1l6,2-12l1r1d3l1d1r1,7-11d1r1d1l6u1l1d3,6-11d1r1d1l4,2-12l1r1d3,6-9d3r1d1l4r4d2l5u2r4u4l2r1d1r1d1l4r3u2l4d4u4r6d1u1r2d2l7r3u2l4d2r7u1r1u1l7,17-9d6l2u2l2u2l1r1d3u1l1r3u4d6r2u8l1u4d4r1u2d10l2u6r1l1d6r2u8d8l2u2r1l1d2,16-3u1d3r1u3d1l1d4r1u3d5l2d6r2u9d4u1l2d4l2u2r1l1d2r4u4l2r2d4l4d2r1l1u2r4u4l2d3u3r2d4l2r2u2l1r1d2l2u3,11-9r1,11-15r1,17-4d8,17-2d8,4-6u1l3u3r1d1u2r6d4r2u3d3r2u3d1r2u1l1r1d1r2d2l2u2l4d2l2u2l2u1d3l5u4r6l6d2r6l6d2r1u1d1r4u2l4r2u1d1r2u2l4r1l1d4r2u1

;35
####################
#                $.#
# # ################
# #  .             #
# # # ##############
# # #. .         $ #
# # # # ########## #
# # # #. .       $ #
# # # # # ######## #
# # # # #.       $ #
# # # # # # ###### #
# # # # # # $     .#
# #$#$#$#$# ###### #
# #.#              #
# ######### ########
#.   . $    $  $  ##
### # #####       ##
#@  # $  .#.########
####################
Solution: r2u2l2u14r16,5-17r3,14-15r1d1l4u1r2l2,6-15r5,3-11d1,13-15l2,9-15r1,11-14d2,5-13u9,18-5l12,7-13u7,18-7l10,9-13u5,18-9l8,11-11r6,15-15l13,17-15l11

;36
###################
###################
#######     #######
#####  $### #######
#####$  ### #######
#####     $ #######
###  $ $ ## #######
### # ## ## #######
#   # ## ## ##.$..#
# $  $    $ .*....#
##### ### #@## $..#
#####     # ## ####
###########    ####
###################
###################
###################
###################
Solution: d2r3u2r2l2u2r2l2d4l3u3r4u1r1d1l5u7l4d1l1d2r2d4r6d1r1u1l1u1r1l1d1l6u4r2l4u2r1u1r4d6u3l3d4r5l2d3r3u3l6u4l2d1r1u1r1,8-7u1,7-5r3,11-4d4,10-9r6,7-3d1l1d1r4,11-4d4,10-9r5,5-5d1,4-9r10,1-9r12,5-6d2,4-9r8,5-3d5,4-9r7

;37
###################
############ @#####
#                 #
# $   .#     $ # .#
# $   .#     $   .#
# $   #.     $ # .#
# $   #.     $ # .#
#    #  ###### #  #
#    #  #      #  #
#   #   #      #  #
#   #   #      #  #
# $#   .#      #  #
#  #$  .#   ## #  #
# #  $ .  ##   #  #
# #$   .##   $ # .#
#     ##     $   .#
#   ## $   # $ # .#
#.##       # $   .#
###################
Solution: 3-13d1,3-16u1,4-13r2,7-12d1,3-13d1,4-11d1,3-13r3,4-15l1,14-6l6,7-5d6,14-5l3u1l1d1r1d1l3,7-5d5,14-3l1d2r1d1l6,12-2d2,13-5l5,1-4r4l3u1l1u1r11u1r1d2l1d1r4u1r1d4u3d5u5l6u2l10d4r1u3l1u1r11u1r1d2l1d1r4u1r1d4l1d2r1d2l1u4r1d2u5l9u2l7d10r1u9l1u1r11u1r1d2l1d1r4d1r1u1d3l1d4r1u5l1d7r1u6,3-7u3l1u1r3u1r2l6d14r2u1l1d1l1u4r1u2l1d6,12-15r4u1d2r1u4d2l1d1l4u1r1d1r1u10l1u1r3d11l4d2r4l3u1l1u1r4u1r1d1u2l1u4r1d4l1d2l8d2l2u1r3d1r1u1l1u1r7

