;1
 #####
## . #
#  . ##
#  *$ #
# $.$@#
# $. ##
######
Solution: l1u1l1,1-5r1,1-3r1,2-5u1r1u1,5-4l1,4-5l1u1,4-1d2,5-4l1,1-5r1,2-2d1,4-3l1u1,1-3r1,2-5u2,1-2r1

;2
 #####
 # .@#
 #$.$#
 # * #
 # * #
 # * #
## * #
#  * ##
#  *  #
# $.  #
# $. ##
######
Solution: undefined

;3
 ######
 # +  #
##$*$ #
# $.$##
#  .  #
#  .  #
#######
Solution: d3r1d1l1u4r2d1l1d1l1d1l2u1r1d1r1d1r2u1l1u3l2d2l1d2r2l2u2r2l2d2r2u1d1l2u2r1u1r1l1d1l1d2r2u2l2r2d1r2d1l2u2l2d2r1l1u2r1u2r1l1d2r1d1r1d1l1u2l1u2r1d1u1r2d1l1d1u2l2d2r1d2r2u1l1u1l3d2r2l2u2r3d1r1d1l1u3r1u1l1d2l3d2r1u1l1u1r1

;4
 #####
 # . #
 # . #
 # . #
## *$##
# $.$@#
#  *$ #
# $.  #
#######
Solution: l1u2d2u2l2d2l1d2r2l2r1u4r2d2l1r1u2l2d2u2r1u2r1d2l2d2r1u2d1l1d1l1d2r2u2l2d1r1u3r2u2l2d4u2r1u1l1d3r1u2d1l1d1l1d2r2u2r2d1l1u1l2u2r2d2l1u1l1d1l1d2r2u2r2d1l1u1l3d2r1l1u1d1u2r4d2l1u2l3d2r1u1l1u1r1

;5
#######
#  .$@#
#  *$ #
## * ##
#  * #
#  . #
#  * #
######
Solution: undefined

;6
#######
#  .  #
#  *  #
#  .$ #
##$. ##
#  * #
# $*$#
## .@#
 #####
Solution: undefined

;7
 #####
 # . #
##@.$#
# $* ##
#  *  #
# $.  #
####  #
   ####
Solution: undefined

;8
#######
#  .  #
# $*  #
# $. ##
## * #
# $. #
#@$.$#
## . #
 #####
Solution: undefined

;9
######
#  + #
# $*$##
## .$ #
##$.  #
# $.$##
#  . #
#  . #
######
Solution: undefined

;10
 #####
 # . ##
 #$.  #
 # .  #
##$.$ #
#@$.$##
# $. #
# $. #
######
Solution: undefined

;11
#######
#  .$ #
#  .$@#
## *$##
#  * #
#  . #
# $.$#
## . #
 #####
Solution: undefined

;12
 #####
 # . #
 #@*$##
##$.  #
# $*  #
#  . ##
#  * #
#  * #
######
Solution: undefined

;13
 ######
 # .$ #
##$+$ #
#  *  #
#  * ##
# $. #
## .$#
 # . #
 #####
Solution: undefined

;14
  #####
  # . #
### . #
# $$.$##
#@$ .  #
### *  #
  ###  #
    ####
Solution: undefined

;15
#######
#  .  #
#  .$ #
## . ##
##$* #
#  * #
#  *$#
#  *@#
######
Solution: undefined

;16
######
#  . ##
#  .$ #
# $.  #
## .$ #
 # * ##
 #$*$#
 # + #
 #####
Solution: undefined

;17
  #####
  # . #
### .$##
#  $*  #
#@$ .$ #
### . ##
  ##  #
   ####
Solution: undefined

;18
 ######
 # .  #
 #$+  #
 # *$##
## * #
#  * #
#  * #
# $. #
# $. #
######
Solution: undefined

;19
######
#  * #
#  * ##
## .  #
#  .$ #
# $. ##
# $* #
## *$#
 # .@#
 #####
Solution: undefined

;20
######
#  . #
#  * ##
##$.  #
 # .$ #
## * ##
# $* #
#@$. #
# $. #
######
Solution: undefined

;21
  #####
  # . #
  # +$#
  #$* #
### .$#
#  $. ##
#  $.$ #
##  .  #
 #######
Solution: undefined

;22
#######
#  .$@#
#  *$ #
## * ##
#  * #
#  . #
# $.$#
## * #
 # . #
 #####
Solution: undefined

;23
 #####
 #@. #
 #$* #
 # * #
## .$#
#  . #
#  * ##
## *$ #
 #    #
 ######
Solution: undefined

;24
#######
#  *  #
#  .  #
# $. ##
# $.$#
## . #
 # * #
 #$*$#
 # + #
 #####
Solution: undefined

;25
#######
# $.  #
#  *  #
#  * ##
## . #
# $* #
#  * #
##$.$#
 # .@#
 #####
Solution: undefined

;26
######
#  * #
# $. ##
#@$.$ #
##$.  #
#  .$##
#  * #
## * #
 # . #
 #####
Solution: undefined

;27
 #####
## . #
#@$.$##
# $*  #
## *  #
#  . ##
# $. #
# $.$#
## . #
 #####
Solution: undefined

;28
######
# $. ##
# $*  #
#  .  #
#  * ##
## * #
 #$+$#
 # . #
 #####
Solution: undefined

;29
 #####
## *@#
# $.$##
# $*  #
#  .  #
#  *$##
## . #
 # .$#
 # . #
 #####
Solution: undefined

;30
 #####
## .@#
# $*$##
#  *  #
##$.  #
## .$##
#  * #
# $. #
#  . #
######
Solution: undefined

;31
  #####
  # + #
  #$*$#
  # * #
### . ##
#  $.$ #
#   *  #
### .  #
  ######
Solution: undefined

;32
####
#  #
#  #
#  #
#  #
# $#
# @#
#.$###
#.$  #
#.$. #
#  ###
####
Solution: undefined

;33
  #####
  # .@#
  #$.$#
  # * #
 ## * ##
##  *  #
# $$.  #
#   . ##
#######
Solution: undefined

;34
 #####
 # .@#
 #$*$#
 # * #
 # . #
##$. #
# $.$##
#  .$ #
#  .  #
##  ###
 ####
Solution: undefined

;35
  #####
  # . #
  # . #
  # * #
### * #
# $$.$#
#@$ . ##
### *  #
  ##   #
   #####
Solution: undefined

;36
  #####
  # .@#
  #$.$#
  # * #
### * #
#  $. ##
#  $.  #
### .$ #
  #  ###
  ####
Solution: undefined

;37
######
#  . ##
#  .$ #
# $.  #
# $. ##
## * #
## *$#
# $. #
#@$. #
######
Solution: undefined

