;1
     ########
     #      #
######$ $ $$#
#  #@#    $ ######
# $#  $ $ #   $  #
#  # # ## $ #### ####
# $$ #$## # ###.....#
#     $   $    .....#
#  ### ## #####.....#
#  $ # $ $#    .....#
# $# #### # # #$#####
#               #
#################
Solution: undefined

;2
##############
#       #    #
# $ $   $ $  #
###### ##### #
#... #   $ # #
#... # $  $  #
#..  #$#### ##
#...     ## ##
#... # #  $  #
###### ##$ $ #
  # @$ $ $   #
  #    #     #
  ############
Solution: undefined

;3
    #####
#####   #######
#             #
# @##$##$ $ $ #
#  ##  # $#$  #
#####  #$   $ #
    #$ #   $  #
##### #### #$ #
#..... ## $ $ #
##....  $   $ #
#......########
########
Solution: u1r11d7u3l1u1l2d3l1d1l5d1l1u1r1u1l2r3d1r4u1r2d1l6u1l1d1r2d1l4r3u4r1u2l1d5r1d1l3,13-9l7d1l1u1r1u1l3,13-8l2r2u3l3d3r1d1l6d1l1u1r1u1l1,12-6d2r1d1l7u1l1d1r1d1l2,12-6l1u1l1d3r1d1l6d1l1u1,5-2d7,6-10l1,11-3d2,12-6l1,10-5d3,11-9l4,6-8d1,13-3l1d5,13-9l7,5-8d1,11-2d3,12-6l1,10-5d3,11-9l8,9-3r1u1r1d3r1d1l1u1l1d3,11-9l7,9-5r2u2l2d1l1u1r1u1l2r4d3l1d1l1u2l1u1r2u1r1d3r1d1l1u1l1d3r1d1l6,7-2l1u1l1d7,8-6u3r1u1l3,5-1d6

;4
############
#    #     #
# $$$#$$$$ #
#  $     $ #
# $$ #$ $$ ########
#  $ #     #..#...#
## ####### #..#...#
#  $ #     #..#...#
#    $ $  ##  ....#
# $ $#$$$     ....#
#    #    ## @#####
###############
Solution: l1u1l3u2l3d1l3r3u1r3d3l2r1u1d1l2u1r6d1r1u1l1u1r3d1r1u1r1u1l1d1l1u2d2l1d1l5u2l1d1r1d2l2u1r5d1r1u1l1u1r3d1r1u3d1,7-7d1r1d2l2u1r6d1r1u1l1u1r4d1r1u3,6-7d1l2r5u1r1u2l3u2l3r3d2r3d2l4d1l3d2r1u1l1u1r5u1r1d1l1d1r4d1r1u1l1u1r3d1r1u2l1u1r1,1-8r7u1r1d1l1d1r4d1r1u1l1u1r2d1r1u2,1-9r2d1r1u1l1u1r5u1r1d1l1d1r4d1r1u1l1u1r3d1r1u2,2-3d4l1d1r7u1r1d1l1d1r4d1r1u1r1u1l1d1l1u3,6-10u1r1u1l3d1l2u1r6u1r1d1l1d1r4d1r1u1r1u1l1d1l1u2,4-7l1d1l1u3l1u2r1d4l1d1r7u1r1d1l1d1r4d1r1u1r1u1l1d1l1u1,4-5l1,2-6u1l1u2r1d4l1d1r7u1r1d1l1r1l1d1r4d1r1u1l1u1r2d1r1u1,4-4l1d1l2u2r1d4l1d1r7u1r1d1l1d1r4d1r1u1l1u1r4d1r1u1,2-1d6l1d1r7u1r1d1l1d1r4d1r1u1l1u1r3d1r1u1,4-3l1d1l2u2r1d5l1d1r7u1r1d1l1d1r4d1r1u4,3-1d3r1d1l1u1l1d3l1d1r7u1r1d1l1d1r4d1r1u3,10-3l7d1l2u2r1d5l1d1r6u1r1d1l1d1r5d1r1u2,6-5u1r1u1l4u1l1d5l1d1r7u1r1d1l1d1r4d1r1u1l1u1r4,6-1d1,7-3l4u1l1d5l1d1r7u1r1d1l1d1r4d1r1u1l1u1r3,7-1d1u1r3d2l7u1l1d5l1d1r7u1r1d1l1d1r4d1r1u1l1u1r2,9-5u1r1u1l7u1l1d5l1d1r7u1r1d1l1d1r4d1r1u1l1u1r1,8-5u1r1u1l6u1l1d5l1d1r7u1r1d1l1d1r8,8-1d1u1r2d2l7u1l1d5l1d1r7u1r1d1l1d1r7,9-1d1r1d1l7u1l1d5l1d1r7u1r1d1l1d1r6,4-1d1l1d1r3d1r2u1l5u1l1d5l1d1r7u1r1d1l1d1r5

;5
#####
#   ##########
# #$##       ########
#      $    $     $ #
############   $    #
#..... ### $  $#@#$ #
#.....    $ $$ ###  #
#.....   #   $    $ #
####### ####$####$  #
     #  .# $ $      #
     # ..#   $  $#$##
     # ..#          #
     ################
Solution: undefined

;6
   ###############
  ##             #
### $####  $# $  #
#.#..    $$@###  #
#....# $# $$#  $ #
#.#.##  # $ # $  #
#..... $#$  #$####
#.#.##  #  $  $  #
#. ..#$$  $ #    #
#      ##   #    #
##################
Solution: undefined

;7
 ###################
 #@      ##   #    #
#######$$ #    $ $ #
#.#...#   # $ $# # #
#.#..#   $##$ $    #
#....     $   #  $ #
#....    $###$##$###
#.#..#    $    #   #
#.#...##  #$   #$$ #
########$ $  $ $   #
 #        #  # #   #
 ###################
Solution: r5d3r1d1l3d1l1u2l1u1r1,9-2l1u1l1d3r1d1l3d1l2u2r1d3l1d1r1,8-10u3l1u3r1d1r1u1l2d3r1u1l1u3r1d1r1d1l7d1l1u2d2r5d1r2d2u2r4d1r2u1l5d1l1u2l1u2r2d1l5u1l1d1r1d1l2u1l1d2u2r2d1r3u1r3d1l1d1r4d1r2u1l5d1l1u2r1u1l1u1l1d1r1d1l6u1l1d1u1r1d1r6d1r4d2l1u1r1u1l3d1l1u2r1u1l7d1l1u1d1r8d1r3d1l1d1l2d1l1u3r1u1l4u1l1d2u1r5d1r5d2l5d1l1u3r1u1l5u1l1d2,14-9r2d1r2u1l9d1l1u4r1u1l4d1l1u2,16-7d1u1r2d2l9d1l1u3r1u1l5u1l2d1r1u1r1d1,17-7d1r1d1l9d1l1u3r1u1l5u1l1d1,16-7u3r2d1l1u1l1d4r1d1l8d1l1u4r1u1l5d1l1u2,16-2d6r1d1l8d1l1u4r1u1l4d1l1u1,18-2l1u1l1d7r1d1l8d1l1u4r1u1l5d1l1u1,16-2l3d5r1d1l2d1l1u1r1u1l3d1l1u2r1u1l7,11-5l8r4u2r1u1r1d4u1r4d2l4d1l1u1r1u1l7,13-4r2,16-3d5,17-9l8,8-10u4,9-5l5,14-2d1,13-4r2,16-3d5,17-9l8,8-10u4,9-5l4,11-3r1,13-2d4,14-7l5,8-8u1,9-6l6,12-3d1,13-5l6u1l1d1r1d1l3,12-1d3r1d1l4u1l1d1r1d1l4

;8
 #############
##   #   #   #
#  $   $     #
# $# $#$  $$##
#       $ #@#
# $$#####$###
### #...#  #
# $ #......#
# # #  $#..#
# $ #  $...#
# $ ## #...#
# $    #####
#       #
#########
Solution: u1l1u1l2u1l2d1l2d1u1r1l1d2u2r2u1r2d2u1r2d1l1d6r1d1l1u3l4d2r3l2u2r3d2l2u2r2u5l1u1l2d1l2d2r4l4u2r2u1r2d1r1d4,8-7r1u1r1d3l4d3l5u1r4d1r1u4r1u1l1d1l1u1d2r1d3l4r4u5r3u3l6d6,2-11r3d1r1u5,12-2l1u1l1d1r1d1l1u1l1d6u1l3d2r3l3,1-10r1,3-9d1l1d1r2l3u2r1,3-8d2,1-7r1,3-6d3,8-2d1,7-4r1,9-3d3,8-7r1,10-6d1,6-2r1u1r1d2,7-4r1u1r1d3,8-7r1,4-11r1,6-12u2,5-9r2,7-2d1,6-4r2u1r1d5,5-2d1l1d1r4u1r1d4,2-2r5,8-1d2l1d1r1u1r1d3,2-11r3,6-12u4,5-7r2,3-9d1l1d1r3,6-12u3,7-8l1d1l1u1,1-5r1u1r1d6l1d1r3,6-12u3,5-8r1,7-9u1,2-2d2l1d1r1u1r1d6l1d1r3d1r1u4

;9
##########   ##########
#  #...  #####  ...#  #
#  #...  ##@##  ...#  #
#  #.#.         .#.#  #
# $#...  #   #  ...#$ #
#  #...  ## ##  ...#  #
# $######## ########$ #
#  $   $  # #  $   $  #
#    $    #$#    $    #
######## ## ## ########
#     $  #   #  $     #
# $  $   $   $   $  $ #
## ####### $ ####### ##
#   $ $  #   #  $ $   #
#    $ $ ## ## $ $    #
#        #####        #
##########   ##########
Solution: d8l1d2r1u8r1u1l5u1l1d1r1d1l2d1l1u1r2u1r4d1r1d7l3u1l2d1r4d1r1u8r1u1l5u1l1d1r1d1l2r1,6-10d1l2u1l2d2u1r8d1r1u8r1u1l5u1l1d1r1l1d1r1d1l2,2-12d1l1d2r1l1u2r1u2r12u1r2d1l4u1l2d2r1u8r1u1l5d1l1u1r1u1l2,16-10d1r2u1r2d2u1l8u1l2d2r1u8r1u1l5d1l1u2r1u1l2,12-13u1l1u1r3u1r2d1l4d1l1u8r1u1l5d1l1u2r1u1l1,6-10l2r4u2l2u1l2d1l3u3r1u2l1d5r1u3d3r2u1l1d1l1u1d1r1u1r3d1r2u1l4d1r3u1r1d3l1d1r3d1r1u8r1u1l5d1l1u1r1u1l1,2-5d2l1d1r6u1r1d3l1d1r3d1r1u8r1u1l5u1l1d1r1d1l1,4-7l1d1l2u2r1d1l1d1r6u1r1d3l1d1r3d1r1u8r1u1l5u1l1d2r1d1l1,2-10r5d1r1u3r1u1l6d1l2u2r1d1l1d1r6u1r1d3l1d1r3d1r1u8r1u1l5d1l1u2,2-15u4l1u1r6d1r1u3r1u1l6d1l2u2r1d1l1d1r6u1r1d3l1d1r3d1r1u8r1u1l5d1l1u1,6-14l3d1l1u4l1u1r6d1r1u3r1u1l6d1l2u2r1d1l1d1r6u1r1d3l1d1r3d1r1u8r1u1l4u1l1d2r1d1l1,5-13l2d1l1u3l1u1r6d1r1u3r1u1l6d1l2u3r1d2l1d1r6u1r1d3l1d1r3d1r1u8r1u1l4u1l1d1r1d1l1,8-14l5d1l1u4l1u1r6d1r1u3r1u1l6d1l2u2r1d1l1d1r6u1r1d3l1d1r3d1r1u8r1u1l5,7-13l4d1l1u3l1u1r6d1r1u3r1u1l6d1l2u2r1d1l1d1r6u1r1d3l1d1r3d1r1u8l1u1r5d1r1u1l1u1r2u1r1d1,2-3d4l1d1r6u1r1d3l1d1r3d1r1u8l1u1r5d1r1u1l1u1r2,2-1d6l1d1r6u1r1d3l1d1r3d1r1u8l1u1r4u1r1d1l1d1r3,20-5u2r1d4l1u2d3l2u1r1d1r1u1l4d1l2u1r4d1l3u1l1d3r1d1l3d1l1u8l1u1r5u1r1d2l1d1r2,20-5d2r1d1l6u1l1d3r1d1l3d1l1u8l1u1r4u1r1d1l1d1r2,18-7r1d1r2u3l1d2r1d1l6u1l1d3r1d1l3d1l1u8l1u1r4u1r1d2l1d1r2,18-10l3d1l1u3l1u1r6d1r2u2l1d1r1d1l6u1l1d3r1d1l3d1l1u8l1u1r4d1r1u1l1u1r2,20-3d4r1d1l6u1l1d3r1d1l3d1l1u8l1u1r4d1r1u2l1u1r3,20-1d6r1d1l6u1l1d3r1d1l3d1l1u8l1u1r4d1r1u2l1u1r2,20-12d1r1d2l1u4r1u1l6d1l1u3l1u1r6d1r2u2l1d1r1d1l6u1l1d3r1d1l3d1l1u8l1u1r4d1r1u2l1u1r1,16-14r3d1r1u4r1u1l6d1l1u3l1u1r6d1r2u2l1d1r1d1l6u1l1d3r1d1l3d1l1u8l1u1r5d1r1u1,17-13r2d1r1u3r1u1l6d1l1u3l1u1r6d1r2u2l1d1r1d1l6u1l1d3r1d1l3d1l1u8l1u1r4u1r1d2l1d1r1,14-14r5d1r1u4r1u1l6d1l1u3l1u1r6d1r2u2l1d1r1d1l6u1l1d3r1d1l3d1l1u8l1u1r4u1r1d1l1d1r1,15-13r4d1r1u3r1u1l6d1l1u3l1u1r6d1r2u3l1d2r1d1l6u1l1d3r1d1l3d1l1u8l1u1r5

;10
###################
#  #..............#
# $#############..#
#  #     ##### ...#
# $$   $$ # $  ...#
#   $$#    $    #.#
# $   # $$ $$ ###.#
### ###  $    # #.#
#     # $ $ $ # #.#
# $ ####### #####.#
###   #  $ $  #@#.#
#     # $$ $ $# #.#
#  #$ #  $      #.#
# $#  #  $$  $$ #.#
#  #  #       # #.#
#     ######### ###
#                 #
###################
Solution: undefined

;11
###################
#     #   #   #   #
# $ $ #$$ #$  $   #
#  ##      $  # $ #
# ##  $ $$## ##$  #
# #  #$##     # $ #
# # # $ $$ # ###  #
#@#  $  #  # $ ####
####     #  $$ #  #
 ### ## $         #
 #..  ##   ########
 #...  ## ##  ...#
 #.#..        ...#
 #.....#####  ...#
 #######   #######
Solution: undefined

;12
####################
#                  #
# #$#$#   $    $ $ #
# $ $ $   ## ####  #
#  $ $ $ ##....#   #
# $ $ $  #.....#   #
#  $ $  ##....###$##
# # $$$ #...#.# $  #
#  # # ##.....#    #
##   # #### #### ###
 ####       #@# $  #
    #       #      #
    ################
Solution: undefined

;13
#################
# ... .  #  . . #
#.###$#$ # $# #.#
#.# $ #@$## #$#.#
# $ # #$  #     #
#$      $ # #$#$#
#    ##$ ##$  $ #
# $ $#   #  # #.#
#.#  # $   $   .#
#.# $### ###$#$.#
# .. ... # . .  #
#################
Solution: undefined

;14
  ##########
###@##.....#
#    #.. ..#
# $####   ## #####
#  ###..#..###   #
# $  $......##$# #
#  ###......     #
##    ### ### #$ #
#  #$   #  $  #  #
#  $ #$$  # $##$ #
#  #   $$##$$ #  #
## ###    $ # #$ #
# $ ## #### $ #  #
#   $ $ $ $   $  #
##          ##   #
 #################
Solution: undefined

;15
   ########
   #   #  #
   #  $   #
 ### #$   ####
 #  $  ##$   #
 #  #   $ #$ ###
 #  #      $   ###
 ## ####$####$ $ #
 # $##.....##  # #
 #  ###...###$#  #
##$    .#.       #
#  $###...###$#  #
#   ##.....##  # #
# $#####  ###  $ #
##      $     #  #
# @#####  #####  #
####   ####   ####
Solution: undefined

;16
    ###################
#####@       ##    #  #
#   ##$  $ #   $    $ #
# $  #  ######  $ #   #
# $  #$##    ### ######
#  $$ $    $        #
###$ # $   #  $ #$  #
 #   ####  #  ##   ##
 #  $  ##.....##$  #
 #     #...#...#   #
 ##$#  $..###..  $##
  #    #...#...#  #
  # $$ #.......#  #
  #  ###### ####$ #
  #   $   $ $  $  #
  #####       #####
      #########
Solution: undefined

;17
   ##########
   #    #   #
   # #    $ #
   # $  # #######
 ###### # #     #
 # $        $   #
 # # #   ####  ##
 #   #   #  ## #
#### ##      # ##
#  $  #####  #  #
# # $  $  #  #$ #
#  $  $   #  #  #
##@# ## ###  ####
 ###    ##.....#
   #######.....#
         #######
Solution: undefined

;18
      ###########
      #  #  #   #
      #    $    #
     ## # $   $ ###
######...##### #  #
#  @#.#... #    $ #
# #$#..#.. $  #   #
#   $ ..#.## #  ###
#####  ## ## #   #
 ### $# # ##$ $  #
 # $  $ # $  # $##
 #               #
 #################
Solution: undefined

;19
#####################
#   #               #
# $ #  ####$###### ##
## $  $             #
## $   ### #$#$###$ #
#  #  $  # # #      #
#  #@#$#   # ##    ##
## ###   # # #... ##
#  $  #### # #.##.#
#    $    $#  ....#
####$   # $   .##.#
#       #  #  ....#
###################
Solution: undefined

;20
    ##########
#####        #########
#     # $ $  #  #    #
# #######$####$ #$ $ #
# #    ## #  # $    ##
# # $     #$    #$ $ #
# # $  #     #  #    #
# #  ### ## $##########
# ###  #  #  ##       ##
# #   $#  #### .....#. #
# #$   $  $ #  .#.#... #
#      # $ $   .###.#. #
#####$####  #  .#.#.#. #
# $  $  $ $$ # ....... #
#     #     @##       ##
#######################
Solution: undefined

;21
###################
#       #         #
#   $ $ #$ # $#   #
## #### #  #$   $ #
## #@## $     # $##
# $$$ $  $#   #   #
#  # ## $ #########
#  # ##  $ #  ##  #
####  $$$  ...... #
# $  ##  #.##.##..#
# $#   $ #.#*.###.#
#    #$  #.###.*#.#
##  ##  $#..##.##.#
# $ $ #$   ...... #
#        #  ##  # #
###################
Solution: undefined

;22
######
#    #     ########
#   $#######      #
#  $  $       $$  ##
##$   #$#     #    #
#  $ ## ### ### #  #
# #  $  #.# #.# $  #
# ##   #..# #..#   #
# #   #...   ...#  #
# #   #...# #...#  #
# #   #         #$ #
#  $ $#   ###   #  #
# $   #### @ #######
# $     $  $  $    #
## ####### # ##### #
 #         #       #
 ###################
Solution: undefined

;23
#####       ##########
#   #########   ##   #
# $      $      $    #
#  #### $#$ # ########
#@##  ## # $#$ #     #
##       $    $   $  #
##.#..### #  ### #$$##
#......#    $ #      #
##.##.###$## ###$## ##
#......#      #      #
##..#.### $#$###  #$##
##           $     $ #
#   ###   #  #   #   #
##### ################
Solution: undefined

;24
##################
#   #    ..#.#.. #####
#  $#$   ..#.#..   $ #
# $$    #.......#  # ###
## ##  ##.......##   $ #
#      $ ##...## $$ #$ #
# $$# #   ##.##  # ##  #
# $ #  #   ####  $     #
#       #$ ###      ##$#
#####$      #  # ## #  #
#   # ###   $ ## #  #  ##
#   $   # $ #  $    $   #
#   # $ #$$$ $#     #   #
#####   #  #  $     #####
    #   # @#  #  #  #
    #################
Solution: undefined

;25
#####  #####
#   ####   #####
#   #  #.......#
#   # $#...#...#
##$$#   .......#
#   ## #####   ####
#   #     ######  #
##$ # $   # $     #
#  $ #$$$$#       #
# #    #   $#$#$###
# # ## #$$$       #
# #    $     # #  #
# #   ##         ##
#     ##$###$##   #
#         @#      #
###################
Solution: undefined

;26
 ################
 #  #           #
##  # $#####@$$ #
#  $#  #......  #
# $ #$$..#.#.####
#  $#  #......#
##  # $###  ###
 #$      #  $ #
 #  #  $$     #
##$##### ##   #
#  $   $      #
#      ########
########
Solution: undefined

;27
########################
#  #   #......#    #   #
# $# $ #......    ## # #
#  #    ......#    #   #
#  # ###......#  ####$ #
#   $  ########  $  $  #
#   #@ #  ##  #$# $ ##$##
# $# #$#$   $    # $    #
#   #  #  #  # #$#  # $ #
#   $    $ $$     $  $  #
#      # $      ##$ #####
###############    ##
              ######
Solution: undefined

;28
       #####
      ##   ##
    ###  $  ###
   ##   $   $ ##
  ##  $ $$  $  ##
 ## $ #..#.##   ##
##   ##.....##$  ##
#  $  ...#...   $ #
# $$$$#.#*#.#$$$$@#
#   $ ...#... $   #
##   ##.....## $ ##
 ## $ ##.#..# $ ##
  ##   $ $ $   ##
   ##   $ $   ##
    ###  $  ###
      ##   ##
       #####
Solution: undefined

;29
   #######   ###
####     #####@####
#    $          $ #
# $# ##$  #$  #   #
## #$# $  #   # # #
## # # $#### $#$# #
#  $    #..#      #
#   ## ##..##### ##
#  ## ........ # #
##  # ......*. # ##
##$ #####..## ##$ #
#  $  $ #..#      #
# $# $  #### $##  #
#  $   $ # $ $ $  #
#    ##      #    #
###################
Solution: undefined

;30
 ###################
##       #         ##
#  #$  #     $ $  # #
#  $  # # $## # ##  #
# $ ##   #  # $  #  #
# $   $$ #$ #$$$ #  #
##  ##   #  #    $  #
#@ #   ##  # ###$#  #
## #    $  # .#.... #
#   ## #  $# .#.... #
# $   $ #$ # .#..#. #
# $## $ #  # ....#. #
#    $    #  ....#. #
##  ## ##  #     ## #
 ####################
Solution: undefined

;31
  ####   ########
  #  #####      ##
 ##  #   #   #   #
 #  $# $ $  $# $##
 #$  $  # $  #$  #
##  $##  $ $  $  #
#  #    # $ $  $ #
# $$  # @ # $  # #
# $ #########$ # #
# $  $    $    $ #
#       #     ####
#  ##..###..###
####.........#
   ##..###..##
   #....#....#
   ###########
Solution: undefined

;32
###################
#           ##    #
#    $    $   $ $ #
#   ########  #   #
#     $    $  $   #
# $#        #  # ##
#  ###.....##     #
# $  ##....#   $$ #
#  # ###..##$# $  #
## $$   @     $#$##
#  # ##..### # $  #
# $  #....##$ $   #
# $  #.....#   ## #
#  ###     ##   # #
#                 #
###################
Solution: undefined

;33
  #########
 ##   ##  ##
##@ $$   $ ##
# $# ## $$  #
#  $  #     #
# $$ $#  ####
#   # # $  ##
#      $ $  #
# $# $# $#  #
#  $  #   $ #
##### $ #####
 #.... ....#
 ##.......##
  ##..#..##
   #######
Solution: undefined

;34
###############
#.#.#  #  #   #
#...#  $ $    #
#...#  # # $  #
##..# #   #$###
##..#  $$  $  #
#   #$#   #$  #
#      # #  ###
#  # $  $  $  #
#  @##    #   #
###############
Solution: undefined

;35
######
#    #########
##...    #   #
 ##..##$$#$  #
##...#@  #   #
#....##$$#$$##
##...    #  #
 ##..##$    ##
  # .#  # $  #
### ##   #   #
#     $ $ ##########
# $$$$   $   $  $  #
#    #####         #
######   ###########
Solution: undefined

;36
   #####   #####
  ##   #####   ##
 ##    # @ #    ##
##    $  #       ##
#   #$# # # # #   #
#  # $ $ # ... #  #
# $ $ $  $..#...  #
#  # $ $ # ... #  #
#   # # # # # #   #
##    $  #        #
 ##     ###  ###  #
  #  #### #### ####
  ####
Solution: undefined

;37
 #################  #####
##    ##   #     ####   #
#     $   $#$ ## # $    #
#  ####$$    $   $ $ $  #
#  $    $ #$  ##$  ### ##
##   ######  $     # #$#
#  ##########$  #$ ### ##
# #.......#  $ # $ ## @ #
#   .....#        $### ##
#  #....    $$$    # #$##
#   ....#  $  ## #####  ###
#  #.....#  $$# $  $ $  $ #
###.......#   #    #      #
  #########################
Solution: undefined

;38
######################
#      #        #    #
#  $ $ #$# ## $$# $  #
# $##### #...## ###  #
##@#    $ ...  $  #  #
 # #   # #...# ## #$ #
 #$## #...#*#...  #  #
 #  # $....*....# #  #
 # $# #...#.#...# # $#
 #  #  ##    # #  #  #
## $#$    $$   $  #  #
# $ #  #### ####  #$$#
#   ###         ###  ##
##   $   ##$$## $ $   #
 #  $  $      $       #
 ########   ###########
        #####
Solution: undefined

;39
    ######
    #    #
##### $ $######
#      # $  $ #
# $ $ #.      #
##   #... $ $ #
 #  #....### ##
 #$#.....*@$ #
 #  #....###$##
## $ #... $   #
# $ $ #*      #
#      #  $ $ #
#  $ $$  ######
#####    #
    ######
Solution: undefined

;40
  ########
###      ###
#  $  $  $ #
# $ ## $ $ #
#  #..# $  #
# #....#$$ #
# #.....$  #
# $@...#$  #
#  #..#  $ #
# $ ## $ $ #
#          #
############
Solution: undefined

;41
#### #######
#  ###  #  #####    ######
#   $  $ $ #   ######    #
#   #$  #$ #$ ..*......* #
##$##   $   $ #########. #
#        $    #   #   #. #
# $  $ $ #$ #$# ....* #.##
### # ##$#    # .###.##*#
#   # ## ## $$##.#.#. #.#
# $ #$$ $ $   ##.#.*. #.#
# $ $        $##*#  # #.##
##### ### # # # .######. #
# $ $$$@$$$$$ # ..*..... #
#             #   ####   #
###################  #####
Solution: undefined

;42
       ###
      ## ##
     ##   ##
    ##  #  ##
   ##  $#$  ##
  ##    $  $ ##
 ## $ .# #.   ##
## $ $#...# $  ##
#  ## .... $$#  #
##   $#...#    ##
 ##   .##..   ##
  ##    $ $  ##
   ## $###$ ##
    ##  #  ##
     ##   ##
      ##@##
       ###
Solution: undefined

;43
    ###########
    #         #
    # $  $ $  #
   ## $ # # $ ##
  ##   # $ #   ##
 ##   # #.# #   ##
##   # $.*.  # $ ##
# $ #  .....   $  #
#  # $#..#..#$ #  #
#   $  .....  #   #
## $ #  ...  #   ##
 ## $ # #*# #   ##
  ##   # @ #   ##
   ##   # # $ ##
    # $$ $  $ #
    #         #
    ###########
Solution: undefined

;44
####################
#                  #
# #$   $  #  $  $# #
#  $  $  $  $ $    #
##### ########### ##
#  $   $  #  $     #
# $#$ #   # $# $#$ #
#  $   $  #  $     #
#    $  $ #@ ### ###
#### ######### $   #
# ## # $ $ $ $     #
# #  .........     #
#   #.........     #
#    .........     #
####################
Solution: undefined

;45
     ### ###
     #+# #.#
 #####.###.######
##    $     $   #
# $$    $ $  $  #
#  ###.###.######
# $# #.# #.#
#  # #*# #.#
# $###.###*#####
#  $  $  $   $ ##
##   $     $ $  #
 #####.###.###$ #
     #.# #*# #  #
     #.# #.# #  #
######.###.###  #
#    $$      $  #
#  $           ##
######.###.#####
     #.# #.#
     ### ###
Solution: undefined

;46
        ###
       ##.##
      ## . ##
     ##  .  ##
    ##.$ @  .##
   ## $ $#    ##
  ## #   # $$  ##
 ##.. #  #$ $ ..##
## $ $ # #  $    ##
# $    $ # $ $    #
#...######## $ ...#
##   $   #   $   ##
 ##  $ $ #$#    ##
  ##..  $#  #..##
   ##    $$ $ ##
    ##.     .##
     ##  .  ##
      ## . ##
       ##.##
        ###
Solution: undefined

;47
  ###############
  #             #
 ##$$ ### ### $ ##
##  ###*# #*###$ ##
#  $$ ### ###  $  #
##       $       ##
 ##$   $###     ##
  #  $ $ # $$  $#
  #  ##  @  ##$ #
  #$  #######   #
  #     ###     #
  ##     # $$ ###
   ####...$.###
      #*....#
      #....*#
      #..*..#
#######.#.#.#######
#      $...$ $    #
#        .        #
###################
Solution: undefined

;48
     ###         ###
    ## ##       ## ##
   ##   ##     ##   ##
  ##   $ ##   ##  $  ##
 ## $##   ## ##  $##$ ##
##    $ $  ###  $   $  ##
#   $$##$  $@$   ##$$$  #
## $$ ##   ###   ## $  ##
 ## .*.*  ## ## $..*. ##
  ##.....##   ##.....##
   ##...##     ##.*.##
    ##*##       ##.##
     ###         ###
Solution: undefined

;49
#########################
#                       #
#         ###    $ $    #
# $ $ $   #@# $   $$$   #
#  $ $ $  $ # $$   $    #
# $ $ $     #$$ $  $$   #
#    $ $   $#     $ $   #
#   $ $     #  $ $      #
# ## ###### # ###### ## #
# ###.......#.......### #
#  ###...... ......###  #
#   ###..... *....### $ #
#  $ ###....#*...### $  #
#     ###...#...### $   #
# $    ###*.*.*### $    #
#    $$ ###**.###  $$   #
#   $$   ###.###  $ $   #
#    $$     *      $$$  #
#                       #
#########################
Solution: undefined

;50
###########  ###########
#  #..  ..#  #..  ..#  #
# $#.#  #.#  #.#  #.#  #
#  #..  ..#  #..  ..#  #
## #.#  #.#  #.#  #.#$##
#  #..  ..#  #..  ..# ##
# $#..  ..#  #..  ..#  #
#  #### ###  ### ####  #
# $$  # ######## ####  #
#     #   $@$       #  #
#   $ #  ####### #  #$ #
# $############# # $#  #
#  #    $        # $ $ #
# $#  $########  # $$  #
#  $ $   $ $  ####$ $$ #
#   $# $ $   #  $      #
#  $  #  $  # $ #   $  #
#  $$  #$  #  $$ #  $$ #
#                      #
########################
Solution: undefined

