;1
##########
#        #
# # # # ##
#  $ $ $ #
#.## # # #
#.#     @#
#.########
###
Solution: 4-3l2,1-2d3,6-3l4,1-2d2,8-3l6,1-2d1

;2
######
#    #
#$#  #
# #  #
# #.#######
#.# # #   #
###$### # ###
#+$         #
######### # #
        #   #
        #####
Solution: r8,3-7u4,1-1d3,11-7l9,3-1d2

;3
#####
# @ #
# $ #
# . #
#.$.#
##.##
# $ #
#   #
#   #
# $ #
#   #
#####
Solution: 1-4r1d2,3-2l1,1-1d2,2-8u4,2-10u4

;4
 #####
 #   #
 # $ #
 # # #
## $ ##
#  #  #
# *#* #
# $+  #
# *#* #
#  *  #
##   ##
 # # #
 #. .#
 #####
Solution: 4-7d4,1-7r1d4,2-5d2,4-5d2,4-2l1,2-1d4,2-4r1,4-3d2

;5
###########
#  #      #
#  $   $  #
#  ##.##  #
##$#...#$##
#  #. .#  #
#  #   #  #
#  #   #  #
#@ $  $   #
###   #   #
  ##  #####
   ####
Solution: r2d1r1u4d3r3d1r2u1l3u1l1d1l1d2r1u2l1u1r1d1r1u3,2-5u2,2-1d6,1-8r2,4-9u3,8-3d4,9-8l3,5-9u1,4-7r1,6-8u2,8-2l2,5-1d2,2-2r2,5-1d1

;6
##### #####
#.. ### ..#
#   #.#   #
##$  @  $##
#   $ $   #
#  ##.##  #
#  #####  #
#  $ $ $  #
#         #
## $#.#$ ##
#.  ###  .#
##### #####
Solution: 2-4u2,3-1l1,5-4l2,2-3d1,2-6u4,7-4l1,5-3d1,8-4u1,9-2l1,7-1d1,8-3l2,5-4u1,6-7r1,8-8u6,7-1r1,4-7r3,8-8u6,7-10u1,6-8r1,8-7d2,7-10r1,4-7l1,3-10u1,2-8r2,5-7d1,2-6d3,3-10l1

;7
#######
#     #####
# $ $ #   #
##$  ..   #
#   ... $##
#  #..#   #
#### ##$  #
# $  $   ##
#   @ #  #
##########
Solution: 6-7l1,4-8u3,3-4r1,5-3d1,1-7r2,4-8u3,3-4r1,4-4r1,4-1d2,3-4r1,1-2r2,4-1d3,2-4u1,1-2r2,4-1d2,8-5u1,9-3l3,7-7u3,8-3l1

;8
#########
#   +   #
# #$$$# #
#  .#.  #
# #$$$# #
#  .#.  #
##  .  ##
 ##   ##
  #####
Solution: l3d2r2d2l1d1r1d1r2u2r2u2l2d1l1r1,3-3d1u2,4-1l1,5-1d1l1,3-1d1,1-1r2

;9
###########
#  #   #  #
#   $  *  #
# $## ##  #
##@#. ## ##
#  #.   $ #
#  #. ##  #
#  #.##  ##
#     #   #
### $     #
  ##  ##  #
   ########
Solution: 4-10u5,9-5l4,5-2r2,8-1d7,9-9l4,4-10u3,2-5u2,2-1d6,1-8r2,4-10u1,2-2r4,4-9u1

;10
   ### #####
#### ###...###
#        . $ #
# ## ###   # #
# ##$####### #
#     #    @ #
####   $ $  ##
   #  #######
   ####
Solution: 12-2l2,8-3u2,9-3u1,8-1r1,4-5u2,3-2r5,10-2l1,8-3u1,8-6l3,4-7u4,3-2r5,9-3u1l1,10-6l5,4-7u4,2-2r6

;11
##############
#.  $       .#
### #*###$ $ #
  # $ ##  .. #
 #### ##@  $ #
 #   $... ##$#
 #   ####    #
 #####  ######
Solution: d1l4r4u2r2u2l8r3l2r3l1r5d2l1d2l2r2d1r3u3d3l3u1l5d1l2u1r6u1r1u1r3d3l3u1l1u2r2u2l5d3,6-5l2,3-3r1,5-4u1,2-5r3,10-4l1u1l1d1r1d1l1,12-4l3u1l1d1r2u3l1d1r1d2l2u1r1u2r2d1l2d2r3u2

;12
  ######
  #    #
  # ## ######
  # $    .  #
###.#####.# #
#@ $   $    #
### # ### ###
  #   # # #
  ###*### #
    #     #
    # $####
    #. #
    ####
Solution: r2d2r2u2r4l5r1d2l2u4d2r6d4l4u2d4r1u1l1u3l2u2r6d4l3,5-8d2u3l2u2r6u2l2r4d2l2,7-5r1,9-6u1,3-1d4,3-3r5,3-7u2,5-5d2

;13
  ######
  # $ .#
  # ##.#
  # ## ####
  #       #
####*# #$ ####
#  $ #  $ #. ##
# ## ##@$ #   #
#   $...      #
#   ####  ##  #
#####  ########
Solution: r1l1u1l1u2r3d3l1d1r3u1r2d2l1u1r1u1l1d1l1u1d1l3u1l1u1r1l2u2r3d3l1d1r3l8d1l2u1r6u1r2d2l1u1r1u2l3u2l3u3r2l2d3r6d2l1u1r1u1l2r1d2l2u3d3r3d2l1u1,4-4d3,5-8l2,2-6r1,4-7u1,13-8l4,8-9u1,1-8r10,13-8l7,9-7l1,8-5d2,9-8l2,7-6d1

;14
    #######
    #     #
 #### # # ####
##  #$#@#$#  ##
#   * .*. *   #
#     .*.     #
#  ##$# #$##  #
##### # # #####
    #     #
    #######
Solution: u2l2d3r1d1r5l6u1l2d1l2u1r4d1l2u1l2d2r1u1l1u1r2d1r4d3l2u2d2r2u3l4u1l2d1r4d3r4u2d2l3r1u3r1u1r1u1d2r2l8r8u1r2d1l5u1r2d1r2u1l1d1l2u1l1d1l1d3r2u2d2l2u3r4u1r2d1l4d3l4u3r1l3u1l2d1r4d3r4u5d1r2l2d4l4u7r4d2u2l4d7r4u3r1u1l1d1r4u1l2

;15
###########
#    +    #
# $ $ $ $ #
#... * ...#
# $ $ $ $ #
#    .    #
###########
Solution: l2d3l1d1l1u1r1u1r1u2l1d1u1r3d1l1d1l1d2r2u3r1u1r2d1u1l1d1l2d3r2u1r1d1r1u1l1d1l4u1l1u1r1u2l1d1r3d2r1d1l1

;16
##############
#.  $        #
### #*###$ # #
  # $ ##   # #
 #### ## $ # #
 #@  $....## #
 #   ####    #
 #####  ######
Solution: r6u2r2u2l8r3d3u3r5d2l2d2l3u4l2d2r1l1u2r9l2d2l2d2l3u2d2l1d1l2u1r3u2l2u2r9l2d3l1r1u3r2d5l3u1d1r3u5l2d2l2d1u1d1u1r2u2r2d5l3u1l1u2r2d1l1r1u3l1d3u1l1d1

;17
##########
#        ##
# #####   ##
# #   ###  ###
# #..    $   #
# ##**$ ##   #
# #  .*  # ###
# # # ** #$#
# #  @  ## #
# #######  #
#         ##
###########
Solution: u2d2r2u1l1d1l3u2r2u1r1d1l3d2r4u1r1u1l1d2l4u2r2u1r1u1r1d2u2r3l5u1l2d1r2d2l1u1d1l1d2r2u1d1l2u2r1u1r1u2l2r1d1r1d1r2u1l2u1l2d1r1u1r1d1r5d1r2u1l8r5u2l2u1l6d9r8u1r1u4r1u1l6

;18
  ###########
  #         #
  # $   $   #
  ### $ #####
  #   $##   #
  #     $   #
  # $##$##  #
  #         #
  ##### #####
####### #
#..  ## ##
#.   ##  #
#.       #
#. @ #####
#..  #
######
Solution: 7-5d6r1d1l6d1l1u2,4-5d1l1r1l1d1r3,7-6d5,8-12l4u1l1d2r1d1l2,7-5r2,10-4d2,11-7l3,7-5d6,8-12l5,2-11d2,7-3l1d1,5-5r4,10-4d2,11-7l3,7-6d5,8-12l5,2-13u2,5-2d2,6-5l1,4-4d2,3-7r3,7-6d5,8-12l5,2-13u1,3-11l1,3-2r1u1r1d3r1d1l1u1l1d2l1d1r3,7-6d5,8-12l5u1l1d1r1d1l1,9-2l3,5-1d3,6-5l1,4-4d2,3-7r3,7-6d5,8-12l6

;19
         #####
         #  .###
         ##  $ ##
          ##    #
           ## $ ##
#############$  .##
#@ #   #  #   * *.#
# $.   *      * *.#
#############$  .##
           ## $ ##
          ##    #
         ##  $ ##
         #  .###
         #####
Solution: d1r3u1r2d1l2r7u1r2d1l5r5d1r2d2l1d1l1u1l1d1r2u1r1u3r1l1u1r1l1u3l2d1r1u1r1d1l1d1r1d3l2u1r2u1r1d1l3u1r2l1u2l1d2l1d1r3d1u4l1u2l1d1l1u1d1r2d4r1d3l1u2d2l1u1r1u3d3l1u1r1u2l2d1r1u3r1d1

;20
### ############
#.# #          #
#.### ##### ######
#...$$      $    #
#.### ########## #
#.###   #  #     #
#.*.$   ####$# ###
# # #   $      #
# # ## ####### ###
# # @# #     #   #
#$#$##$########  #
#                #
######  ##########
     #  #
     ####
Solution: l1u3r2d1r1d4l5u9d4,3-6l1,1-7u4,3-11u4,4-6l2,1-7u2,7-6l5,1-7u1,6-13u6,7-6l5,9-7l2,6-8u1,7-6l4,13-3l2,5-2d3,6-6l2,5-3l3,11-3l8,12-5d1,13-7l6,6-8u2,7-5l1,5-6u2,6-3l2

;21
  #####
 ##   ##
## $ $ ##
#   *   #
# #$$$# #
#. .+. .#
# #$$$# #
#  ...  #
#########
Solution: l3d2r2u1d1r4u2l4r4d2l2u1d1l2u2r2d2r2l2u2l1d1l1d1l2u4r2d3u1r1d1r1d1r2u4l2d3u1l2u2l1u1r1d3l1r4l3u4r2d3l1r1u3l2d3u1r1l1u2r1d2u1d2u2r2d1l1

;22
           ###
           # ##
 #####     #  #
##   #     #$ #
#  $ #######  ##
#  $  ...+.    #
#  $ #######  ##
##   #     #$ #
 #####     #  #
           # ##
           ###
Solution: r4l9d2l2u2r1l1d2r2u2r10l1u3l1d1u1d2r1d1l9r9d3l1u3d1r1u3l1d1r1d1u1l1d2u1l3r4d3u1d1l1u4d1l8d2l2u1d1u1d1r2u2l1r4l1r8l1u3l1d1r1d2l10r1d2l2u1l1u2r1d1r11u2l1d1r1d1l9d2l2u1l1r1l1u2r1d1r7l6r1d2l2u1l1u1r7l6d2r1u1l1u1r5l5u2r1d1l1d1r4l3u2r1d1l1d1r2

;23
   ###########
   #         ##
 ### #######$ #
##   #     #  #
#  $ #     #$ #
#  $ #######  ##
## $ ....+.. ..#
#  $ #######  ##
#  $ #     #$ #
##   #     #  #
 ### #######$ #
   #         ##
   ###########
Solution: 12-9u1,12-11u1,12-8u1,11-6r2,12-10u3,11-6r1,13-5d2,12-3d1,12-1d1,2-6r6,2-8r1,4-9u2,3-6r4,2-7r1,4-8u1,3-6r3,2-5r1,4-4d1,3-6r2,3-3d2,2-6r2,12-4d1,13-6l2,12-2d3,13-6l1,13-9u2

;24
 ########
##      ##
#  # ##  #
# ##  ## #
# # $$ # #
#  $  $# #
#  ....  #
##$.@ .$ #
# $.  .$##
#  ....  #
# #$  $  #
# # $$ # #
# ##  ## #
#  ## #  #
##      ##
 ########
Solution: d2l3d4r1d1r3u4d1r1l1d1l1u2d2r1d2l3u1l1u5r1u1d2r1u1r1u2r1d2,6-11u1d1l3u1,3-6d1,8-7u1d1l1,7-9u1,6-6d1,8-7l1,4-3d2,5-3d2,6-4d1,3-4d2,1-6r1

;25
    #####
  ###   ###
  #   $   #
### ## ## ###
# $       $ #
# # ##$## # #
# # #   # # #
# # $   $ # #
# #### #### #
#  # # # #  #
##  #   #  ##
 ##   @   ##
  ###...###
    #...#
    #####
Solution: 1-4r2,3-7r2,6-6d6,5-13r1,6-4d7,7-12l1u1l1d1,6-1d10,5-12r1,3-4r2,6-3d7,7-11l1,5-10d1,9-7l2,6-6d6,11-4l4,6-3d8

;26
#######
#     #
# # # #
# $ $ #
# # # #
#.# #.#
### ###
## + ##
# .$. #
# $$$ #
#  .  #
##   ##
 #####
Solution: u4l1r1u2l2d3u1r3l1u2r2d3u2d1l2d4l1d1l1r1d1l1d1r1d1r2u1r1u2l2r2d2l1u1d1l1u7d6l2d1r1u1r1u6l2u2r2d5

;27
####################
#  . .          $  #
#  ### ###   ### # #
## # #   #####   # #
 # # # # . $ . # # #
 #$### #  $.$ ## # #
 #     ##$.@.$##   #
 ##### ## $.$  # ###
     # # . $ . # #
     #   #####   #
     # ###.#.### #
     #   $   $   #
     #####   #####
         #####
Solution: d1u1l1r2l1d1r1d1r2d1r2d2l4d1l2u1r1d1r1u1,17-1l5,8-11r2d1r2u1l1d1l1u1,2-6u4l1u1r1,12-1l6,10-8r2,14-7l1,9-5d2,10-4d1,12-4l2,13-5l1,12-8u1,13-7l1r1u2,9-7r1

;28
  ######
  #.#  #
  #@# $##########
  #$#        #  #
  # #  ####   $ #
  # #..#..# ### #
### ####... $   #
# $ $       # # #
# # # ##  ### # #
#      $  $   # #
########## ## # #
         #      #
         ########
Solution: u1d6r2d2l2u7d5r5d1r1u1r1u1l1d1l1u1d1l1r2l2r4u4l6u2r1d3u2,11-6r2,15-4l3,11-5u1,12-3l6,5-2d2,15-6l5,9-7u1,9-9r3,13-10u3,14-6l4,6-9r6,13-10u3,14-6l3,1-7r6,8-8u1

;29
   #####
   #.*.#
#### $ ####
#   $ $   #
#   # #   #
## ## ## ##
 #$# @ #$#
 #       #
 ###...###
   #####
Solution: d1u4l2r4l2r1u2l1d6u4l2d1l2u1r3u1r2d1l1d4l3u3r1u1r1l1d1l1d3r3u5d1r2d1r2u1l3,5-4u1l1u1r1d1r1u1l1d1l2d1l2u1r3u1r1d4l1d1r1u1r1d1r2u3r1u1l3u1l1d4r1d1l1u1l1d1

;30
  #############
  #     .     #
  # # ##### # #
  #           #
  ###* #$# *###
  ##  ## ##  ##
  #  ##   ##  #
  # ## $.$ ## #
### $  .#.  $ ###
#.# ## $.$ ## #.#
#    ##   ##    #
#  #  ## ##  #  #
#####  #@#  #####
    ##     ##
     #######
Solution: 5-5u1r1u1l1,11-5u1,10-3r1,7-10u1,5-8l1,3-7d2,4-10l2,1-11u1,6-7r1,9-6d1,10-9l1,8-5u1,9-3l3,5-4u1,3-3r2u1,4-1r3,7-3l2,3-3r1,5-2d1,11-8r1,13-7d2,12-10r2,15-11u1,13-3l1,11-2d1

;31
###############
#.       $    #
# #######.### #
#           # #
# #######$# # #
#.$       # # #
# # # #   # # #
# # #$### # # #
# # #    +# # #
# # ####### # #
# #         # #
# ########### #
#             #
###############
Solution: u5r2d7l8u5r5d1l1r2d2l4r4u5l1r1d2l3r3u2l8d9r12u11l11r11d11l12u7r7d1r1u1l5r5d3l4u2d2r4u2l1u1l6r1d5r8u7l2d4

;32
 ###
 #.####
 #@##.####
 #$   ##.# #####
 # ##$   ###   #
 # ## ##$.$    #
 # ## ## #.#####
 # ## ## #$    #
## ## ## # ### ###
#. *  $  #       #
#  #  #  #####$# #
#  #  #  #.      #
##################
Solution: d7l1d2r1u9d1r3d6l3r2d2r1u8d1r3d5l1d1u1l3r3d2r1u7d1r3l1d2r4d3u1r2d2l5r3u4l4u2r2u1r2d1l4r2l2d2r4d2l4u2

;33
       ######
       #    #
######## ##$##
# . *      $ #
# # ####.### #
#+ $   #     #
#### # ##### #####
   #. $    #     #
   ##### # ##### ##
       #. $    #  #
       ##### # ## #
           #. $   #
           ####   #
              #####
Solution: 2-5r2,5-7r3,9-9r3,13-11r2,5-3l2,12-3l7,11-1d1,12-3l3,8-2d1,17-11l4,14-9l5,10-7l5,6-5l4

;34
   ########
   #      #
  ## #### ###
  #  ...#   #
### $.$*### ###
#    .*.$ #   #
# ###.$+$ #$# #
# $  . *      #
##### $ $ #####
    # # # #
    #     #
    #######
Solution: u2d1l1u1l1u1l2d2r2l1u1l1u1r1d1r3d1l1r1d1l1d1r1d3r2u5l2d1l1u1r1u1l1r1d1r2d1l1r1d4l2u4l1u2d2r2u1l1d2l1r1d3l2u2r1l1d2r2u5r2d2l1r1d3l2u4r2d1r4u2l2d1u1r2d2l5r1d3l2u3d3r2u2l1r1d2l2u2r2u1r3l1u4l2u2l5d2l1d2l2d2r3

;35
     #####
     #   ####
  #### #    ##
  #  # $ ##  #
  #  *  *. $ #
  #  ###.*####
###.##.####
#     $  #
#   ##$# #
#####@   #
    ######
Solution: r3u2l5r5d2l2u2d1u1l3u3r3u3r2d3u2r3d1r1d1l2r1u2l3u1l2d3r1l1u3r2d2l1d1l4d4l2u1r1d1r1u3r1u2l1d2r1u1r3u1r1u2l2d2r1d1l1

;36
#############
#       #   #
## ## # # # #
#    $#$# # #
#  $#     $ #
#   #.#.# # #
##*######.###
 # #@ $.   #
 #.#  ##   #
 ###########
Solution: r4d1r2u1l2r1u6r2d3l1r1u3l2d3l4u1l3u2r3d3u3r2d3l2r4d1u1l4u1l3d2r1u1l1d3u6r4l1d2l2r2u2l3d4

;37
###########
#    #    #
#  # # #  #
#  #$#$#  #
##*     *##
 # #.#.# #
 # ##.## #
 #   @   #
 ####$####
   #   #
   #   #
   ## ##
   #   #
   #   #
   #   #
   #####
Solution: d5u5r3u4r1u2l3d3r2d3l6u4l1u2r3d2u1d2u3l2d2,5-14u7,8-1d2

;38
    #####
    #   #
 #### # ###
 #+$      ####
 # #### # #  #
 #  # $  $ . #
 #  # ####$# #
##$##    # # ####
#   #### #.    .#
#      . ## #####
########  # #
       ##   #
        #####
Solution: r3u2r2d2r2d1u1l2d2r3d2u2r1u1r1d3u3l1d1l4u4l2d2l3d5l1d1u1r2d1r5u1d1u2l3r3d3r1d1r2u3r3l2r1l2d3l2u1l1u3l3u2r5l3u4l2d2l3d5l1d1r5l4u6r3u2r2d2l4

;39
    #######
    #     #
 #### # # ####
 #  $  @  $  #
## ## #.# ## ##
#   # #.# #   #
#   $ #.# $   #
##### #.# #####
    #     #
    #######
Solution: 9-6r2,5-6l2,3-3r3,7-2d4,11-3l3,7-2d3,13-6l3,9-7u3,10-3l2,7-2d2,1-6r3,5-7u3,4-3r2,7-2d1

;40
  #####     #####
 ##...##   ##...##
##. * .## ##. * .##
#       ###       #
## $  $  #  $  $ ##
 ##  # $ @ $ #  ##
  ##  # $*$ #  ##
   ##  $ * $  ##
    ##  #$#  ##
     ##     ##
      ##   ##
       ##.##
        ###
Solution: r1u1r1u1r3u1d3r1u3d3u1l2u1l2d1r2,14-5u2,15-2l1,13-3u1,12-5l1,11-8u3,9-5r1u1r3,14-5u2,15-2l2,11-6u1,10-4r3,14-5u2,13-2r2,10-7u1,9-5r1,11-6u1,10-4r3,14-5u2,3-5u3,5-2l2,7-4l2,4-5u3,6-5r1,7-8u3,9-5l1,8-4l3,4-5u2,3-2r2,7-6u1,8-4l1,6-5u1,7-3l1,5-4u2,8-7u1,9-5l1,7-6u1,8-4l3,4-5u2,8-7r1d3,11-7l1

;41
       ####### #####
       # ....# #.  #
#### ###$$$ .###   #
#. # # * *      $  #
#  ### # # $ ### ###
#     $@ * $ ##    #
#  ### #$# $ ##    #
#. # #     #####  .#
#### #######   #####
Solution: l5d1l1u2d1r5d2r4u2l8u1l1d2r1u1r4d2r4u4r6u2r2d2l1u1l1d3l1d1r2u1r1d1,8-3r8,18-3l1,16-2d3,16-7u5,6-3r10,8-1d1,9-3l1r1u1,8-1r3,9-2r2,6-3r3,8-7u3,10-4u2,9-3l1,9-1r1,12-5l2r1u1,12-3l1d1l1u1r1u1l1d1l1u1,12-6l1,10-7u5,18-3l8

;42
#############
#    .+.    #
# $$$.*.$$$ #
#    ...    #
###### ######
     # #
   ### ###
   # $ $ #
   #     #
   #######
Solution: l1d2r1u1d6l2u1r1d1r1u5l1u1r1d1r2u1d1r3u2l3d2l5r1u1d1l3u2r3d2l3r7u1l1d1l3u2l2r2d1r2d1r3l1u2r1d1u1r2d2l6u1d1l2r8u2l1d1r1d1l5u1l2d1r2d5r2u1l1d1l1u5l2u2l3d2r4l4u2r1d1l1d1r3l2u1r2

;43
    #######
    #     #
##### ##$##
#  #  $   #
#  $  #   #
#  ##.#. .#
##$#..##$##
 # #.*.#  #
## # $ #  #
#  #   #  #
#@ $  $   #
###  .#####
  #####
Solution: r2d1r2l2r1u4d2r1d1u1r1u2l1r1d2l1d2u1r2l3u1d1l1r2l1u2r1d1r1u1d1l1d1l3u5l1u2r1d1r2u1r1d4u1d2u3d2u6r3d3r1l1r1d1l1r1l1u4l3d2l1r1d5r1d2r1l4r1u2r1u5r2l2u2r3d2r1d2l1d2r1l1u2r1u2l2d1r1u1r1d1l1d1u1l1r1d1u2l4r1d5l1d3r1u4d3l1d1l1u1l1u5l1u1r3u1r1d1u2d1r3d4r1d3l4u1d2l2u1r1d1r1u3d2r4u3l1d2r1d1l3u1l1d1

;44
 #########
 # . . . #
##$ $ $ $##
#  . . .  #
# $#$#$#$ #
#  . . .  #
##$ $@$ $##
 # . . . #
 #########
Solution: u1r4u2l3u1r1u1r1l2d3u1r3d2u2d2u2l1r1l4r1u1r1u1r1d1l3d1l1d1u1l1u1r3d1r1u1l3d1l3r1l1r1l1d2u2d2r1u1l1u1r2u2l1d2l1d2r1l1r3u2r1u1l1d1l1u1r1d3l2u1l1u1r1d2r1d2l1u1r1d1r5l1u1l1u2d2u1d2l3u2r1u3r3d1l1d4u2r3u2l1r1d2l4d1l1d1l2u1r1u1r1l1d1l1r2u5d1r2d5u1l2u1l1d1r4u1r1u1d1l1d2l1u5r2d1r1l1d1r1d1l2d2r1u1l4d1r2l1u1l3d1r2u1r2u2d2l3r1u4l2d1l1d2r1l1r1u4d1r4d3r1d1l3u1l1d1u1r1u3l2d1l1d2r1d1r4u4r2d1r1d2l1

;45
 ###
## #
#  #
#  #####
# *    #
# ##   #  ####
#*#  ######  ##
#@#  #  $    .#
###  # # #  . #
  # *  #$# $$.#
  ##   # #  . #
   #    $    .#
   ########  ##
          ####
Solution: u3r3l2u2l1d3u1r3d1r2u1l3r1d5r1d2l1u1r2d1r6l1u2r1l1u1l1u1r1u1r1d3l2d2l4u4r5u1r1d1l2d4l2u3d3l2u4r6

;46
   ######
   #  # #
   #  * #
####  * #
#   + * #####
#     *     #
# ********* #
#     *     #
##### * $   #
    # *  ####
    # *  #
    # #  #
    ######
Solution: l1r1d1r4l1d4u3d1r4u2l6u1l3d1l1d2r4l4u3r4d1l1u1l3d3r7l1d1u1l3u2r1u1l2r1d3l3u2r2u1r1d1l3u1r2d1l2d2r5u1r1u1r4d2l4d2r1u1r1u1l1d1l1u1r4u2l3d1l1d2r1u1d4l1u4

;47
 ###############
 #             #
 # #####$##### #
 # #         # #
##$# ### ### # #
#  . #.*  .# # #
#  . #..$$.# # #
##$# ### ### # #
 # #    $    # #
 # #####$##### #
 #      @      #
 ###############
Solution: 2-3d2,1-6r1,6-8r2,8-5l1d1,8-5d1,8-6r1,8-8u2,7-5r2,8-10u4,9-5l1,8-1d4,9-6l2,10-8l1,8-9u2,9-6l1,2-8u2,1-5r1

;48
#####
#...#######
#...      #
#.. ####$ #
#..## #  #####
##.          #
 #$##$$# ### #
 #  $@ #   # #
 #   $ # $ # #
 ### ###$  # #
  #   $   ## #
  #   # $ $  #
  #####   ####
      #####
Solution: l1d1l2u5r1u1l1d1l1u1,4-7l1d1l1u5l1u1r1d1r1u1,8-10u1,11-11l1,9-12u1,5-7u1,8-2d3,6-5l3,2-6u2,3-3l1u1l1d1,6-7u1,7-5l4,2-6u2,3-3l1,7-10l2,4-11u3,5-7l2,2-8u5,3-2l1,8-7u4,9-2l5,6-8l1,4-9u1,5-7l2,2-8u6,9-11l1d1l1u1r1u1l3d1l1u3r1u1l2d1l1u5,9-9d1,10-11l2d1l1u1r1u1l3d1l1u3r1u1l2d1l1u4,8-7d2,9-10l4,4-11u3,5-7l2,2-8u3,9-7r1d1l1u1l1d2,9-10l4,4-11u3,5-7l2,2-8u2

;49
 #####
 #   ##
##    ######
# $$$$$    #
#    $.....#
##  $ ## . #
 # $  @ .# ##
 #$$$$$. #  #
 #    ..... #
 ######    ##
      #   ##
      #####
Solution: undefined

;50
    ####
   ##  ##
  ## $  ##
 ##  $.  ##
##  @$.   #
# $$$$*$$##
#  ..*....#
##   $.   #
 ##  $.  ##
  ## #. ##
   ######
Solution: u2r1u1r1d1,6-4d4,4-4l2d1l1d1r1,4-8r1,4-7r1,8-4d1,7-6r1,7-4d1,6-6r1,4-6r2,4-4d1r1,6-4d1,4-4r1,5-2d2,4-5r1,2-5r2,5-4d1

;51
 #########
 #.  .  .#
## $$$$$ ##
#  $...$  #
# .$. .$+ #
#  $...$  #
## $$$$$ ##
 #.  .  .#
 #########
Solution: undefined

;52
#####
#   ####
#  $.  #
# $.$. #
##.$#$.##
 # .$.$ #
 #  .$@ #
 ####   #
    #####
Solution: undefined

;53
 #####
##   ###
# .$.  #
# $+$  #
###$#####
#   .$. #
#   $.$ #
### .$. #
  #    ##
  ######
Solution: undefined

;54
    #### ####
#####  ###  #####
#  . $ . $ . $  #
#   . * * * $   #
#### . $@. $ ####
   ##   #   ##
    #########
Solution: r1l2u2l3d2r1d1r2u1l1r1u1l2,9-3l2r2,10-4u1r1u1r2l2d1u2l1d1l2,11-3l2,13-3l2,12-4l2,15-2l3

;55
 ########
 #      #
 ##$  $##
 #      #
 # #$$# #
 #      #
 # $# $ #
 # $  $ #
## $ #$@##
#.. .. ..#
#.. .. ..#
##  $$  ##
 ##    ##
  ######
Solution: 4-12u1,5-10l3,5-12u1,4-10r3,2-7r1d1,4-9l2,3-5d3,2-9r5,5-7l2,2-6d3,5-7r1,7-6d3,6-9u1,5-7r1,7-6d2,6-5d1,7-7l3,3-6d1,2-8r1u1r1d2l1d1r1,5-3d3,6-7l2,3-6d1l1d1r1u1r1d1l1d1r1,4-3d1,3-5r1,5-4d2,6-7l2,3-6d2,2-9r1,4-8d1,6-1d1,7-3l1,5-2d4,6-7l2,3-6d1,2-8r1u1r1d1,3-1d1,2-3r1,5-2d1,4-2d2,5-4l1,5-5l2,2-4d4

;56
##########
#        #
# $ # ## #
#    $ # #
# #  . # ###
#  $.#.$   #
# #  . .   #
# ###$.$.$##
#      .  #
#####  $ @#
    #  ####
    ####
Solution: l3u1l1u1d1l4u3r2u4r2d2l1r2d2r1l1u2l2d1r1u1r1d1u1l1u2r3,8-4d1,9-6l1,8-7l1,9-8u1,10-6l1,8-5d1,5-10u1,4-8r2,2-1d1,1-3r3,5-2d1

;57
  #######
  #  #  #
 ##  $  #
 #  $#  #
## $ .#@#
# $#.####
#$ .##
# .##
#.##
#  #
####
Solution: u2d1l1u1l2d2u1l2d2l1d2u2r1d1u3r2d1l1u1l1d2l1d1r1u2r2u3l1d2l1d1r2

;58
#########
#.$   $.#
# .* *. #
# $   $ #
# $.@.$ #
# $   $ #
# .* *. #
#.$   $.#
#########
Solution: u3l2d1l1d2r1l1u2r1u1r4d1r1d2l1r1u2l1u1l2d6l2r4l2u6l2d1l1d2r1u1d2r2d1u5r2d1r1d2l1u1d2

;59
   #####
####   ####
#         ##
# ##***    #
# #   *#   #
# * + *##  #
# *   **** #
# *****  * #
#  ##* $   #
#   #*   * #
#    ** ** #
##         #
 ####   ####
    #####
Solution: l1r2u2r1u2l2d3,5-1d1r1d1l1,8-3l2,7-7d2,10-7l1u3,10-3l3,7-11u2,6-8r1,7-7r1,9-8u1,8-9u1l1u1r1

;60
#######
#     #
#  $  #
# .$. #
##$$$##
#  $  #
#$.+.$#
#. . .#
#######
Solution: l1u1l1d1r3u1r1d1l1u3r1u2l3d4r1l1u4r3d2l1d2u1l1d1l1u2d1r2l1r1u1l1r2u2l2d5u5l2d1r1u1r1d4u4r1d1

;61
     #####
  ####   #
  # .$$. #
  # @.$. #
  # $$$.##
  # .$. #
###$$.  #
#  .$  .#
# # #####
#   #
#####
Solution: undefined

;62
 ######
 #.   ######
 # #  # $ .#
 # #  $    #
 # # #### ##
 # $ #.$  .#
 # $ #  $ .#
 # # #  ####
##$ $.    .#
#   ####$# #
#    ..#  @#
############
Solution: undefined

;63
  #####
  #...#
  #...#
###...#
#    #####
# $  #   #
### $   $#
  #$ $$$ ##
  # $ $   #
  #@ ###  #
  #  # #  #
  #### ####
Solution: u7d5r1u4l1u1r1d1r1u1l1d4l1d3r1u6l1u1r1l1d2l2d1r2d1r1u2l1u1r1l1d5r1u2r2u1r2d3l3r3u2l5d4r1u8d6r1u1d1r3u2l4d1l1u4d3r5d2l1u1r1u1l4d1l1u3d3r1d1r3u1l2d1l1u5d4r4d1r1d2l1u1r1u1l4u1l2d2r1u5

;64
   #####
 ### # ###
 #   .   #
##  #.#$ ##
# $$.$.$$ #
#   $.$   #
### .$. ###
  # .$. #
  #  +  #
  ##   ##
   #####
Solution: undefined

;65
    #########
    #    #  #
#####$$@... #
#    $...$..#
# #$$..  $$.#
# # $.$$# #.#
# # ..$ #  ###
#   $$      .#
### $   #   .#
  ##### #$#$##
      #     #
      #######
Solution: d1r3u1r1d2u2l2d3u1r1l1d2r1d2l1u4l1u1r2l1d4l2d3r2u6l1u1r1d7r2u1d1l2u2r2l2u1l2u3l1u1r1d1r1u1l1u2d3l2d2r1l1u2r2d2l1d1r5l4u5r2l1d1l2d1l1d1r1d1r1u2l1u1r2d1r1u1l2d1l1d1l1d1l2d1l2u4r6d1r1u1l1u2l1d1r1d2l2u1r2u2l2d1r2d4l4d1l2u4r5d3l3u2d3l2u4r4l2d1r2d2l1u1l1u1r1d1r2d3l1u2l2d2r3u1r4d1l1d2l2u2d2r2u3l3d1l1u1d1l1u1

;66
############
#    #     #
# $$   $$  #
###.*@$ ..##
#    * .   #
#    $.#   #
#   $ *#   #
# $$ . *$  #
###..   ..##
#          #
############
Solution: u1d1r1d1l3r1l1d3u2r1d2u1l3d1r3u2r1u1r3d3u3l2u1r2l2u2r3d6u6l1d1u1l2d2r2l2u2r1d2l1d1l3u1r4l2d2l4u1r3u3l1d1u1l2d1r2u1r1d1

;67
  #####
  #   ##
### $  #
#   $$ #
#@$$$  #
## $ $##
 #  # #
 #....#
 #....#
 ######
Solution: u1r2u2r2d1r1d2l1d3l3u2r1l1d2r3u3r1u2l1u1l2d6l1d1r1u7r2d1l1u1l1d5l1d1r1u6r2d5u1l1r1u4l2d2l1d4u3r1d3u5r2d1l1u1l1d4u4r2d2l2u1l1d3

;68
      ######
      #    #
    ### $  ##
 ####   $$  #
## # $ ##   #
#    $$@  #.#
#  $ # ##  .#
##$$ #     .#
 # #    ##..#
 # ## ####..#
 #    #  #..#
 ######  ####
Solution: undefined

;69
    #######
  ###     #
### $ .   #
#   $$**..#
# $ + ## ##
##$$**..  #
#      ####
########
Solution: undefined

;70
 #####
 # # #
 #   #
## $ ##
# $.$ #
# .$. #
# $.$ #
# .$. #
##$.$##
 #.@.#
 #####
Solution: undefined

;71
 ########
##  ##  ##
#        #
# # $$ # #
#  $..$  #
#$$.$$.$$#
#+.#..#..#
##########
Solution: undefined

;72
   ###########
   #         ##
 ### ### ###$ ##
##         $   #
#  $ #.   .#$  #
## $ ####### ###
 ##  ...*+.. #
## $ ####### ###
#  $ #.   .#$  #
##         $   #
 ### ### ###$ ##
   #         ##
   ###########
Solution: undefined

;73
 ########
## $   .#
# $@$$.##
#  $ # .####
###  #$ ##.#####
  #  $ $$. ....#
  ##  $   .  ###
   ######    #
        ######
Solution: undefined

;74
        ####
     ####  ##
    ##    $ #
   ##  $    ##
  ##  $ #$#..#
 ##  $  $ #..##
##  $ #$   ...#
#  ## $  # ...#
#@ $       ####
########  ##
       ####
Solution: undefined

;75
######
#    ######
##$  .    ##
#  $$$...  #
#    ##$$.+#
#  $$$...  #
##$  .    ##
#    ######
######
Solution: undefined

;76
     #####
     #   #
  #### # #
### $  # #
#   $ $..#
#+  .$$..#
#   $ $..#
### $  # #
  #### # #
     #   #
     #####
Solution: undefined

;77
 ####
##  ######
#.....   #
#... # # #
###### # #
   # $$$ ####
   #@  $    #
   ###$ $## #
    # $     #
    #  $ ####
    ##  ##
     #  #
     ####
Solution: undefined

;78
       #######
 #######.....#
 #   #  .....#
 #  $   #  # #
 # $$$  # ## #
### $ #      #
#   @ # ######
#  $ ## #
# $$$   #
## $   ##
 #   ###
 #####
Solution: undefined

;79
       ####
 #######  #
 # $      ##
 #   ###   #
###$$#....#######
#     .... #+.. #
#   $ ##   #..  #
##$$  #   ###   #
 # # ## $ $     #
 # $   $$$   #  #
 #      $  ######
 #####  ####
     ####
Solution: undefined

;80
#########
#..... .#
# $$$.# #
# $@$...#
##$$$$$.#
#     $.#
#   $$$.#
#   #  .#
#########
Solution: undefined

;81
 ############
 #    .    .#
 #   .#.. . #
 ##  ### +  #
 # $ #  . . #
 #$    . #. #
 # $  $  ##.#
 # $ $  ##. #
##  $       #
#  $ $$ $   #
# $    $ #  #
#   #########
#####
Solution: undefined

;82
 #######
 #     ##
## #    #
#  $    #######
# $$* $       #
#  * $*$# # # #
#@......$.$.$.#
###############
Solution: undefined

;83
 ######
 #    #
##  $$##
# $$.. #
# ..$$ #
# $$.. #
##.+$$##
 #  ..#
 ######
Solution: undefined

;84
      ####
      #  #
   ####  #
   #  $$ #
####  $ ##
#   $$$ ######
# +.*........#
##$$$ ########
# $   #
#    ##
#  ###
####
Solution: undefined

;85
  #####
 ##.$ ##
##. * .##
#  $ $  #
##.$@$.##
#  $ $  #
##. * .##
 ## $.##
  #####
Solution: undefined

;86
   #####
 ###. .###
 #.$$#$$.#
##.$ $ $.##
#.  $@$  .#
##.$ $ $.##
 #.$$ $$.#
 ###   ###
   ##.##
    #.#
 ####*####
 #       #
 #.     .#
 #########
Solution: undefined

;87
#######
#. @ .#
# $ $ #
#.$*$.#
# $ $ #
#. * .#
#######
Solution: undefined

;88
    #####
    #   #
    #   #
    ##$ #
     #  #
  ####$ ###
  # @   ..#
#### ###..##
#   $   ...#
#  $$   ...#
#  $ $$#####
###$$  #
  #   ##
  #   #
  #####
Solution: undefined

;89
        ##########
#########    #   #
#                #
## $ #### #### $ #
 # $ ####.#### $ #
 ##$ ....+.... $##
 # $ ####*#### $ #
## $ #### #### $ #
#                #
#########    #   #
        ##########
Solution: undefined

;90
    ######
#####  # ##
#      $  ##
# ### $$$  #
#      $.$@#
#### $$$.  #
   # $ ...##
   #$$$...##
   # # ....#
   #   #.###
   #######
Solution: undefined

;91
 ####
 #  #####
 #$     #
## ##   ######
#     $$   $ ####
#  #  # # $ ....#
##$####  $$ ....#
 # #  $   $ .+..#
 # #   ##$####..#
 #   #    #  ####
 #$###### #
 #      #$##
 ## ###    #
  # $      #
  #######  #
        ####
Solution: undefined

;92
    #######
    #     #
    # #$  ###
    # # $$  #
    #       #
#####$$# ####
#      #  # #
# # #  #  $ #
# # $ ## $  #####
# #$$  ####  ...#
#     @.........#
###### #### $####
    #    $   #
    ##  ######
     ####
Solution: undefined

;93
   ############
   #  *.......#
#### $$$#######
#     *.......#
# $$ ## $  ####
#  $ ##$$# #
####     # #
   # $$    #
   ###  @###
     #  $##
     # $$ #
     #    #
     ######
Solution: undefined

;94
    ####
    #  ####
 ####     ####
 #  $ # $$  .###
 # $$   $  ....#
 #  ##$#  ##.###
 #     ####.#####
 #$$@$$   ......#
##  $      .#####
#  $$  ######
#    ###
#  ###
####
Solution: undefined

;95
   ########
   #      #
   # ##$$$# #####
 ###  $   ###   ##
 # $$  $     ....#
 #     #  ###..###
 # $ $$## #*####
 ##$$  #  ###
  #  @ #  ..#
##### ##  ..#
#   $     ..#
# ##$###  ###
# #   #  ..#
#       ####
#########
Solution: undefined

;96
 #########
##   #   ##
#  $.$.$  #
# $.###.$ #
# . .$. . #
##$ $@$ $##
# . .$. . #
# $.###.$ #
#  $.$.$  #
##   #   ##
 #########
Solution: undefined

;97
     #######
     #. @ .#
###### $ $ ######
#.  $ .$*$. $  .#
###### $ $ ######
     #. * .#
     #######
Solution: undefined

;98
   ###
  ##.##
 ## $ ##
##. . .##
#  $$$  #
##.$@$.##
#  $$$  #
##. . .##
 ## $ ##
  ##.##
   ###
Solution: undefined

;99
      #####
      #. .#
      # $ #
      # # #
     ## $ ##
     #. @ .#
###### $ $ ######
#.    .$*$.    .#
###### $ $ ######
     #. * .#
     ##$ $##
      # $ #
      # . #
      #####
Solution: undefined

;100
 ######
 #    #######
 # $$ #     #
 ##   # ### #
  ###  $$   #
  #   # $   #
  #   # $$ ######
#### @# $  #    #
#  $$ # #### ## #
# $$    ......  #
#      #   #### ##
########...      #
       #...#     #
       ###########
Solution: d2l1u2r1u2l2d1r1u1r1d3l1d1r10l2u2r3d3u1l6d2r4d1r3u1l5r4u2l5d2u1l1u1l3d1l5u2r3u1r1d1l1d1r10l2u2r3d3u1l5d2r2d1r4u1l6u1l1d1u2l3d1l5r1u1r12l2u2r3d3u1l5d2r2d1r4u1l7u1l1d1u2l7u1r3u1r1d1l1d1r10l2u2r3d3u1l5d2r2d1r4u1l7u2d1u1l4u8l1d1u1l2d1r2u1r1d7l1d1r10l2u2r3d3u1l5d2r2d1r4u1l6u2d1u1l5u7l2d1r1u1r1d6l1d1r10l2u2r3d3u1l5d2r2d1r4u1l5r4u2l10r2u5r2d1r2u3l4d6u4l2d5r7l5u5r2d1l1u1l1d4u4l2d5r6l4u4r3d2l2r2u2l3d3u4l2d5r5l3u4r2d1l1u1l1d3u4l2d5r4l2u3r3d1l2u1l1d2u4l2d5r3l1u4r4u1l3r3u2l4d6u4l2d5r2

