;1
##############################################
#                                            #
#                #$#          $ $  $ ##### $ #
#    $    $ $ $  # #   $  $ $ #.    .#  .#   #
# $$# $$########## #   ####   ######## $ #$  #
#   $       #.     ##$  ..# $   $        # $ #
#   #   $   #  $    #  $ .#   $    $  $ .#   #
#  $# $ # $ # $#$   #   $ #$  ############   #
# $ #   $   #       #$  $ #   #    $  $  $ $ #
#  $#$      #  $   ##  $  #  $# $            #
#   #  ###### $# ###  $ $ #   #     $ $     $#
#  $# $           $      .# $ ###$  #####....#
# $ #   $ $        $    ..#     #   #...#....#
#   #########.+.###########$  $ #$  #...######
#   $   $   #####  $ $      $ $ #  $#........#
# $   $                $ $      #$  #......#.#
# #$     $$  #$ $#$  ############   #........#
# $  $ $.#                         $#...#....#
#   ###### $ #######.   #######.....#........#
#   $    $    $ $  ######.   .#######........#
# $    $   $      $        $        .......#.#
#                                   .........#
##############################################
Solution: u2l5d1r3u1r1d1l1u1l5d1r6u1r1d1r5u1r2d1l5u1l1d1l2u4r1u2d2r3u3l3d3l1d4r12u3l1d2l1d1r1l3u3r1u2l1d3l1r1d1l1d1r3l6u1r7u1l1d1l2u4r2u1l1u1r2l1d3r1u2d3r1u2d1l3u6r3u1r4d1r1u1r1d1u1r4d1l1d1r1u2l6d4r2d1r2u1r3d1r3u2l1u1r1d2l5d1l3u1l2d1l1d4l1d2r2d3l3u1l4d1l12d1l1u1l2d1r1l2d1r1u2r4d2r1d3r3d1r10u1r3d1r1u1l2d1l10u1r7d1r1u1d1l15u1r31d1r1u6l1u1r2l6d7l31u1r35d1r1u4d1l3u2r4d1r1u1l7d5l36u1r40d1r1u6l1u1r1d7l30u4l1d2l1d1r31d1r1u4l1u1r2l1d5l27u2l2d1l2u2r1d1l1d1r30d1r1u1l1u1r2u1r1d1l7d2l20u2l4d1l2u2r1d1l1d1r30d1r1u3l1u1r2l1d3l34u1r2u1r1d1l1d1r31d1r1u2l1u1r2l1d2l30u4l2d3l1d1r32d1r1u1l1u1r2l1d1l36u1l2d1l2u2r1d1l1d1r39d1r1u6d5l32r1u5l3d1r2u1r1d4l1d1r31d1r1u4d1l3u2r3d4l30u4l8u1l1d4l1d1r39d1r1u3l1u1r1d4l41u6r1u1r1d5l1d1r39d1r1u2l1u1r1d2l41u3r1l1u2r2d4l1d1r39d1r1u1l1u1r1l1d1l30u5l4d2l3u1l1d3l1d1r39d1r1u5d4l30u5r2d1r1d1l3u1l1d3l1d1r31d1r1u4d3l31u5r7d1r1d1l7u1l1d3l1d1r31d1r1u3d2l30u5r4d1u1r2d2l6u1l1d3l1d1r31d1r1u2d1l30u3l1u1l1u1l3u1l1d2r1d1l3u1l1d3l1d1r39d1r1u1l41u9r1d3l1d1r1u1r1d5l1d1r37d1r1u2r1u1l1d1l1u4l1u1r1l1d7u1l35u5l1u5r1d8l1d1r8u1r1d1l1d1r28d1r1u5l1u1r1d6l38u14r1d7l1d1r1u1r1d5l1d1r36d1r1u4l1u1r1l1d5l35u4r2u2l1r1u1l1d1l2u2r1d6l1d1r38d1r1u6d6u1l30u6l7d1l2u2r1d6l1d1r39l40u12r2d11l1d1r38d1r1u5d4l40u14r2d12l1r1d1l1d1r38d1r1u4d3l40u19r2d18l1d1r38d1r1u3d2l40u16r1u1r1d16l1d1r38d1r1u2d1l40u18r5d1l2u1l1d17l1d1r36d1r1u8d7l38u19r4d4l1r1u2l2d16l1d1r38d1r1u1l40u19r5d3l1d2r2u1l3r1u2l2d16l1d1r38l39u15r6d3l1u2r1u1l3r1u2l2d16l1d1r37d1r1u2d1l39u14r2u1r3d5l1u4r1u1l2r1u2l2d16l1d1r37d1r1u1l39u17r4d2r4d1l3d1l1u1r1u1l2r1u2l2d16l1d1r37l38u19r6d3l1d2r2u1l4r1u2l2d16l1d1r36d1r1u7d6l38u19r10d2l7u1l1d17l1d1r36d1r1u6d5l38u15r10d3l1u2r1u1l7r1u2l2d16l1d1r36d1r1u5d4l38u18d3r10d2l1d1l4d1l1u3r1u1l2r1u2l2d15l1d1u1r1d1l1d1r36d1r1u4d3l27u5l1u1l10u9r4d7r1u6r1u1l3r1u2l2d16l1d1r36d1r1u3d2l27u4l1u2l8u13r10d2l9u1l1d17l1d1r36d1r1u2d1l37r1u19r12d2l11u1l1d16l1r1d1l1d1r36d1r1u1l38u19r7l2d10r7u2r1d1l1d2r2u1l9d1l1u6r1u1l2r1u2l2d16l1d1r36l37u18r5d10r10u3l2u1l1d2r1d1l8d1l1u6r1u1l3r2u2l4d2r1u1r1d15l1d1r35d1r1u8d8u1l37u15r4d7r11u3r1u3l1d2r1d1l3u1l1d2r1d1l8d1l1u6r1u1l2r1u2l2d15l1d1u1r1d1l1d1r35d1r1u7d6l37u16d1r5d7r9l1u6r1u1r1d3r1d1l3u1l1d2r1d1l8d1l1u6r1u1l2r1u2l2d16l1d1r35d1r1u6d5l37u19r17d5r1d1l2u1l1d2r1d1l3u1l1d2r1d1l8d1l1u6r1u1l2r1u2l2d16l1d1r35d1r1u5d4l35u5r19u1r2d1l20u1l1d4l1r1d1l1d1r35d1r1u4d3l26u3r6u2r5u1r3d1l22u1l1d5l1d1r35d1r1u3d2l27u5r18u2l1d1r1d1l25u1l1d5l1d1r35d1r1u2d1l27u5r20u2l1d1r1d1l20u1l1d5l1d1r28d1r1u1l26u5r19u3l2d2r1d1l19u1l1d5l1d1r28l26u5r17u3l1d2r1d1l17u1l1d5l1d1r27d1r1u8d7l25u5r15u5r1d4r1d1l18u1l1d5l1d1r27d1r1u7d6l25u5r8u1r7u1r1d1r1d1l18u1l1d5l1d1r27d1r1u6d5l25u3r2u2r3u1r10u1r1d1r1d1l18u1l1d5l1d1r27d1r1u5d4l27u3r4u2r13u2r1u5r1d6r1d1l9u1l1d3u2r8u9l1d8r1d1l17u1l1d5l1d1r27d1r1u4d3l26u5r20u2l4u9r1d10r1d1l18u1l1d5l1d1r27d1r1u3d2l26u5r17l1u14r1d13r1d1l18u1l1d5l1d1r27d1r1u2d1l25u5r15u14l2d2r1u1r1d12r1d1l17u1l1d5l1d1r27d1r1u1l25u5r16u14l6d2r4u1r1d12r1d1l17u1l1d5l1d1r27l24u5r15u12l5d3l1u2l1u1r6u1r1d12r1d1l17u1l1d5l1d1r26l24u3r10l1u2r7u12l6d8r1u7l1u1r5u1r1d12r1d1l17u1l1d6l1d1r34l32u4r8u3r8u11l5d7r1u1r1u1l1d1l1u5l1u1r5u1r1d12r1d1l17u1l1d6l1d1r33l31u6r17u10r3d1l3u1l1d9r1d1l17u1l1d6l1d1r32l31u6r17u9r6u1l5u1l1d10r1d1l17u1l1d6l1d1r31l28u6r17u10r8d1l9u1l1d9r1d1l17u1l1d6l1d1r30l29u6r17u14r6d1l5u1l1d13r1d1l17u1l1d6l1d1r29l26u6r14u1r1u12d13l7d2r14u3l1d2r1d1l23u1l1d4l1d1r28l25u4r22u5l1d4r1d1l23u1l1d4l1d1r27l24u4r21u1r1u6l1d6r1d1l23u1l1d4l1d1r26l28r3u6r9d2r14u1r2d1l1u9l2d1l1d1r1u1r1d8r1d1l2r2u9r3d1l3u1l1d8r1d1l1r1u2r1u5l1u2r2d1l2u1l1d8u8r6d1l4u1l1d8u8r10d2u4l1d4u2r1u5l1d6r1d1l2u1l1d1u1r2u7l1d8u9r1u1r1d9l4u2r1d1r2u2l1d3r1d1l1u1l5u2r4d1r2u2l1d3l8u2r8u1r1d3

;2
##################################################
#@                                              .#
#                 $      $   $   $   $  $  $ $ $.#
#  #### $ $ $  $  $    $ $ $   $   $  $  $ $ $ $.#
#  #. # ...... #####   ####   ###########  #######
#  # $##########   #$ $# .# $     $    .# $#.....#
#      $  $   $  $ #   #$ #    $     $  #  #.....#
#    $      $   $ .#$ ##  # $ #######   # $#.....#
#   ################  #  $#        .# $ #  #.....#
# $$#.$    $    $ $   #$  #$ $ $$ $ #   #$ #...*.#
#   #  $ $ $ $$ $   $ #   #    $ $  #$$ #  #.....#
# $$# $  $   $    $   #  $# $  $ $$ #   # $#.....#
#   #.   ##############$  #       $.#   #  #.*...#
#  $######  $   $ $  $    #$  #######$$ #  #.....#
#    $  $ $ $ $   $$ $ $  # $ #. $ $  $ # $#.....#
#             $          .#$  #$ $      #  #.....#
#  $#######################  $#    $ $ .#$ #...*.#
#   #.    $          $    $   # $ #######  #.....#
# $$# $ $$  $  $ $   $   $  $ #   #.$   $  #.....#
# $ #  $   $ $ $   $   $     .#$ $#  $$  $ #.....#
#   # $$ ####### $ ############   #.       #..*..#
#  $#.   #. $ .#   #.   $       $ ##########.....#
#   ######  $  # $ # $$  $ $ $  $ #..............#
#   $  $ $ $ $ #.  #.            .#........*....*#
# $   $$ $ $   ####################..............#
#      $    $  $ $  $  $    $  $ $ ...........*..#
#   $      $    $   $$  $ $ $ $  $ .......*......#
#   $    $   $    $             $  ..............#
##################################################
Solution: undefined

;3
############################################################
#                                                          #
#       $   $           $    $     $  $ $  $     $  $   $  #
#    $  $ $ $  $  $  $  $  $  $  $ $         $          $  #
#  $########      $$######  $  $ #### $   $   $ $####  $ $ #
#   #      ###$$    #....#$ $$ $ #..##  $ $ $    #..##     #
#  $# $$$$ $ #   $$##....#       #...#$  $  $ $ $# ..##  $ #
#   #        #$    #.....# #######...#  $ $$     #....##   #
#  $# $ $$ ###   $ #.....###.........##     $$  ## ....# $ #
#   # $    #  $   ##................*.#  $$$    #......# $ #
#  $#  $ $ #$   $ #...*...............##  $  $ $#......#   #
#   #  $  ## $   ##.........*....*.....#$       #......#$  #
#        ## $  $##.....................# $ $$  $#......#   #
#    $ $ #      #.........*............#  $     #......# $ #
#   $   ##$$$  $#............*..*......# $  $ $ #......# $ #
#    $###     $ #......................#   $    #......#   #
#     #   $    $#######................# $ $ $  #......#   #
#   ### $ $$$ $ $ $   ##...............#   $   $#.....## $ #
#  $# $             $  ##             ##  $ $   #.....#    #
#   #   $ $  $ $$$ $ $$ ###           # $    $ ##     # $  #
#   #########$          $ ##   $     ##   $$   #     ##    #
#     $   $ #  $ $ $  $    ##      $ # $$     ##    $# $ $ #
#   $   $   ######## $   $  #  $     #   $$ $ #  $   #     #
#           $ $  $ ##  $  $ #        #$      ##  $  ## $ $ #
####### $ $  $    $ # $  $ $#     $ ## $   $ #      #      #
#.....#  $$$   $$   ## $ $  #  $    #  $ $ ###    $ # $$ $ #
#.....###    $$  $ $ #     $##     ## $   ##    $   # $    #
#.......#### $ $     ## $ $  #   $ #  $  ##        ## $$ $ #
#          #   $ $ $  #     $#     # $  ##    $    # $     #
#  $       ##   $$    ## $   #    ## $ $#   $      # $ $ $ #
#       $$  ###  $$ $  ##  $ ##   #  $  #        $##       #
#  $$         ##  $   $ ##$   #$$$#$   ## $  $    #   $    #
# $   $  $$    #    $    #  $ #   #   ##          # $ $ $$ #
#         $    ##     $$ # $  #   # @$#           # $      #
#      $        ####     #    #   #...#     $   $ #        #
#  $        $      ############     #    $   $    ##########
#     $  $  $                     $                 $      #
#              $    $  $  $   $         $     $  $      $  #
#                                                          #
############################################################
Solution: undefined

;4
#################################################################
#....................#                                          #
#................ ..##$ $ $ $$    $   $ $ $ $   $  $   $ $$  $$ #
#..................##   $ $ $  $$ $  $  $  $ $ $  $$$ $ $   $$  #
#.................## $ $$ #####$ $ $$ $   $  $  $  $    $  ##  $#
#................## $    #....#          $  $  $  ###########$$ #
#...............##    $ #.....######$  $ $   $ $$ #.............#
#..............## $ $  #......#....# $$ $  $ $ $  #.............#
#.............##      #.......##...#      $  $  $ #.............#
#............##  $ $ #.........#...#$ $ $ ##########............#
#............#  $   #..........#...# $ $$ #........##...........#
#....#########$$ $ #...........#...#      #        .#...........#
#....#   $            $     $###...######## $ $$ $ $#...........#
#....# $     $   $  $ $ $ $  #  $  $ $ $ .#   $  $  ##..........#
#....# $ $$   $$ $ $    $$$$$# $$     $  .#$ $$$ $$  ###........#
#....#  $$ $$  $  $  ##$ $   # $   $ $   .#   $  $  $$ #........#
#....#.    $  $  $    #  $ $ # $$$ $ $ $ .#  $  $ $    #........#
#....##### $$ $ $  $$ # $ $  #   $    $  .##        $  ##########
#        #  $  $    $ # $ $ $# $   $    $  ########  $          #
#        #$$ $ $ $$ $ # $ $  # $$ $$ $ $ $$ $  $  # $  $ $ $ $  #
#        #    $$ $ $ ## $ $ $ #$   $$$    $      $#             #
# $      #$$ $$ $$  # $       # #$ $    $  $ $ $  ########### $ #
#   ###### $       # $ $ $$ $$  # #$ $ $  $   $   $  $ $ $  #   #
#   ##   $    $$$ # $  $  $ $     # ########### $    $ $  $ #$  #
#   # $$   $$    #     $ $$ $ $ $    $   $   $     $$$  $   #   #
#   #   $ $ $ $ #  $ $   $    $   $    $   $   $    $ $   $ # $ #
#   # $$ $  $  #  $  $ $    $   $   $ $  $   $   $      $   #   #
#   #    $$   $######### $ ############$#$#$# #$############# $ #
# $ # $ $ $  $  $ $  $.#   #.$   $  $     $     $ $ $   $       #
#   #  $$ $$ $ $ $  $ .#$  #   $ $   $ $    $ $     $ $ $$ $    #
#   #.               $.#   #.$  $  $  $ $ $ $    $    $     $ $ #
#   ####################$ $########.......###################   #
#   #                             #########                 #$  #
#   #  $  $  $  $  $  $  $  $  $  $ @$ $  $  $  $  $  $  $  #   #
# $ #                                                       #$  #
#   ####        #############################################   #
#      ##########                                             $ #
#  $    $    $    $   $    $   $   $   $     $     $   $   $    #
#                                                               #
#################################################################
Solution: undefined

;5
##########################################################################
#                                                               #  .....+#
#  $  $  $$  $ $ $ $   $ $   $  $  $  $ $  $ $   $ $$   $  $ $$ #$ ......#
# $  $  $   $   $$ $  $  $  $#######    $  $  $  $   $ $  $  $  # $......#
#   #############  $#######  #.$  .# $######################$   #$ ......#
# $$#.       $ .#$  #.....#$ # $ $ #  # $ $ $ $  $   ......#  $ # $......#
#   #   $ $$  $ #  $#.....#  #  $$ #  # $ $ $      $ ......# $  #$ ......#
# $$# $ $    $  #$  #.....# $#$$   #$ #        $# $  ......# $$ # $......#
# $ #  $  $ $  .#  $#.....#  #    $#  # $  $$$    $$ ......#$   #$ ......#
#   # $##########   #.....#$ ###   # $#  $$$  # $$ $ #######  $ # $......#
#  $#  #........$ $ #  $###   .# $ #  # $$   $  $  $ # $  $ $$$ #$ ......#
# $ #$ #........  $$#$  #.  $ $#$  #$ #   $ $$$  $   # $$       #  ......#
#   #  #........$   # $ # $    #  $#  # $$    $$ $#  #    #######$ ......#
# $$# $#########  $ # $ # $$ $ #$  #  #    $$  $  $ $#$$ $#......  #######
#   #  $  $ $  #$$  #   #$    .# $ # $# $$   $       #    #......$ #
# $ #   $     $#   $# $ #   $###$  #  #  $############$ $ #......  #
# $$#$$ $  $$  # $$ #$  # $  #  $ $#$ # $ #........... $  #......$ #
#   #.    $    #   $# $ # $ $#$ $  #  # $ #...........  $ #......  #
# $ ########$ $#$$  # $ # $  #  $ $# $#   #...........    #......$ #
#    $ $  .#   # $  #   #$$ $#$ $  #  # $$#######################  .#
#  $    $$ # $ #   $#  $#    #  $$ #$ #  $ $ $   $ $  $   $  $ .#$ ..#
# $$ $$    #  $# $$ # $ #  $$# $$  #  #        $     $  $       # $...#
#     $  $.#$  #    # $ #  $ #    $# $#   $  $  $  $   $  $  $ $#$ ....#
#  #########  $######   # $$ #$$$  #  ######################$   # $.....#
# $# $  $ $ $  $  $ $ $$# $  #   $ #   $ $  $ $  $     $  .#  $$#$ ......#
#  #          $    $  $ # $ $#  $  #$    $  $      $$ $  $ #    # $......#
# $# $ $ $ $     $      #    #$  $ #   $  $   $  $   $   $ #$$ $#$ ......#
#  #  $ #####  $#####$ $#  $$# $ $$# $ $    $  $ $ $ $ $   #    # $......#
# $#$  $#...#$  #...#   # $  # $   # $ $ $  ######## $ $$$ # $$ #$ ......#
#  # $  #...#  $#...#  $#  $ #   $ #$ $$ $$$#......#  $    #    # $......#
# $#  $ #...#$  #...#   #.  .# $  $#        #......#    $ .#$$  #$ ......#
#  # $  #...# $ #...#$ $######$    ##########......#########   $# $......#
# $#   $#...#$  #...# $ $ $ $   $ $ $ $   $   $ $ $ $   $ $  $  #$ ......#
#  #  $ #...# $ #...#$   $ $  $$   $    $ $ $  $  $   $   $    $# $.....#
#  #.  .#...#   #...#  $     $   $   $ $     $   $   $  $   $ $ #$ ....#
# $######...#####...#########################################  $# $...#
#   $ $ $ $ $ $ $ $ $ $ $ $ $ $ $ $ $ $ $ $ $ $ $ $ $ $ $ $ $   #$ ..#
#  ...........................................................     .#
#  ...........................................................     #
###################################################################
Solution: undefined

;6
############################################################################################
#                                                                                          #
#                                                                                          #
#   #####  $ $ $#####                                           $                          #
#   #....#  $$  #.  ##   $  $  $  $  #.       .#   ##############  $$    #   #         # $ #
#   #.....#  $$ #$   ##    $$  $ $   ##       ##...#        #...##  $ $ $#    #       #  $ #
#   #......#    #  $  ##  $   $      #.#     #.#...# $ $$ $ #...# # $ $$ # $ $ #     #  $  #
#   #.......#  $#$ $$  ##    $ $ $$  #  #   #  #...# $$$  $ #...#  #  $  #      #   #  $$  #
#   #........#  #    $  ##  $  $  $ $#   # #  $#...#$$ $$$$ #...#$  #  $ #  $ $  #.#  $  $ #
#   #.........### $$ $ $ ##    $     #$$  #  $ #...# $      #...# $  #   #     $  #   $$ $ #
#   #    $  $  $          ##     $$  #   $     #...#  $ $$ $#...#    #$$ # $    $ # $ $    #
#   # $  $ $ $   $$  $$$$  ##        #   $$$  $#...# $  $  .#...# $$$#   #    $   # $$ $$  #
#   #$$ $$$  $$ $ $  $ $    ########## $ $  $  #...#   ######...#    # $$#   $    #$  $$ $ #
#   #   $ $$  $   $$$$ $$ $    $ $ $ #  $ $   $#...# $  $ $ #...#$ $ #   #$ $    $# $      #
#   #$    $   $$   $    $$$$$   $ $  # $  $$$  #...#$  $$   #...#   $ $ $#     $  # $$$$   #
#   #  $ $  $     $$$$  $     $  $  $#  $      #...#    $ $$#...#$$ $#   #        #    $$$ #
#   #$  ###### $   $ $$ $$$$$$$ $    #$ $$$$$ $#...#$ $$$   #...#     #  #........# $$  $  #
#   # $ #....#$   $$  $ $   $      $$#  $      #...#    $ $ #...#$$ $$ # #........#$   $   #
#   # $ #....# $   $  $   $   $  $   #  $$$ $$$#...# $ $$ $$#...# $  $  ##........#  $ $$  #
#   #   #....#     $  $ $#########  $#$   $  $ #####        #   # $$ $$  ########## $   $$ #
#   #####....##### $     #.......#$              $ $     $                           $   $ #
#      $         #   $  $#.......#     $   $  $      $ $  $   $$  $   $$   $  $ $ $     $  #
#       $$   $ $ # $     #.......# $ $   $                  $         $  $  $        $   $ #
#    $     $     #  ######.......##########  $ $$  ####   $ # $ $   #   #######$  $  #   $ #
#   #################       $        #.   .#      #.  .#     #     #  $$#.   $  $  ##.##   #
#   #          $....#  $  $    $  $  # $$   # $  #  $$  # $$$ #   # $   # $$      #     #  #
#   #  $     $  ....#$               #   $ $ #   # $    #      # #  $ $ #  $ $$$ #.$ $ $ $ #
#   #  $   $$$  ....#  $$   $$   $$  #$ $    # $ # $ $ $# $$$   #  $$ $$# $ $    #.  $$    #
#   #   $$      .#### $  $ $  $ $  $ #  $   #    # $$   $   $$  # $ $ $ #  $ $$ $#. $ $$$$ #
#   # $  $  $$  .#    $    $  $ $  $ $   $ #   $ #  $  $# $   $ #       # $       #    $   #
#   #  $ $$  $  .#    $$$  $@ $ $  $  #####      #  $   ###$#################$  $  ###  $  #
#   #  $   $  ####$   $  $ $  $ $  $  $    #  $ $# $    # $   $ #       #   $ $ $     #  $ #
#   #$  $     #    $  $  $ $  $ $  $ #  $   #    # $  $ #    $  # $ $$  # $       $ $  #   #
#   #     $   # $$     $$   $$   $$  #  $ $  ##### $ $$ #$   $  #  $  $ #  $$$$ #  $    #  #
#   #$    $####  $ $                 #$$ $   #   #  $$ $#  $$  # #   $$ #  $    # $$$   #  #
#   #  $$  #  $ $ $   $ $  $  $  $ $ #   $  #  $ #  $   #$ $  #   # $$  # $ $$ $ #   $ #   #
#   # $    #        $    $   $  $  $ #.   .# $    #.  .#     #  $  #  $ #.        #   ## $ #
#   # $ ##########################   ######  $ $ $ #### $  $#  $$ $ #   ##############  $  #
#   # $ #.........................                                                         #
#       #.........................                     $                                   #
#       #.........................                                                         #
#########............................#######################################################
#..........................................................................................#
#..........................................................................................#
#..........................................................................................#
############################################################################################
Solution: undefined

