;1
########
#  *@  #
#  $.  #
###  ###
  #  #
  ####
Solution: l1d1,1-1r3,3-4u1,2-2r1,4-1d1,6-1l2,4-4u1

;2
 #####
 #   ##
##  @ #
# $#. #
# $ .##
#    #
######
Solution: d3l3u1r2d1r1u2r1u1l1u1l2d2l1d1r2l1u3d1r1u1r1d1

;3
  ####
  #  ###
###$.@ #
#   #  #
#  $. ##
#  #  #
####  #
   ####
Solution: 4-4l1,3-1d2,2-5u1r2,5-3d1,1-3r1,3-2d1,4-4l1,5-6u3,6-2l1,1-4r2

;4
 #####
##   #
#    #
#  ###
#.$$.#
#@ # #
##   #
 #####
Solution: 2-5u2,1-2r1,4-4l2,1-5u1,4-2l1,2-1d3,2-6u1,1-4r2,1-2d1

;5
 ######
 #    #
##$ . #
#    ##
# $#. #
#@ #  #
####  #
   ####
Solution: 2-5u1,1-3r2,4-2d2,2-1d2,4-6u3,5-2l1,2-5u1,1-3r2,4-2d1,2-2r1

;6
 #####
 #   #
##$#.##
#  @  #
#  #  #
##$ . #
 #  ###
 ####
Solution: 2-6u2,1-3r1,2-1d3,2-3r1,4-2d1,2-6u3,2-1d2,2-5u1,1-3r1,4-3d1,5-5l1,2-3r1,4-1d2,4-5u2,2-5r1

;7
####
#  #
# @#
#.$#####
#      #
#.$# # #
#  #   #
########
Solution: 2-6u1,1-4r3,2-4u1,6-4l4,1-3d1,2-1d2,1-4r3,1-6u3,6-4l4,1-3d1,1-1d1

;8
 ####
 #  ###
##    #
# $.  #
# @# ##
##$ .#
 #  ##
 ####
Solution: l1u1r1,2-6u3r1,2-1d2,5-3l1,2-5u2r1,4-4u1,2-1d2,2-5u1,1-3r1,5-2l1,2-3r1,3-1d1,4-2d2

;9
######
#    #
#  . #
##$# #
 # . ##
 #$   #
 #@   #
 ######
Solution: 2-4u1,1-2r2,4-1d3,2-6u3,1-2r1,5-5l1,3-6u1

;10
########
#   #  #
#  .   #
##$##  #
# @.#  #
# $    #
#####  #
    ####
Solution: 2-4u1,1-2r3,5-1d1,1-5r3,5-4u1,6-2l3,2-1d2,5-6u3,6-2l2,1-4r1

;11
   ####
####  ##
# .    #
# $#   #
#  # ###
##$.@ #
 #    #
 ######
Solution: 2-4u1,1-2r3,5-1d1,2-6u2,6-3l1,4-2d2,5-5l1,2-4u1

;12
 ####
##  #
# . ###
# $   ##
# $#   #
# .@ # #
####   #
   #####
Solution: l2u2r1l1d2r1u2l1u1r1d3r2u2l1r1d2l3u3r1d2l1d1r2l1u2r3d1r1d2l2u1l2u4r1d1l1d3r2d1r2u2l1u1l2u1l1d2u1r3d1r1d2l2u2r1u1l2u1l2d2r1u1

;13
 ####
 #  #
 #  ####
##$$.. #
#   @# #
#  #   #
#  #####
####
Solution: l2u1r1u2l1d3r2d1r2u2l2d1l1u1l1d1l1d2r1u1l1u1r2u1r3d2l2u1l1u1r1l2u2r1d1l1d1r1

;14
  #####
###   #
# ..$$#
# @#  ##
#  #   #
####   #
   #####
Solution: u1r1u1r2d2u1l2r1d3r2u1l1d1l1u2r1u1l1

;15
 #####
##   ##
#  #  #
# .$$.#
#### @#
   #  #
   #  #
   ####
Solution: u2l1d1u2l2d2u2r2d3u3l2d2r2d1r1d2l1u3l2u2r2d1r1d1l2r1d2r1u1

;16
     ####
######  #
#       #
#  #    #
##$..$###
 # @  #
 ######
Solution: l1u2l1u1r4l1d1r3u1l3d3r1u1l1u2r2d1l1u1d2l3u2r3l1d1r1d1l1r1u1r2u2l1d1r1d1l2u1l1d1

;17
 #####
 #   ###
 #   $ #
#### # ##
#    *  #
# # #.@ #
#   #####
#####
Solution: r1l1u3l2r2d2l3r1u3l2r2d3l1d2l2u2r4l1u2r2d2r1d1l1u3l2u1l2d1r1u1r1d2u1r2d2l3d2l2u2r3

;18
  ####
  #  #
  #  ###
  #  $ #
#### # ##
#    *  #
# # #.@ #
#   #####
#####
Solution: u1l3r3u2l1r1d2l2u2l1u2d2r1d2l1d2l2u2r4l1u2r2d2r1d1l1u3l3u2r1d3u1r2d2l3d2l2u2r3

;19
   ####
####  #
#  #  #
#  .$ ##
#   #  #
###$.@ #
  #  ###
  ####
Solution: l1d1l1u1d1r1u1r1u2l2r2d2l2u1l2u2r1d1r2l1d2r2u2l4d1r1u1r3d2l2u1d1r2u2l1u2r1d3r1d1l1

;20
#####
#   ##
# #  #
#  .$###
## #   #
#  $.@ #
#   #  #
########
Solution: l2d1l2u1d1r2l2u1r3l2u2r1u1r1d2r2d2l1u1l2d1l2r2l1u2d1r2u3l1u1l2d2r1l1u2r2d1r1d3r2u1l1d1l3u2l1u2r2d1r1d2

;21
####
#  ####
# ..  #
# .@$ #
## $$ #
 ###  #
   ####
Solution: u1r2d1l2r2d2l1u2l1u1l2d1r1d1r1l1u2r1d1r2u1l2r2d3l1u2l2d1r1u2d1r2d2l1u1r1u1l2r2u1l1

;22
#####
#.. ###
#.@$  #
# $$  #
#  #  #
#######
Solution: l1d2r1u1r1l2u2r1l1d2r1l1u2r2d1l1r3d2u2l3d1l1u1r4d2l1u1l2d1l1u1r4u1l2d1l1u1

;23
####
#  #####
#      #
#  ##  #
##$..$##
#  @  #
#  #  #
#  ####
####
Solution: l1u2l1u2r1d4r1u1l1u2r3l3d2r2d1r1u2r1u1l3r3d1l1d1l3d1l1d2r1u1l1u1r2u1l1u1l1u2r1d4u1r3d2l1u1r1u1l1d1l3d2r1u1l1u1r2l1u3r3d4l1u1

;24
    #####
 ####   #
 #.  .  #
## # # ##
#@ # # #
# $  $ #
####  ##
   ####
Solution: d1u1r1u2r5l1d3l1d1l1u1r2l2u1d1r2u3l4d2l1d1r3l1r1u2d2l2u3r3u1r2d1l1d3l2u3r1u1r1d1l4r2d3r2u2d2l2u3l2d3r1l1u3r3u1r2d1l1d3l1d1l1u1l2u3r3u1r1d1l4d3r2u2d2l3u1r1u2r3u1r2d1l4r1d4r1u1r1u2d2l2u3r1u1r2d1l1

;25
 #######
## @   #
# $    #
# .$####
##. #
 #  #
 ####
Solution: r1l1d2l2u1r3l2d3r1u2l1u2r2d1l1u1l1d2u2r4d1l3u1l1d1

;26
  #####
  #   #
### # #
# $$.@#
# .  ##
##  ##
 #  #
 ####
Solution: l1r1u2l2d3l2u1r1d1r1u1l1d3r1u1l1u2r2d1l1u1l1d1r2u1r1u2l2d1u1r2d2l1d1l2u1r1d3l1u1

;27
 ####
 # @#####
 #  ##  #
 #.  .  #
### ##  #
# $  $ ##
#   ####
#####
Solution: d5l2u1r1d1r1u3r3d2l3u2l1u2r1d1l1d1r1d2r3l3u2r2l2d2r3u1r1l1d1l3d1l2u1r1d1r1u2d1r3u1r1u2l1d1l3d2r3u1r1u1l1

;28
   ####
####  #
#  . $#
#  $@.##
####   #
   # # #
   #   #
   #####
Solution: undefined

;29
####
#. ###
#.  @#
# # $##
# $   #
###   #
  #####
Solution: l3d2u2r3d1l1d2r2u1l1d1l1u1r1u2l3d2r2u1d2r2u1d1l2u2r1u1l2r1d2l2u2d2r2d1r2u1l1d1l1u2r1u1l2

;30
####
#  ####
#  #  #
#  . $##
## $ .@#
 ### # #
  #    #
  #   ##
  #####
Solution: l2u2r1d1l3r2d3r2u2l1u1l1d1r2l1u1l3d1u1r2d2u2d1r2d2l1d1l2u1r1u3l2d1r1u1r1d1r2d2l1d1l2u1r1u2r1u1l2d1l1u1r2d2u1r2d2l1d1l1u2d1r2u2l1u1l2d1r1l2u1l1u2r1d1l1d1r1

;31
#####
#   #####
# .  $  #
##$##.@ #
#     ###
#     #
#######
Solution: u1l3u1l2d1r4l3d1u1r3d3l4u1r2d1r2u2r2u1l4r2d3l2u1r1d1r1u1

;32
#####
#   #
# # ###
#  $$ #
###+# #
#   . #
# # ###
#   #
#####
Solution: u1l2u2r2d4r2u2l1r1d2l2u2d2l2d2r2u1d1l2u2r2u2l2u2r2d2

;33
  #####
###   #
#   # #
#  $$ #
### .@##
  # .  #
  #    #
  ######
Solution: u3l2d3r2u1l2u1l2d1r2d1r1d2l1u2r2u3l2d3u1r1l1u2r2d3l1d2l1u2r1u1r1u2l2d1l1d1r2l1u2r2d2l1d3r2u1l1d1l2u3r2d1l2d2r1u1d1r2u1l1

;34
 #####
 #   #
 # # #
 #   #
 ### ##
## $$ #
# ..@ #
#   ###
###   #
  # # #
  #   #
  #####
Solution: r1u1d1l1u3l2u2r2d4r1d1l2d1l2u1r1u1r1d3u2r1u3d3l1d2r2d2l2u3l1u2r2d1l1r1u3l2u2r2d4r1d1l1

;35
   ####
   #  #
####  #
#  $$ #
# ..@###
#      #
#  #   #
########
Solution: u1l1r2u2l1d3l1d1r1l3u2r2d1r1u1d3r2u1l3u2l2d3r1u1l1u1r1u1r3u2l1d3u1l2d2r2d1r2u1l3r1u2l3d3r1u1

;36
   ####
   #  ##
####   #
#  $$  #
# ..@###
# #   #
#     #
#######
Solution: u1l1r2u2l1d3l3u1r2d1r1u1l1d3r2u1l1d1l1u1r1u1l1r1u1r1u2l1d3l1d2r2u1l1d1l1u1

;37
    #####
#####   #
#  ## # #
# . $$@.#
#   #   #
# # #####
#   #
#####
Solution: d1l1u1l2d3l2u4r1d1r5u2l2d1u1r2d2l4d3l2u3r5d1r1u1l6d1r1l1d2r2u2l1u1r3d1r2u1l4r2u2r2d1

;38
 ########
##  #   #
# . $$@.#
#   # # #
# # #   #
#   #####
#####
Solution: u1l1d1l2u1l1d1l1d1r1u1r1l2d3r2u2l1u1r3u1r2d1l4r3l3r4l4d2u1l2u1r1u1r1d2u1r4d2l2u1d1r2u2l4d1l1r1u2l1r1d1u1l1d1l1d3r2u2d2l2u3r5u1r1d1l6d1r1l1d2r2u2l1u1r3u1r2d1l4r2d2r2u1

;39
#########
#  ##   #
#+$##   #
#      ##
# #### ##
#  ###  #
#  #    #
#  #   ##
########
Solution: u1r1d1l1d1r4u1r1d3r1d1l1d1l2u1r1d1r1u4l1u2r2d1l1u1l1d1r1d1l4u1l1d3r1d2l1u4

;40
########
#   #  ##
#       #
### #.  #
 ##$$.@##
 #  ####
 #    #
 #    #
 ######
Solution: u1l1u1l2d3l1d1r1u4r2d2l1r1u2l2d3l1d2r1u4d1r2u2l2u1l2d1r4d1r2l2d1l2d3r2u1l1d1l1u4d1r2u2l2r2u1r1d1l3u1l2d1u1r2d1r4d1l1u1l1d1u1l2u1l2d1r4u1r1d1r1d1l1

;41
  ######
  #    #
###    #
#   #.##
#  $$.#
##   @#
 ######
Solution: l2u1d1r2u1l2r2u2l2d1u2r2d4l3u1r2d1r1u2d1l2u3r3d1l1u1l2d3l2u1r1d1r3u3l2d2l1d1r2l1u2r1u1r1d1

;42
    ####
#####  #
#      #
#   #. #
## $$.@#
 #   ###
 #####
Solution: u2l4d3r1u1l1u2r4d2l3u1l1u1r2l1d2r3u3l1d1l2d3l1u1r1u2l2d1r1u1r1d1l1d1r2

;43
########
#   #  #
#      #
# # #. #
#  $$.@#
###  ###
  #  #
  ####
Solution: l1u2l2d2r1d2l1u2l2u2r5d2l3u1d1r3u2l3u1l2d1r3l1d2r3u3l1d1l4d2r3

;44
#######
#     ##
#      #
## ##  #
 #$.$.@#
 #  #  #
 #  ####
 ####
Solution: u2l4d2r1d2l1r1u2r1l2u3r3d1r1d3l1u1l2d2l1u3d1r4u2l2u1l3d1r2u1r2d2r1d1l2r1u3l2d1r1u1r1d2

;45
#####
#   ###
#     #
###$* #
#  @.##
# #  #
#    #
######
Solution: r1u1r1u1l2d1r1d3u2l1u3l2d1r1u1r1d3r1d2l3u2r2l2d2r2u1r1u1d2l3u2r2

;46
#####
#   ##
#    ##
###$* #
 ## .@#
 #    #
 #   ##
 #####
Solution: l2u1d1r2u1l1u1l1d2r1d2l2u1r1d1r1u1l1u4l2d1r1u1r1d3u1r2d2l1u1d2l2u1r1d1r1u1

;47
#####
#   ##
#    ##
###$* ##
### .@ #
#      #
#   #  #
########
Solution: l2u1d1r2u1l1u1l1d2r1d1l1d1l2u1r3u1r2d2l1u1l1u3l1u1l2d1r1u1r1d3r1d1l1r3u1l1d1l1u1d1l1d1l2u1r3u1r2d2l1u1r1u1l1

;48
####
#  #
#  #####
#      #
##@.#$ #
#   #  #
#   ####
#####
Solution: 5-5u1r1u1l3d1l1u1l1u2r1d3r1d2l2u1r1d1r1u1

;49
#####
#   ####
#      #
##  #  #
 #@.*$##
 ###  #
   #  #
   ####
Solution: u2r3d2l1d2r1u3r1u1l3d1l1d1r1u3l2d1r1u1r1d2

;50
 ######
 #    #
##    #
# $$$ #
#.+.###
#####
Solution: r1u1d1l2u1r1u1r1l1d2r1u1l1u2r3d2l2r2u2l3d2r1d1l1u3r1d1u1r2d2l2u1l1d1u2r3l1d1r1d1l1u1l1d1

;51
#########
#       #
#   .   #
###$*$###
  # .@#
  #####
Solution: u1d1l2u1r1l1r1u1l1r1u1r2d1l1u1l1d1l1d2r2u1d1l2u2r1d1u2r2d1l1u1l1d1u1l3d1r2

;52
#########
#   #   #
#    .  #
####$*$##
   # .@#
   #####
Solution: u1d1l2u1r1u1l2r2u1r2d1l1u1l1d1l1d2r2u1d1l2u2r1d1u2r2d1l1u1l1d1l2u1l2d1r3

;53
 ####
 #  ###
 #    #
##$   #
# * ###
# * #
# .@#
#####
Solution: l2u2r1u1d2r1u1l1u1r1u2l1d3u2r3d1l2u1l1d1

;54
#######
#     #
#     #
## $###
 # * #
 # * #
 # .@#
 #####
Solution: u2l1d1l1r1u2l1u1r1d3l1u2r1u2r2d1l1u1l1d3u3l2d1r1u1r1d2

;55
   #####
 ###   #
 #   $ #
## ##*##
#    * #
#   #.@#
########
Solution: u1l3d1l2u1r1u2r2u1r2d1l1d2l2d1l2u1r3l2u2r2u1r1d1

;56
 ####
 #  #
 #  ####
##     #
# $**.@#
#  #   #
#  #####
####
Solution: l1u1l3d1l1d2r1u3r4d2l2u1l1u1l1d1r1u1r1l1d1l2d2r1u1l1u1r3l1u3l1d2r1l1d1r2d1r2u2l2d1l2r1u1d1l2d2r1u1l1u1r2l1u3r1d2

;57
 ####
 #  #
##  ###
#   @ ##
# $**. #
#  #   #
#####  #
    ####
Solution: l3d2r1u2r3d2l1u1l1u1l2d1r3d1r2u1l1u1l2d1r1u1r1d1l4u1r2u2l1d2r1d1r2u1l1d1l1u1l2d1r1u1r3d1r1d2l1u1l1u2l2d1r1l1u3r1d2

;58
#######
#     #
# *.@ #
##$*  #
 #  ###
 #  #
 ####
Solution: l1u1l2d1r1d1r1d2u1d1l1r1u2l1u1r1d3l1u2r1u2r2d1l1r1d1l1

;59
 ####
##  #
#   ###
# *.@ #
##$*  #
#   ###
#   #
#####
Solution: l1u1l2d1r1d1r1u1r2d1l2u1l1u2r1d1l1d1r1d3l2u1r1u1r3u1l1d1l2d2r1u1

;60
######
#    #
#  #*##
#   .@#
#  #$ #
##  * #
 ###  #
   #  #
   ####
Solution: undefined

;61
#####
#   ####
#   *  #
## #.@ #
 #  $###
 ## * #
  #   #
  ##  #
   #  #
   ####
Solution: u1l2u1l2d1r3l2d2r1d2r2u1l1u1d2u2l2u2r2d4l1u1r1u3l2d2r1l1u2r2d2u1r2u1l1d1l1d1l1d2r1u2d2r1d2l1u2

;62
  ####
###  ###
# .    #
# $*$  #
###@. ##
  #  ##
  ####
Solution: undefined

;63
   #####
####   #
# .    #
# $*$ ##
###@.##
  #  #
  #  #
  ####
Solution: undefined

;64
 #####
 #   #
 #.  ##
##$*$ #
#  #. #
#  #@##
#    #
######
Solution: d1l3u2r1u1d3r2u3d3l2u3r1u2l1d3l1d2r3u2r1u1l1d3l3u2r1u3r2d2u1l2d2l1d2r1u3

;65
####
#  #####
# . #  #
# $*$  #
##  .@ #
 ####  #
    #  #
    ####
Solution: l3u1l1u2r1d1r1d1r1d1r2u2l1d2u1l2u1l2d1r1d1r2u1l1d1l1u1r4d1l1r1d2l1u2r1u1l2

;66
#####
#   ##
# .. #
##.@$#####
#  $$    #
# #  # # #
#   ##   #
##########
Solution: d1r3l5d2r1l1u2r2u2r1d1l2d1l1d2r2u3r1u1l1d3r1u1r2d2r2u2l5u2r1d1l1d1r3l3d2l2u2r1l1d2r2u3d1r3d2r2u2l4d1l1u1r1u1l1

;67
#####
#   ######
#    #   #
## *$# # #
 #@.*    #
 #  ######
 #  #
 ####
Solution: r4l4u3r1d3l1d2r1u2l1r4u2r2d2l5u1l1d1u3r1d1r1d1u1l2d2r4l3d2l1u3d1r2u2l1d1u2l2d1r1u1r1d1r1d2r2u2r2d2l3

;68
 ####
 #  #
##  ###
# *$  #
#@.*  #
#   ###
##  #
 ####
Solution: undefined

;69
########
#  #   #
#      #
#*$ #  #
#+* #  #
#  #####
####
Solution: u1r1l1d2r1u1r1u1d1l2u1r1u1r2u1r1d1l3d2r1u1l1u1r2l2u1l1d2r1u1r2u1r2d1l3d1l2u2r1d2r1u1r3d2l1u1r1u1l4u1l1d1

;70
####
#  #
#  ####
#   . ##
## $*. #
###@$  #
#   ####
# # #
#   #
#####
Solution: r1u1r1u1l2d3u2l1u1d1r1d2u1d1l2d2r2u3r1u1r2d1l1u2l3r3d2l1u2l2d1r2l1d2u2d2l2d2r2u3r1u2l2d1r1l1u1l1u2r1d1l1d1r2

;71
######
#    #
#@.# #
#.*$ #
# $ ##
##  #
#  ##
#  #
#  #
####
Solution: d2r1l1u2r1d4u5r2d2l2d2r1u1l1u3r2d2l1d1l1u1d3l1d2r1u4

;72
 #####
 #   #
 # # ###
## .$. #
#  $+$ #
#  ##  #
#  #####
####
Solution: l1u1l1d1u1d1r2u1r2d1l2u1l2u2r2d1u1l2d2r1l1d1r2u1r2d2u2l4u2r2d1u1l2d3r1l1u3r1l1d3r2u1r2d2l1r1u1l1u1l1r1d1l1u1l2u2r2d1u1l2d2r2d1r2u1l2u2l2d3r2u1r2d2l1u1l4d2r1u1l1u1r2

;73
 #######
 #  #  #
##  #  #
#  $.  #
# @.$ ##
###$.##
  #  #
  ####
Solution: r1u1r2d1l1u1l2u2r1d1l1d1r2d1r1u1l3d1u1r2d1l1r1d2l1u3l2d1r2u1r1d1l2u3r1d2r3u2l1d1r1d1l1

;74
  #####
 ##   #
##    #
# .$.##
# $.$ #
###@# #
  #   #
  #####
Solution: u2l1u1r1u1d4u2d3r2l2u5r1d1l1d4r2u2l1r1d2l2u3l1u1r1l1d1l1d1r1u1r1d1u3r2d1l1u1l1d1l1d2r2u1l1u2r2d1u1l1d1l1d2r2d2l2u1

;75
    ####
    #  #
#####  #
#  .$. #
#  $.$##
####@  #
   #   #
   #####
Solution: undefined

;76
######
#    #
#    #
###.$###
###$.@ #
#  .$  #
#   ####
#####
Solution: undefined

;77
#####
#   ####
# #**  #
# @ $# #
#  .   #
########
Solution: undefined

;78
####
#  #####
#  #   #
#  .$#@#
#   .$ #
# *#####
#  #
####
Solution: d1l3r3u2l2d1l1d1r1l1u1l2d1r1l1d2r1u3r2d1l1u1l1d1r2u2r2d2l1r1u2l2d1l3u2r1d1l1d1r1

;79
  ####
  #  #
  # $#
###. #
# @$ #
#*#. ##
#     #
###   #
  #####
Solution: r1u1r1d2l1d2r2u1l1d1l1u2r1u2l1u2r1d4l1u1d3r2u1l1d1l1u1

;80
######
#    #
#    #
# #@##
# #$.###
#  $ . #
###$.  #
  #  ###
  ####
Solution: u2l2d4r2u2d2l2u4r3d1l1d3r1d2l1u4d3r3u1l1d1l2u2r1d1l1u1d1l2r2d1r1u1r2d1l1u1l4u4r2d3u3l2d4r2d1r1u1r2d1l1u1l4u3r1u1r1d3u2l2d3r3

;81
   ####
   #  #
   # $#
####. ##
#  $   #
#  *.  #
# @#####
####
Solution: undefined

;82
   ####
   #  #
#### .#
#   $$#
#   $ #
###.# #
#   .@#
#   ###
#####
Solution: u3d2u2l1r1d3l2u1d1r2u3l2r2d1l1u1l1d2u1r2d2l2r2u2l1u3r1d3l4u1r2d1r2u3l1d2r1d1l2d2r2u3l4d1r1u1r1d1r2d2l2d1l2u1r2

;83
  ####
  #  #
###$.##
# *@  ##
# #$.  #
#      #
##  ####
 ####
Solution: r1d2l3u2r2d1u1l2d2r3u1r1u1l2r1u2l1d2r1d2l3u2r2l2d2r3u2r1d1r1d1l2u1d1u2l3d2r3l1r1u2l1u2r1d2l3d2r3l1u2r2d1r1d1l1u2l2d1u1r2d2l2u1r1u3l1d2l2d2r1l1u2r3d2r2u1d1l3u2l2d2r1l1u2r3u2l1d2l2d2u2r4l1d2r2l3u2l2d2r1l1r1d1r1u1r1u4l1d1r1d3l3u2r2l2d2r3u2d2r2u1d1l3u1r1u1l1d2r3u1l1

;84
 ########
 #  #   #
##$.    #
# ..#$###
#  $  @ #
#####   #
    #####
Solution: l3r2u1d1l2u2r2l2d1l2d1r4l2u3l1d1r1d2l2u1d1r4u3,1-3d1r4u3r2d1l4r2d3r2u1l1d1l1u2d1l2u2r2l2d2l2u1r1d1r3u2l2u1l1d1r3u1r2d1l3

;85
######
# . .###
# # $  #
#@$ $  #
####.###
  #  #
  #  #
  #  #
  ####
Solution: u2r2d1r1d3u2r2u1l2u1l3d2r3l1u1r1u1l1r1d4l1d2r1u5r2d1l1u1l1d1

;86
 ####
##@ ##
#   .#
# $  #
####*###
# $ .  #
#      #
#   ####
#####
Solution: r1d2r1d2r1d1l2r1u4l3d1r2u1r1d3l1d2u1r1l1d1l2u2r2d1r1u3d3l1d1l1u1r2u1r2d1l3d1l2u2r2d1r1u1l3d1r1d1r1u1l1u1r1

;87
    ####
 ####  #
 #  #  ##
## $.   #
# *$# # #
# #  .  #
# # #@###
#     #
#######
Solution: u3l2d2r2d2l4u3r1l1d3r4u4l1r1d2l1r1u2l2u1l1d1u1r1d1r2d2l2u1d1r2d2l4u3r1u1r2l2d1l1d3r4u4d2l2u1d1r2u2l1r1d2r2u2l1u2l1d2r2d2l4u1l1u1r3l2d2r2d2l2r2l2u2d2l2u3r1u1r3d2u2l3d1l1d3r2u3d1r2u2l2u1l1d1r3u1d3r2u2l2d2l2d2r2u1

;88
 ####
 #@ ##
 #*$.#
 #.$ ###
## #   #
#      #
#   ####
#####
Solution: d2r1l1u2r1d1r1d2r1d1l2d1l2u1r3u2d2l2u2r1l1d2r2u2d1r2d1l3d1l1u2

;89
 ####
 #  #
##. #
# * ###
# $*  #
#   @ #
####  #
   ####
Solution: l3u2d2u2r1d1r1u1d2r2u1l2u1l2d2r2l1r1u2l1u2r1d2l2d2r1u2r1d1r2d2l1u1r1u1l2u1l2d2r2l1u1r3d2l1u1r1u1l1

;90
####
# @#
#  ####
#$$$  #
#...  #
#  #  #
#  #  #
#######
Solution: l1r1d3u1r1l1d1l1u1r1d1r3u1l2d1l2d2r1u1l1u1r2l1r1u1r1d1l3u1r1u2l1d3r3u1l1d1l1u1d3l1u1r1u1r3d2l1u1r1u1l1u1l3u2r1d2

;91
########
#   #  #
# $.   #
##$+#  #
# $.   #
#   ####
#####
Solution: u2l2d1r3l1d2r3u3l1d1l2d3l2u1r2l1u1r1u2l2d1,5-4l1,3-5u1,1-2r1,5-2d1,6-4l2

;92
####
#  #
#.$###
#+$  ##
#.$   #
###   #
  #   #
  #####
Solution: d1r2u1r1d1l3u1r1d1l1u3r1d2l1d1r2d2r2u2l1u1l2d1r1l2u1r2d3r2u2l1r1d2l2u2r1u1l2r1d3r2u1l1d1l1u1r1u1l2

;93
 ####
 #  #
 #  ####
##  .. #
# $$$ @#
#  # . #
#  #####
####
Solution: l1u1l3d1l1d2r1l1u2r1u1r3l3d1l1d2r1u3r3d2l1u1l1u1l1d1r1u1l1d1l1d2r1u1l1u1r3l1u3l1d3r2d1r2u2l2d1l1u1d1r1d1r1u1l2r3u1l2d1l3d2r1u1l1u1r3l2u1r2d2r2u2l1d1l2u1r1l2u2r1d1l1d1r1

;94
 ####
 #  #
##.$####
#@.$   #
# .$#  #
##     #
 #  #  #
 #######
Solution: r2l1d1u1d2u3d1r1l1d2r3u2l2r1l1d1l1d1r2l1u2r3d3l1u1l3u1l1u1r2l1u2r1d2l1d3r1u1r3u2l3d1l1u1r4d3l1u1l2d1l1u1r3u1r1u1l3

;95
  #####
  #   #
  #.  ##
###$$* #
# @.#  #
#      #
#  #  ##
#######
Solution: r1d1r3u2d1l1d1l2u2d2r2u2d2l2u2r1u2l1d3l1d1r2d1r1u1r1u2l2r1d1r1d1l3u2d2r2u2l1u2r1d1l1d1l1d1l2d2r1u1l1u1r1

;96
   ####
  ##  #
###   #
# $$* #
# .@.##
##   #
 ##  #
  ####
Solution: undefined

;97
  ####
  #  #
  # .#
###$+###
#  $*  #
#      #
#  ##  #
########
Solution: d1l1d1r1u3l1r1d3l3r3u1r2d2l1u1l4r2u2d2l2u1r1d1r2u2l1d1r1d1l1u2r1u2l1d2r1d2r2u1l1d2u1l1u2l1d1l2d2r1u1l1u1r3d1l1r3u1l1d1l1u1l3d2r1u1l1u1r2

;98
   #####
   #   #
####.  #
#  $.@ #
#  *$ ##
##  ###
 #  #
 ####
Solution: undefined

;99
 ####
 #  #
##  ###
#   @ ##
# $$$  #
#  #  .#
#####..#
    ####
Solution: r1d2l1r1u2l4d2r1u2r3d2l1u1l1u1l2d1r3d1r2u1l1u1l2d1r1u1r1d1l1d1r1u1r1d1u1l3u1d1l2u1r2u2l1d2r1d1r2u1l1d1l1u1l2d1r3u1r1d1l1d1u1r1d1u2l3u2r1d2l1d1r2u1r1d1l1d1r1

;100
   #####
 ###   #
 #.  # #
##+$$$ #
# .#  ##
#    ##
#  ###
####
Solution: u1r2d1l1u1r1u1r2d2l1r1u2l2d1l2d2u1r1u1r1u1r2d2l2r2u2l2d1l2d2l1d2r1u1r2u1r1u1r1u2l2d1l2d2l1r1u2r2u1r2d2l1d1l1u1r2u2l2d1l2d2l1d2r1u1r2u2d2l2u1d1r2u1r1u1r1u2l2d1l2d2l1d1r1u3r2u1r2d2l1d1l1u1l1u1l1d2u2r1d1r3u2l2d1u1r2d2l2u1l2d2l1d2r1u3r1u1r1u1r2d2l1r1u2l2d1l1d1l1d2u2r1u1r1u1r2d2l1d1l1d1l1r1u1r1u1r1u2l2d1l1d1l1d1l1d2r1u1r2u1r1u1l2

;101
  ####
###  ###
#   .  #
# #+$  #
#  *$###
###  #
  #  #
  ####
Solution: undefined

;102
  ####
###  #
#   .###
# .$$$ #
#  #.@ #
#    ###
######
Solution: undefined

;103
   ####
   #  #
####  ###
#  $$$  #
#@.. .  #
###  ####
  ####
Solution: undefined

;104
    ####
#####  #
# $ $$ #
#@.. . #
##   ###
 ##  #
  ####
Solution: undefined

;105
 #####
 #   ###
##$# $ #
#@.* . #
#     ##
##  ###
 ####
Solution: undefined

;106
   ####
####  ##
# $  $ #
#@.* . ##
#####   #
    #   #
    #####
Solution: undefined

;107
   ####
####  #
#  #  ##
#  $$$ #
#@.. . #
####  ##
   ####
Solution: r4l1u1l1d1r3u1l2r1d1l4u2r1d1l1d1r3u1l1r2u2l1d1r1l1r1d1l1d2r1u2l1d1l3u2r1d1l1d1r3u1l1d1l2u2r1d1r4d1l2u3r1d2

;108
########
#  #   #
#  # # #
# $$ $ #
##+. .##
 #  ###
 #  #
 ####
Solution: u1l1u2r1d3r2u1l1d1l1u1r2u2r2d2l1r1u2l2d2l3u2r1l1d2r4d1l1u2d1l3u2r1d1l1d1r3u2d2l2d1r1d2l1u3r2u2r2d1u1l2d2l1r1u2r2d2l1d1l1u1l3r2d1r2u1r1u2l2d2l1d1r1l2d2r1u1l1u2l1u2r1d2

;109
   #####
   #   #
####   #
# $ $$###
#@.. .  #
###  #  #
  #  ####
  ####
Solution: r4u1d1l2u1r1u2r2d1l1u1l1d3r1u1l2d3r1u1l1u2r2d1l1u1l1d1l2u1r1d1r2d2l1r1u2l2u1r2d3l1u1r1u1l1r1u3r2d1l1u1l1d3r1u1l1d1l1d2r1u1l1u2r2d1l1u3r1d2

;110
####
#  ###
#    ##
# $$$ #
##+.#.##
 #     #
 ####  #
    #  #
    ####
Solution: u1d1r1u1d2r2u2l1r1d2l3u2l1u2r1l1d2r1d2r3u2d2l3u2r1l2u2r1d2r1d2r2u2l1u1l1r1d1r1d2l2u2l2u2r1d1l1d1r2d2r2u2l1u1l1d1r2l4u1r1d1r3d2l3u2r1d1l1d1r2l2r1u2r2d2u2l4u2r1d2r2u1d1l1d2l1r1u2r1u1l1d2u1l2u2r1d1l1d1r1u1r1d1r2d2r1d2l1u2

;111
     #####
 #####   #
 #   # # #
 # #$    #
 #  .@####
### #.####
#    $   #
# # ## # #
#   ##   #
##########
Solution: undefined

;112
  ####
  #  #
###  ###
# $$$  #
#@.. . #
## # ###
 #   #
 #####
Solution: undefined

;113
########
#   #  #
#  **$+##
#       #
#####   #
    #####
Solution: undefined

;114
########
#..@.. #
#$$ $$ #
#  # ###
#    #
######
Solution: undefined

;115
#####
#   #####
# $ $ $ #
#  #  # #
# . .@. #
###  ####
  ####
Solution: undefined

;116
########
#  ##  #
#      #
# $$ # #
##$ #. #
 #  .+###
 ###    #
   ##   #
    #####
Solution: undefined

;117
####
#  ###
#    ###
# $$   #
##$ #. ##
 #  ..@ #
 ####   #
    #####
Solution: undefined

;118
  ####
  #  ###
###    #
# $$*  #
# .@. ##
#  ####
####
Solution: undefined

;119
#######
#.+#  #
#  *  #
# $ $ #
###   #
  #   #
  #####
Solution: undefined

;120
 ######
 #    #
## ...#
# $$ $#
#@ #  #
#  #  #
#######
Solution: undefined

;121
 ####
##  ###
# $ $ #
#@    #
##$ ..#
 #   .#
 ######
Solution: undefined

;122
####
#  #
#  ###
#  $ ##
# $*+ #
## .  #
 #  ###
 ####
Solution: undefined

;123
####
#  ###
#  $ ##
# $*+ #
#  .  #
#######
Solution: undefined

;124
#######
#     #
#   $ ##
###$*+ #
  # .  #
  ######
Solution: undefined

;125
#####
#   ##
#    ###
### $  #
 # $*+ #
 #  .  #
 #######
Solution: d1l2u2d1r1d1r2u2l2u1l1d1r3d2l4u1r1u3l2d1r1u1r1d3l1d1r1

