;1
#############
#           #
# .$$$$$$$. #
# *.  $  .* #
# * . $ . * #
# *  .$.  * #
# .$$$*$$$. ###
# *   *   *   #
# * *.....*.* #
# * *$.   *$$ #
# .$* *$ $* $ #
#   *  $ $  $ #
#   *...*...* ###
### *   $   $   #
  # *$$*******$ #
  # * . $ $ $ . #
  # . . $ $ $ . #
  #   .   $   . #
  ### $*******$ #
    # *       * #
    # *       * #
    # .       . #
    #  .......@ #
    #           #
    #############
Solution: r1u5l4d4u4r1d4u4r1d4r2u8l2d7l1d1r1l8u5r2d1r2d4u2d2l1d1r1u3r2u1l1d3l5u4r4d4l4u4r2d4l1d1r1l2u4r1u1r1d3r1d1l1u4r1d3r1d1l1u1l1d1u5l4u5l2u10r10d10l1d2l3u1l2d1r1d4l1d1r6u1r4d1l1u1l7u1l1d1l1d1r5l1u2l1d1l2u2r1d2l1d1r3u1r2u1l4d1l2u2r1d2l1d1r3u2r1u1d1l3u3l1d2r1d1l1r4u1l2d1l2u2r1d3l1d1r2u2r4u1l4d1l2u2r1d3l1d1r1u1r7u2l6d1l2u2r1d2r5d1r4u4l1d3l1u1l2d1r2u9l2d4l1d2r2l2u2r1u4r2d7r1d1l1d1l2u1r2u2l3u2r1u1r1l1u3r2d6l6u1l1d3u2l1u2l2d1l1u1r4d2r7u1d1l4u1l1u4l3u1l2d3u3r2d1r3d5l3d4l2u5l1u1r1d6r2l2u2r5l3d2l2u10r2d7r1d1l1r3d1r2u1l3r1u2l3u4r3d4u3d2l1d1l2u2r1l1d1r4l1u1l1r1u2l1d2u2l2d3r3d1r5u3l2d1l3u1l1d1r1l2r1u3l2d3r3d1l1d1r6u2l4r4d2l6u3r1d1u3d3r5u2l1d1l1u1d2l3u2r1d1l1d1r3u1r2d1l5u1l1d1u4r1u2d1r1u3l2d5r1d1l1u5l2d3u3d1r1u1r1d3r1d1l1u5r1d4u3l3d3l2d4l2u10r8d6u6l2d6u3l2u1r1d1r3u3l2d1r2l2r1d2l2u1r1d2l4u1r3u1r1d1u1r1l3d4l1u1l1u1r1u2r3u2l3d2u1l1u1r3d2l1d1r2u2l3u1l1d1

;2
      ####
      #  #     ################
      #  #  ####   ##         #
      #  #  #  #              #
    #### #  #      ##         #
    #  * #### ### ###   #######
    #  **#      *  ##   #
    #  *  ******** ##   #
    # ** #  *      ##   #
    # *  ## * ### ###   #######
#####** ### * ##   ##         #
# $ * * #   *   *  ##         #
#     * #********* ##         #
##### * #  *    * #########   #
    # * #  * ## * #       #   #
    # * #  * @# * #       #   #
    # * #  * ## * #       #   #
    # * #  * ## * #########   #
    # * #  *    *   #         #
    # * **********. #         #
    # *             #         #
    #     #####################
    #######
Solution: undefined

;3
#################
#######   #######
#     ....#     #
#   # #...#     #
#    $.#..... # #
#  # #..*.##.   #
#  # .#*.....#  #
####.*#.###.## ##
#   *.#.....    #
# $#+*... #  #  #
#  #####*##     #
# $$ #   #    # #
# $  $$#     #  #
# $ $#   #####$##
# $  # ### $ $  #
# $  $$  #   $  #
# $  $   # #$ $ #
# $$$$$$$$    $ #
# $  $ $ # $ $$ #
#        # ##   #
#################
Solution: undefined

;4
################
#   #......#   #
#    .    .# $ #
### #......    #
 ## ######## ###
 #             #
 # $ $ $$$ $ $@#
 ####### #######
 #. #  .  #    #
 #.$# *.. # $  #
 #. ###.###$ $ ##
 #.   * # $ $ $ #
 # $##*      #$ #
 #. ##.####$##  #
 #.##   # $  #$ #
 #. #   #   $$  ##
 ## # $$ #       #
  # #    # $ #$  #
  # ######## #   #
  #          #####
  ############
Solution: undefined

;5
#####         ##############################
#   ##       ##                            ##
# *  ##     ##  * *#***********  *********  ##
# **  ##   ##  ** *             **       **  #
# * *  ## ##  * * * ########## ** ####### ** #
# *  *  # #  *  * * #        # *  #     #  * #
# *# *  ###  * #* * #        # * ##     ## * #
# *  #*  #  *#  * * #        # * ##     ## * #
# * #  *   *  # * * ########## *  ##   ##  * #
# * #  ** **  # * *            #.  #####  .# #
# * ##  * *  ## * *#**********$ **       **  #
# * ###  *  ### * *            # .*******. # #
# * # ##   ## # * * ########### .*       *. ##
# * #  #####  # * * #        # .*$##   ##$*. #
# * #         # * * #        # *$ ####### $* #
# * #         # * * #        # *  #     #  * #
# * #         # * * #        # *  #     #  * #
# * #         # * * #        # *  #     #  * #
# * #         # * * #        # ** ####### ** #
# * #         # * * #        #  **       **  #
# $ #         # $#$ ###########  *********  ##
#  @#         #                            ##
#####         ##############################
Solution: undefined

;6
     #######
     #  #  #
     #     #
     #  #  #
     ## #.##
####  # #  #
#  ####$##$###     ####
# .*@   #    #     #  #
#  $$$ # $ $ #######$ #
##.# ###   $ $    $   ##
 #.$ ###  $$   $ $$ $  #
 # # ### $   $ $   $ # #
 #   #  ############   #
 ### #$ ##  ######## ###
  #     ##$ ######## ##
  # ##.#   $ ####.*.* ####
###*. .#.#   ####.... #  #
#   .#.# $$* #### #.###  ####
# $*$ * .. . #### #.  $$.   #
###  $ #####$#### #*### .*. #
 #  ####....     .*..##*  ###
## ##### ##.#####.##  * .##
#      #..$. ####.### #  #
# $$#  $..#..*....  $ ####
#    $$## ####### #$# #
###$$  $  #    #  $   #
  #    ####    # $  ###
  ######       #  ###
               ####
Solution: undefined

;7
####################
#                  #
# ** * * * * * * * #
#  ##############* #
# *##          ##  #
#  # *  **  **@# * #
# **  **  **  ##*  #
#   **  **  .##  * #
# **  **  ** #  *  #
#   **  **  ## * * #
# **  **  *## * *  #
#   **  ** # * * * #
# **  **  ##* * *  #
#   **   ##  * * * #
# **  **##  * * *  #
#   **  #  * * * * #
# **  *## * * * *  #
#   ** # * * * * * #
# **   #* * * * *  #
#   **## * * * * * #
# **  # * * * * *  #
#   *##* * * * * * #
# ** ## * * * * *  #
#   *##* * * * * * #
# *** * * * * * *$ #
#                  #
####################
Solution: undefined

;8
     #######      #####
     #  #  ########   #
     #     ##         #
     #  #  ##$######.####
     ##.# ##  #   #   $ #
####  # #  #   $# #   # #
#  ####$##*# ##    #### #
# .*@   # .$$ # $$ #### #
#  $$$ ## .$  # $  #    #
##*# ##  $.#  #$  #  ######
 #.  ## $.. ##  $ # #     #
 # # ####  $     ## #.##*$##
 # ..  .###### ####    $.  #
 #####$ *..    .   # $.#$  #
  #  . .##*.###### ##.   ###
  #$##.#.  $ #####.$.$ ###
###  ..# #  $   ##. ..#  #
#  ..#*# $$* ##  ## ### .####
# $$$ $  . . ###  #   $* .  #
###..$.#####$#### #$### .*. #
 #  ####   ...  ..*  ##*  ###
## ##### ## ##### ##  * .##
#      #..$.##### ### #  #
# $$#  $  #. $        ####
#    $$## ####### #$#$#
###$$  $  #    #  $   #
  #    ####    # $  ###
  ######       #  ###
               ####
Solution: undefined

;9
      #####  #####
 ######.. ####.  #####  ######
 #@ $  .$.$.. .#*  .######   #
 #$###.$ #.*..*.  $   $      #
 # ###   # ## ..#* ######## ##
 # .#### #$ $ ###  ######## #
##.$ ..* #  $##### ######.*.#
#. .#.*.$.   # $  .####..$..#
#.$##**####    # ## $  $ # ##
# $.# .#. ##$$ # $    ## #$.#
#.  .#    ##   ##  # ##  #. #
####.* # .###$ ##$ #  $ ##. #
   #  .**### $ ##  ## # ##* #
  ###.$#      $ #$ ##  $ #. #
  #  $ # $ $ #    $##  $.** #
  #$  ###### ####$ ##  # #  #
  #.$$.#       ##   #### #* #
  ##  .#$$$#$$$## #  $   #  #
  #   #           #  $# ##*##
  # $## ######### #$  $     #
  #   ..#       #   $ $##*. #
  #######       ### $   $ # #
                  #######.  #
                        #####
Solution: undefined

;10
       #####   #####
       #   #####   ##
       #$# #   # $  #
  #### #@$ $    $ # #
  #  ### # ######   #
  #    $   ####  $.#######
  # $####### . . #.#     #
 ###.##...## .$$##.*.. # #
 #......*..# *  .$.*## $ #
 # *####......## #.*  $#.#
 #.. #  #****### ### $  .#
 #.*.# ....#..   #  ####.#
 ##$ #$.####.## $$ $     #
  #  #  #  #  #  #  # ####
  #.##$ #$ ##$### .# $#
###*   $  $    ## ##$ #
#   #####  $$#  #$ $  #
# $     # $  #  $   $ #
#  #$$  #  $ #  $#    #
# $   $ # $$ ###    ###
#  $   # $  $# ######
##  #### $   #
 ####  #   ###
       ######
Solution: undefined

;11
#####
# . #################
# $                 #
##*##### $ ###### #*#
 # ##### $      #  .#
 #  ##### ##### $ #.#
 #$ ...$..#####$  # #
 #   *###.##### # $$#
 #.#*...*.#####   # #
 # ...## #### $ #   #
 ####### ###  $ # #$#
  # $  $*## $ $$# # #
###..* #  $  $  $ # #
#  ..*....#  $  $   #
# $#***##.##$ $$ $#$#
#     $@$  #      # #
##*.#$#$$# ########.#
 # ..$...# ####    .#
 ##.##$# # ## $ $$#*#
 ##. #.  $          #
  #. $. ## # #### #$#
  #.* *.   #        #
  ###################
Solution: undefined

;12
     ##################
     #  #@ ########   #
     #   $ ##         #
     #  #  ##$###### ####
     ##.# ##  #   # $ . #
####  # #  #   $# #   # #
#  #### ##*# ##    #### #
# .*    # .$$ # $$ #### #
#  $$$ ## .$  # $  #    #
##*# ##  $.#  #$  #  ######
 #.  ## $.. ##  $ # #     #
 # # ####  $     ## #.##**##
 #  ..  ###### #### .  $   #
 #####$ ... $ .... # * #$  #
  #  .  ##$.###### ## .  ###
  # ##*#   $ #####.$ $ ###
###$ ..#.#  $   ##.  .#  #
#  ..#.# $$* ##  ## ### .####
# $$$ $ .. . ###  #   $* .  #
###. $ #####$####$#*### .*. #
 #  ####   .     .*  ##*  ###
## ##### ##.##### ##  * .##
#      #..$. #### ### #  #
# $$#  $..#..$        ####
#    $$## ####### #$#$#
###$$  $  #    #  $   #
  #    ####    #    ###
  ######       #  ###
               ####
Solution: undefined

;13
#########################
#                       #
# ### .###### ** ###### #
# ### * #####  **  #### #
# ###** ######   *  #.  #
#    *      **********# #
# *********             #
#   *     ##  **# * ### #
# # * ## * # **   **  # #
#  ** ## * # * ####** # #
# #$. ## *  ** ###  **  #
#  **   ** ** *  # * ** #
# # ** **     **   *    #
#    ***   # # ** *  ####
##### *  # $    *** #####
#    * ** # ## ** **  ###
# # **  **    **   **  ##
# @**    **$ **  ## **  #
# ** ##### #**## ### ** #
#                       #
#########################
Solution: undefined

;14
####################
#                  #
# ** * * * * * * * #
#  ##############*##
# *##          ##  #
#  ###  **$ **@# * #
# **  **  **  ##*  #
#   **  **   ### * #
# **  **  ** #  *  #
#   **  **  ## *.* #
# **  **  *## * *  #
#   **  ** # * * * #
# **  **  ##* * *  #
#   **   ##  * * * #
# **  **##  * * *  #
#   **  #  * * * * #
# **  *## *** * *  #
#   ** # * * * * * #
# **   #* * * * *  #
#   **##.* * *.* * #
# **  # * * * * *  #
#   **#. *** * * * #
# **  #** * * * *  #
#   *$#. * * * * * #
# *** #$* *$* * *$ #
#     *            #
####################
Solution: undefined

;15
             ####
    ####     #  ##
    #  #######   ##
  ###$ # $     $  #
### $   $ $#### $ #
#     ##   #   # $#
#  $ #  ####$#  # ##
# $ ##.* .*.* # #  ##
###.    $ # ..  #$  #
  #.$$#   #.**.## $ #
  #.$.####### ## $  #
  #.$.   #. $ $ $  ##
  #*## $  .## @   ##
  #  . $##. ## ####
  #.$#  # ..##  #
  ## ####$.*..$ #
  ## ##..*.###  #
  #.   *.**## $##
  #   ####  #  ##
  #####  ##    #
          ######
Solution: undefined

;16
  ####
  #  #
  #$ #
  #  #
  #$ #
  #  #   ####
  #$ #####  ########
  #  ##  $.$##  . .###
  #$ ##  . * $ # #   #
  #    . #.#.$ # .$  #
  #$#$$# $   ## ..# ###
  #    ####* *  #.$$* #
 ##$ $$# $ .######.$ .##
 #     # $  #   #  $#  #
 # ### #   *# $$#$# ## #
 #  .$.####.#   #.     #
 #.*#.*. *.+.*..*.# # ##
 #  . #   #.#### .. $$#
 ## #$#$$ #*   #$## $ #
###...#   #  $ #    # #
# .$ ######. $ #$##$# #
#  * ####.**####... ..#
#### $.#      *  # ####
  #  #...# ## ##.$$$ #
  #.$# $   $         #
  # $.  # $# ##$.#####
  #  #### $ $##  #
  ####  ##   #####
         #####
Solution: undefined

