;1
   #####
####@  #
#  $*. #
#     ##
#  #####
####
Solution: d1l1,1-2r3,6-2l1,5-3l2,3-2r1,2-4u1,1-2r2

;2
      #####
   ####   #
####  $*. #
#  $*.   ##
# @   #####
#  ####
####
Solution: 4-2d1l1,7-1d1l1,4-2r3,1-3r3,6-3l1d1l2,2-5u1,3-3r1d1r1u1,9-2l1d1l3d1u1r1u1r1,3-3r1u1r2,1-3r2

;3
  ######
  # @  #
###$.  #
# . $###
# #$. #
# # # #
#     #
##   ##
 #####
Solution: 4-2d1,3-3d2,5-4l1,3-1d1,2-3r1,4-4u1,3-2r1,2-6r1,3-5u1,2-3r1,4-4u1,5-6l1,3-7u3,4-3l1,4-1d2,6-2l1

;4
 ########
##  #  ###
##.$#  * ##
#   @ * * #
#   ##    #
######   ##
     #####
Solution: 6-2d1,9-3l1,8-2l2,7-4u1,3-1d1,2-3r5,5-1d1,6-3l3,2-4u1,6-5u1

;5
  #####
 ##  #####
 ##      #
 # .**$  #
## #  #@##
#  $**. #
#      ##
#####  ##
   #####
Solution: 4-6u1l1,4-5r1,5-4u1r1,6-2l2,1-5r3,3-3r1d1,3-1d1,6-3l1,8-3l2

;6
 #####
###  ##
#  $  ##
#@#$# ##
# .$. .#
###    #
 ##  ###
  #####
Solution: d1r2,4-2l1d2r1,5-3d1l1,1-2r2,3-6u1r1u1l1r3d1l1,1-4r4,5-2l1u1l1d2,4-4l1d2r1u1

;7
 #####
###  #
## * ###
#  $  ##
#@#$# ##
# .$. .#
###    #
  #  ###
  #####
Solution: 2-5r1,4-3l1d2r1,5-4d1,3-7u2,6-6l1,1-3r2d1,2-5r3,5-3l2,1-3r1,2-2r1d2,4-5l1,4-1d1,5-3l1,3-4u1,4-7u1

;8
 #######
 #  .  #
 #  $# #
###**@ ##
 #  $# #
 #  .  #
 #######
Solution: 3-4u2,5-3l1d1,4-1d1,2-1r1

;9
      #
##########
###   #  #
# @..*.$ #
# $ $ #  #
##### # ###
    # #  #
    #    #
    ###  #
    ######
Solution: 4-3r1,7-2d4,7-3l2,3-4r1,1-4r2,5-3l2,7-8u4,5-5u1,7-2d4,6-3l1,3-4r1,7-8u4,8-3l1,5-5u1,1-3r1

;10
 #######
#   .   #
# #$#$# #
# $. .$ #
#.#   #.#
# $. .$ #
# #$#$# #
#   +   #
 #######
Solution: 3-7u2,3-3u1,2-1r1,5-1d2r1,7-2d1,3-3l1,1-2d1,3-5u1,5-5u1,7-5l2d1,6-7l1,3-5r1,1-5r1

;11
############
#         @#
# #$###### #
# #.#   .$ #
# # .$ .## #
# #  ##$ # #
# # $##  # #
# ##. $. # #
# $.   #.# #
# ######$# #
#          #
############
Solution: 10-3l3d2,7-7l1,4-7u1,3-1d1,1-8r1,8-10u1,4-4r2l1u1r2,4-6u1d3r2u1l1,7-5d1

;12
 ####
 #  #####   ####
 #      #   #  #
 # ###$ #####  ##
 # # #. . .   @ ##
## ####$#####    #
## #### ##  ##   #
#  #  $  #   #####
#        #
#####  ###
    ####
Solution: 7-7l1,6-4u1,7-2l4,2-1d6,1-8r5,7-6u1,6-4r7,14-3d1,13-5r1,8-8l2,4-7r2,7-8u3,6-4r7,14-5u1,4-8r1,6-9u1,5-7r1,7-8u3,6-4r7,16-5l1,15-4l8,14-6u1,15-4l6,14-2d1,15-4l4

;13
   ####
 ###  #  ####
##    ####  #  #####
#  #        # ##   #
#  $$$ #### # #  # #
###  ###  # # #  @ #
  #  #   ## # #   ##
  ####   #  #####.#
         #        #
         ####### .#
               # .#
               ####
Solution: 4-3d1l1,4-6u3,6-4l1,4-3d1,4-1d1,1-4r3u1,3-2r1,5-1d1,4-3r6,11-2d5,10-8r6,17-9u3,18-5l1,16-4d1,15-6r1,17-5d4,4-6u3,3-2r1,5-1d1,4-3r6,11-2d5,10-8r6,17-9u3,18-5l1,6-4l1,4-5u2,3-2r1,5-1d1,4-3r6,11-2d5,10-8r6,17-9u3,16-4d1,15-6r1,18-5l1d3,16-4d1,15-6r1,17-5d1

;14
   ####
  ## .######
 ##        #
 # ...###  #    ####
##   ## # ##  ###  ###
#    #  # #  ## $$   #
#   ##  # ####  @$   #
#####   #       $##  #
        #  #####    ##
        ####   ######
Solution: r2,19-7u1,16-8u1,15-6r3,17-4d1,18-6l2,14-6r1,15-5r2,17-6l1,15-5d1,16-7l6,9-8u5,10-2l5,4-1d1,5-3l1,3-2d1,4-4l1,20-6l4,15-5d1,16-7l6,9-8u5,10-2l5,4-1d1,5-3l1,3-2d2,4-5l1,18-4d1,19-6l3,15-5d1,16-7l6,9-8u5,10-2l5,4-1d1,4-2d1,20-5l2,17-4d1,18-6l2,15-5d1,16-7l6,9-8u5,10-2l5,3-2r1,5-3u1,4-5u1,3-3r1,1-5r1,3-6u1,2-3d1r1,4-5u1,1-5r1,3-6u2

;15
  ####  ####
###  ####  #
#  $   . . #
# $ $   #  #
### #### . #
## @     ###
##   #######
 #####
Solution: 3-3r2,3-1d3,1-3r2,3-6u3,2-2r6,9-1d1,5-3l1,3-4u1,2-2r3,7-3l3,3-4u1,9-2d1,5-2r3,2-2r4

;16
#####  #######
##  ####  ####
##    #  $   #
## #  #  ### #
#  # ###   #.#
#  #     $ #.#
#  #  ###  # #
## #  # ## #@#
#  ####  # # #
#        # #.#
#  ##### ###.#
###### #$$ # #
     #       #
     #   #   #
     #########
Solution: 10-2l1u1l1d3r2d2l1u1l4d1l1u3r1u1l2u1l1d3,8-10d1,9-12l1d1l2u1r4u1l1,8-10d1r1d1l1,10-4l1,8-3d1,7-5r1,10-12r1d1r1u8,6-12r5d1r1u7,2-4d4l1d1r6u1r1d3r1d1l1d1l2u1r5d1r1u3,10-5l5d1l1u3r1u1l2u1l1d7l1d1r6u1r1d3r1d1l1d1l2u1r5d1r1u2

;17
#######
###   #
##.$. #
# $.$##
# .$. #
# $.$ #
##   @#
#######
#######
Solution: 2-6u1,1-3r1d1,1-5r1,4-4l1,2-2r1,5-2l2d1,4-4u1,4-6u1,2-5r1u1,5-5l1

;18
#######
##    #
##.$. #
# $.$ #
# .$.##
# $.$ #
##   @#
###  ##
#######
Solution: 2-6u1,5-5l1,4-4u1,1-3r1d1r1d1,4-3l1,2-4u1,3-7u1,2-6u1,3-1d1

;19
#######
##    #
##.$. #
# $.$##
# .$.##
# $.$ #
##   @#
####  #
#######
Solution: 2-6u1,5-5l1,1-3r1,4-2d3,4-2l1,4-7u4,2-5r1,2-3d1r1,2-6u1,5-5l1

;20
#######
###   #
##.$. #
# $.$##
# .$.##
# $.$ #
##   @#
##  ###
#######
Solution: 2-6u1,1-3r1,2-2r1,5-2l2,4-2d1l1d2,3-7u2,5-5l1u2,1-3r1d1r1d1,4-6l1,1-5r2,2-7u2,5-5l1

;21
     ####
 #####  #
 #  $   ##
 #  # #$##
 ##. . .#
  #$# #$####
###. . .   #
###$# # @  #
  #   $  ###
  #  #####
  ####
Solution: 7-4d1,6-6r2,7-2d2,3-2r3,7-1d1,3-6u2,3-8u2,7-8l1,6-8l2,3-9u1,7-4d2,7-2d2,3-4u1,2-2r4,3-6u1,3-8u1,7-4d1,7-1d2,8-6l2,5-7u2,10-6l4,7-8u1

;22
 #########
##  #  ####
##.$#  *  #
#   @ * * #
#   #  *  #
######* ###
    ##   ##
    ##   ##
     #####
Solution: 6-4d1,7-5u1,8-2l1d1l4,5-2r2,6-7u3,7-3d2,6-2d1,5-4r1,7-3d1,1-3r1,2-3r3,6-4u1,3-1d1,2-3r3,7-3l4,2-4u1,9-2l1,6-1d1,8-6l1u1,6-7u1

;23
###########
#  ##     #
# $   $ #.#
#  ### ##.#
## ###  #.#
# $   $ #.#
#   ##  #.#
### #####.#
###$#  $ .#
#         #
# $#  # @ #
#     #   #
###########
Solution: 7-2l1,6-6u1,3-7d1,1-5r1,2-1d1,4-2r1,2-9r5,8-8d1,2-2d3,1-6r1,2-5r1d3,2-9r5,6-8r1,7-2l4,2-1d4,1-6r1,3-5d3,2-9r2,5-8d1,6-3d1,6-6u1,5-5l2,2-4d1,1-6r1,3-5d3,2-9r3,6-3d1,7-5l4,2-4d1,1-6r1,3-5d3,7-10r1,9-11u8,7-9r1,9-10u6,7-8r1,9-9u4,5-9r3,9-10u4,5-11u1,4-9r4,9-10u3,2-9r6,9-10u2,2-11u1,1-9r7,9-10u1

;24
      ###
      ###
      ###
     #   ##
   ##  . ##
   ## $*$  #
###  $#.#$  ###
### .*.@.*. ###
###  $#.#$  ###
   #  $*$ ##
    ## .  ##
    ##   #
      ###
      ###
      ###
Solution: 8-7r1d1,7-6u1,9-5l1,6-7l1,5-5d1,7-8d1l1,9-10u1,9-9l1,6-10r1u1,9-10l1,9-9u1,4-9r2,4-6d1r1,5-9u1,4-9u1,8-4l1d1,5-5r1,5-4r1,10-8u1l1,9-5d1,10-5d1

;25
   ####
   #  ##
   #  ###
   #  . #####
  ## $*$    #
 ## $#.#$   #
###.*.@.*.###
#   $#.#$ ##
#    $*$ ##
##### .  #
    ###  #
     ##  #
      ####
Solution: 6-7d1l3,5-6l1u3,6-5u1r3,7-6r1d3,6-8r1,8-9u2,9-7u1l1,9-4d1,8-6u1,9-4l2,7-3l1d1,4-3r1,4-6d1,3-8r2,5-9r1u1,8-9l1,6-4l1,4-3d2,3-5d1r1,3-8u1,4-1d4,11-4l4,8-11u4,1-8r4

;26
########
#  #   #
# $$*. #
# .  . #
# .*$$@#
#   #  #
########
Solution: 5-5u2,3-5u1r1,2-1d2,4-3l1,4-1d2,2-2r1,5-5u1l1

;27
#########
#   @   #
#.$$.$$.#
#$..$..$#
#   #   #
#########
Solution: 6-1d1l1,3-1d1r2,1-2r2,3-4u1,5-3l2,1-4u1,3-1d1,5-2l1,7-2l1,7-4u1,5-1d1,2-2r1

;28
       ####
###### #  #
#    ###$ ##
## @ ... $ ##
 ## $###    ##
  #  # #     #
  #### #######
Solution: r5d1r2u1l6r5u2l1d2l4u1l3r1d1r6u1r1d1r1d2l2u2l5d2r1u1l1u1r5d2r2u2l4r2d2r1u1r1u1l3r2u2l1d1r1d1l1

;29
#######  ####
#     #  #  #
## $  ####$ ##
 ## $ .... $ ##
  ##  ####  @ ##
   #  #  #     #
   ####  #  ####
         ####
Solution: 4-2d1,12-3l7,10-1d2,2-2r1,3-3r7,11-2d1,10-3d1r1,12-3d1,3-2r1,5-1d1,4-3r6,11-4u1,4-5u1,3-3r7,12-3l5,10-6u2,11-3l3,11-1d1,12-3l1,11-3l2,13-5l2,10-6u2,11-3l1

;30
 #######
 #  ####
 #   $ #
##$#.#.#
#  #@# ##
# $#.#. #
#    $  #
#### #  #
 ###   ##
 #######
Solution: 4-6r1,6-5d1,2-4d1,1-6r3,6-8u1,2-2d3,1-6r1,6-2l3,2-1d3,6-7u3,4-6r1,2-6r2,6-5d1l2,6-8u2,2-6r2,6-6l1,4-7u3,2-4d1,1-6r3,6-6l1,4-7u1

;31
########
# .  . #
#.$$$$.#
# $..$ #
# $.+$ #
#.$$$$.#
# .  . #
########
Solution: d1r1,3-4l1d1,3-3u1l1,4-3r1u1l1,4-1l1d1,5-5u1,6-4u1,2-5r1,3-6r1u1,6-3l1,2-2d1,1-3d1r1

;32
    ####
    #  #
  ###$.##
###     #
# .  *  ###
# $ *@* $ #
### *** . #
  #     ###
  ##.$###
   #  #
   ####
Solution: u1r1u1l1d1l2d3r4u3l2d1l1u1l1d1r2u1r2d1l2r2d1r2u1l2u1l2r2d3l2u1r2u2l2d1u1r1d1u4l1r1d3l3d1r2u1r1u3l1d2r1d1l1d1l2u2r2d1r1u1l3r3d1r1d3l3r3u4l4d1r2u1r2d4l2u2d2l1d2r1u2r2u4l3d4l1r1l1r1u3l3d1r2u1r1u1r3d4l4u2d2r4u4l3d1l1r1d1l1d2r4u4l3d2r1u1d1l2d2r4u4l2r2d1l2d1l2u2d2r2u4r1d2l1d2l2u2r2l1d1l1d3r4u3l1u1

;33
   ####
   #  #
   #  #
   #  ########
#####$@$ $ $ #
#    **....  #
#   ## #######
#####   ##
    #    #
    ##   #
     ##  #
      ####
Solution: d3l1d1r1u1r1d1u1l1u2l3r2u2d2l2d1l2u1r4u1r1d3l1r1u2r2l3u2d2u2l1u2r1d3r1d1l3r6l1u1l2d1l1u2d2r5u1l3r1d1r4u1l3d1l6d1l2u1r8l4r5l4r1u1r1d1l3u1r1l1u1l1u2r1d3r1d1l3r5u1l2d1l1u2d1r1d1r4u1l2d1l5d1l2u1r7l3u2l1u2r1d3r1d1l3r5u1l2d1l1u2d1r7d1l1u1l6d1l2d1l2u1r6l2u2l1u2r1d3r1d1l3r4l1d2r1d1r1d2l1u1l1u4r1u1l1d1l1u2d2l2d1l2u1r5l1u2l1u2r1d3r1d5r2u1l1d1l1u3

;34
#######
#  # @#
# $.$ #
# .$. #
# .$. #
# $.$ #
#  #  #
#######
Solution: 4-1d1,4-4l1,3-4u1,2-1d1,1-5r1,2-2r1,4-6u1,5-2l1

;35
#######
#  @  #
# $ $ #
##.*.##
##   ##
# $.$ #
# .$. #
#  #  #
#######
Solution: d3r1d1r1d2l1u3l2d1l1d2r1u1r1u1r1u1l1d2l2u1r1d1r1l1u2r1u3l2d1r1d3u4r1d1u1r2d1l2u1l1d1

;36
 ######
 # @  #
 # *$ #
 # .###
## $$ #
#  .. #
#   ###
#  ##
#####
Solution: 3-3d1,3-1d1,5-2l2,2-1d4,3-4u1,2-2r1,2-7u1,3-6u3,5-4l2,1-5r1,2-5r1,2-3d1,1-5r1,3-1d1,5-2l1

;37
    #####
#####   #
## .**@ #
#  $   ##
# ## ####
#    #
######
Solution: 5-1d1l1,2-2r3,7-2l1,6-3l1,5-1d1,4-4u1,3-2r2,2-3r1,4-2d1,7-2l3,2-2r3,7-2l1,6-3l2,4-2r1,4-5u2,5-2l1,2-3r1,4-4u1,7-2l1

;38
#####
#   ###
#  @  #
##$*#.#
 #  $$#
 # .. #
 #  * #
 ######
Solution: 2-2d2,3-4u1,2-6u1,5-6l1,3-1d1,5-3d1l1,2-5u2,4-4l1,3-2d1,2-5u1,3-3d1,5-6u2,2-6r1,2-5r1,1-2r1,3-1d3,2-4u1,1-2r1,3-1d1

;39
 #####
 #   #
##   ###
# **.. #
#  $ $@#
#  ##  #
########
Solution: 2-2d1,2-5u2,2-4r1u1,2-1d1,2-2r1,1-3r1,3-4u1,5-5u1l2,4-1d1,3-1d1,2-5u1

;40
    #
 #######
 #  #  #
 #@ $  #
 #  *. #
###* *###
 # .*  #
 #  $  #
 #  #  #
 #######
    #
Solution: r2d1r1d2u2l2d2u2d2l1d2r1u4l1u1r1d1r2d1l1u1l1d2u2r3u2l1d1l1d2r1d1r1d1u1l1u2r1u1l1d3r1d2l1u4l2d2r1u1r1d1l3d2r1u2r3d2l1u1l1u1l2d2r1u1r3u1l1u2r1u2l1d2l3u2r1d1r1d1r2u2l1d1l3d1r1

;41
       ########
#########   ###
## ....   #   #
#  #@###    # #
# $$$$ # #    #
#      #   # ##
##########   ##
       ########
Solution: 4-5u2,3-2r5,9-1d1,8-3r1,9-3r1,11-2d1,10-4r1,6-4l1,4-5u1,4-4u1,3-2r5,9-1d1,8-3r2,13-4l2,10-5u1,11-2d1l2,8-2d1,10-4r1,13-4l2,10-3d1,2-5u1r2,2-2d1,1-4r2,4-5u2,3-2r5,9-1d1,8-3r2,11-2d1,10-6u1,8-5u1,6-4l1,4-5u2,3-2r5d1,8-5u2,9-1d1l5,10-3l1,8-4u1,9-2l4,10-5u1,11-3l2,8-4u1,9-2l3,12-4l1,10-5u1,11-3l2,8-4u1,9-2l2

;42
   #####
   #   #
####   #
#  ..$##
#  ..$ #
##$#@# #
# $    #
#   ####
#####
Solution: 6-4l1u1,3-4r1,6-4l1,4-5u1,3-3r1,1-6r1u2,4-6l1,1-3r1,6-2l1,4-1d3,2-7u1,5-4u1,2-3r2,2-6u1,1-4r1,4-4d1,5-6l2,2-7u3,1-3r1,6-2l1,4-1d3,5-4u1,4-6u1,6-2l1,4-1d1

;43
     #####
  ####   #
  #   $  #
###  #$###
#  * .  #
#   * #@#
#####.  #
    #####
Solution: u1l2d1l2u1r1u2r2d1u1l2d3r1d1r2u2l2r1u2l2d2u2r2u1r2d1l1u1l1d2u1l2d2r1d2r2u2l1u2l2d2l1d1r1u3r2d2l1d1l2u1r1l3d1r2u1r1u2l1d1

;44
     #####
 #####   #
 #  # $# ##
## **  *  #
#  *.@#   #
#  ** #   #
##   ######
 #   #
 #####
Solution: l1d1u1l1d1l2u1r1d1u1r1l1u2r1d1l1d2r3u2l1r3d1r2u1l4d2u3d1r3u2l2d1l1d1r1l1d2l4r1d2r2u1d1l1u1

;45
  ####
 ##  #######
##  * $ #  #
#  * *  ** ##
#     #@.*  #
###  ## **  #
  ######   ##
       #   #
       #####
Solution: 8-4d1,8-4r1d1,11-4l2,9-2d1,7-3r1,6-3l1,5-2l1,4-2d1l1,4-5u1,3-3r4,3-1d1,2-2d1r1,7-2l3,3-1d1,3-4u1,2-2r1,3-2r2,5-3l1,3-2d1,7-2l2,4-1d1,3-3r1,3-5u2,1-4r2,3-1d1,4-5u2r1,7-3l1,8-7u1,9-7u1

;46
       ####
       #  ###
       # .. #
       # $$ #
    ##### ###
    ##  #   #
    #       #
 ####  ##$.##
 #  ##@##  #
##.$##  ####
#       #
#   #  ##
### #####
# $$ #
# .. #
###  #
  ####
Solution: u2r4d2l1u1r1u1l3u1l1d4r1d1l4d1l2u1r4d1r1u4l1u1r4u1r1d1u1l1u2l1u2r1d4r1d1l3r2u4r2d1l1u1l2d1r1u1r2l2d6r1u2r1l2u4r2d1l1u1l1d4r2u1l1d1l1u3l1u1r1d4r1d2l1u5d3l2u1l1d4r1d1l4d1l2u1r4d1r1u4l1u1r4u1r1d1l4d4l3d1l1u3r1d1l1d1r3d1r1u4l1u1r4u1r2d1l4u1l1d4r1d1l4d1l1u1r1d3r1d2l1u4l1u1r3d1r1u4l1u1r4l3d5u1l3d4l2u1d1r2u6l1d2r1d4l2u1r1d1r1u4l1u2r1d5r1d1l1u4l2d1r1u1r1d3u4d1r3u4r3u1r2d1l4u1l1d4r1d1l4d1l1u1

;47
 ####
##  ###
#  .  ##
#  .#  #
# $*$$ #
###.  ##
  #  @#
  #####
Solution: l2u3l2d1r1u1r1d1l1u3r1d1r2d2l2u1d1r2l2u1l1u1r1d2r1d2l1u3l2d1r1u1r1d1l1u3r1d1l1d2r3u2l2u1l1d1r3d2l1d2r1u1l1u1l3u2r1u1d1r3d1r1d1l2r1u2l4d2r1u1l1u1r1

;48
 #######
 #  #  ###
##.$# .. #
# .$  $$ #
#   ## ###
######   #
# .      #
# $ @#$.##
###  #  #
  #######
Solution: u1l3d1r2d1r1l1u2r4d2l1u1r1u1l4r5l5d1l2u1r5u1r1d1l2r1u3l1u2r1d4r1d1l4r4l1u3l2r2d5r1u2l1u4r2d1l1u1l1d4r2u1d1l2u3l3d1l2u1r5l4u2r1l1d2r4u1r2d1l5r3d3r2u1l1d1l1u3l1u1r1d4r1d2l1u5d3l3d1l2u1r5u1r1d1l1u3l1u2r1d4r1d1l4r3u3l3d1u1r4l1d5r1u2l1u3l3d1l2u1r4u1r1d4u3l1r3u1l2d1l4u2r1d1l1d1r4u2l1d1r1d1l3d1l1u1r3u1r3d1l5r4l1d3r2u1l1d1l1u3l1u1r1d3r1d3l1u5d3l3d2r1u1l1u1r3u1r1d1

;49
#########
#   #   #
# # # # #
#  *$*  #
###.@.###
#  *$*  #
# # # # #
#       #
#########
Solution: l1u1d1r2u1d2u1l2d1r2l4d2u2r1l1d2r2u1d1l2u2r2u2l2u2r2d4u1r2u1l1d1l1d1l2d2r4u2l2r2d2l2u2d2l2u2r1l1d2r4u2l2r1u2r1d2u2r2u2l2d2l1d2r1u1d1l2d2r2u2d2r2u2l1r1d2l6u2r1

;50
 ####
##  #####
#  * .  #
#  $.$# #
#  * *@ #
## $.$. #
###  #  #
#########
Solution: r1u2l4u1l1d1r2d3r1l1u3r3d2l2u1l1u1l3d2r1u1r1l1d2r1l1u2r1u2l1d1l1d2r1d1r1u2d1r1l3u2r1d1l1d1r1

;51
  #####
 ## . ##
##.$ $.##
# $ * $ #
#. *@* .#
# $ * $ #
##.$ $.##
 ## . ##
  #####
Solution: undefined

;52
 #######
##     ##
# $.$.$ #
# .$.$. #
# $.@.$ #
# .$.$. #
# $.$.$ #
##     ##
 #######
Solution: d1l1d2u2r1l1d2r1u1l1u2r2d1u1l2d3r3u1r1u2l1r1d2l1d1l3u3r1u1r1u2l3d1l1d4r1l1u2r1u1r1u2l1d1u1r3d1l1u1l2d1l1d4r1d1r4u1r1u4l1

;53
    #####
    #   ####    #####
    #      #    #   ######
    ## $$  #    #        #
   ####  $##    ## ...  .#
   #   $$ ##     ##  #. .#
#### ## #  #      #  #.  #
#   $## ## ############ ###
# #    $                  #
#   ### ### ###########   #
##### #  @  #         #####
      #######
Solution: r2u2l1u2l1u3r1u1l3r3l1d3u1l2d1u1r2d2r1d2l6r9l3u2l1u2l2d1l3d2l3d2r2u1r20d1r2u1l1d1l1u5r1u1l5r4d3u3l4u1l2d1r1u1r1d1l1d1r1u1r4d6u1l19u3r3d2u2l3d3r19d1r2u1l1d1l1u5r1u1l5u1l2d1r1u1r1d1r4d5l20d1l2u2r2d1r4u3l3d2l1d1r20d1r2u1l1d1l1u5r1u1l5r4d6u1l18r5u2l1u1l1u1l1d3u2l3d3r19d1r2u1l1d1l1u3r1u1l1u1l1d1r2l1d4u1l13u2l1u4l2d5u2l3d3r19d1r2u1l1d1l1u3r1u1l1d3l16u6r1d2r1d1l1u1l1d3u2l3d3r19d1r2u1l1d1l1u4r1u2l3d1r1u1r2d1l1d4u5l3d1u1r3d1l1u1r2l1d5l20r4u7l2d1r1u1r1d6u2l3d3r19d1r2u1l1d1l1u4r1u2l2d1r1u1r1d1u1l4d1r3l3u1l1u1l2d1r1d1r2l1d2r1u1l1u1l1u2r1d1

;54
        ####
#########  #
#      . . #
# $$$   #  #
### #### . #
  #@     ###
  ########
Solution: 3-2d1,3-3r2,1-3r2,3-5u2,2-2r6,9-1d1,5-3l1,3-4u1,2-2r2,7-3l3,3-4u1,9-2d1,4-2r4,2-2r4

;55
   ####  ####
####  ####  #
#   $   ... #
#  $ $   #  #
#### #### . #
  # $  @  ###
  #   #####
  #####
Solution: l2d1l2u1r1u2r2u1r4d2l1d1l3r3u1r1u2l5d1l2r2u2l1d1l1d1r1u1l2r9d2l2d1l4d1l1u3l1u1r6l8d1u1r5l2d3r5u1r2u3l1d1l9d1r2u1r8d2l2d1l5u2l1u1r3d1l3r2l1d2r5u1r2u2l3d1l2r1l2r3u1r3d2l2d1l5u2l1u1r1l3d1r2u1r1d1r2u1l3r2d1r3u1r3d2l2d1l5u2r4u1r2d1u1l2d1l2u1r3l4d1l2u1r5l5d1l2u1r6

;56
########
#   #  ####
# # @     #
# # $ $$# #
#  #*##   #
##  *.  ###
 ##.. ###
  #  ##
  #  #
  ####
Solution: l1u1l2d3r1d1r2l2u1l1u3d1u1r2d1r6d2l2u1d1r2u2l4d1r1u1r3d2l2u1d1r2u2l2d3l2d1l2u1d1r2u1r2u2l2u1r2l1d1r1d2l2d1l2u1l1u1l1u3r2d2r2l2u2l2d3r1d1r3l3u1l1u3r2d2r1d2r1d1l1r1l1u3r1u1r2d3l1r1l2r2u3l2d1l1d2u2l1u1d1r2u1r2d1l2r2d2l5u1l1u3r2d1r1d2u1l1u2l2d3r1d1r2u2r2u2l1d1r1d1l1u1l1d2u1r3d1r2u2l3u1l1d1r1d1l1u1l1d1

;57
 ############
 #   #      #
 # #  $$#$# ##
 # #         #
 # ### ##### #
 # @# .... # #
##  # .... # ##
#  ######$##  #
#  $  $    $$ #
####   #   #  #
   ############
Solution: l1u4r2d2r8d4r1d2l1u1l2d1l2u1r2l4d1l2u1r4d1r2u1l2r1u2r1u1l2d1l2u3r6d4r1d2l1u1l2d1l1u3l3u3r6d4r1d1l3d1l2u1r2l1u2l1u1l1d1l2u1r1u2r6d5l2r2u5l6d3r2u1d1l2u3r6d5l2d1l2u1r2l1u2l3u3r5u2l5d1u1r5d2l5d3r2u1l1d1l1u3r2l2d3r4u1l2r1d1u1d1l3u3r6d5l2d1l1u2d1u2r1u1l1d3r3u5l1u2l5d4l1d1r2l1u4l2d1r1u1r1d3l1d1r1u5r1d1u1r4d2l4u1l1d3u4r3d1u1r2d2l4u1l1d2u1r6d5l6d1l2u1r4d1r1u3d2r3u5l8u2l2d7r6d1r1u2

;58
#######
#     #
#.### ###
#.# $ $ #
#.#  $  #
#.# $ $ #
#.###@ ##
#      #
#  #####
####
Solution: 5-3d2,6-6u1,3-3r1,5-4u1,7-4l2,3-5r1,5-1d2,4-5r1,5-3d1,6-6u1,7-3l1,5-2d1,4-5r1d1,6-7l2,4-7l2,1-8u5,5-3d3,6-7l4,1-8u4,3-4r1,5-3d3,6-7l4,1-8u3,7-4l1,5-3d3,6-7l4,1-8u2,7-5l1,5-4d2,6-7l4,1-8u1

;59
#######
#     #
#.### ###
#.# $ $ #
#.#  $  #
#.# $ $ #
#.## @###
#     #
#  ####
####
Solution: undefined

;60
#######
#     #
#.### ###
#.# $ $ #
#.#  $  #
#.# $ $ #
#.#@ ####
#    #
#  ###
####
Solution: undefined

;61
#####  #######
##  ####  ####
##    #  $   #
## #  #  ### #
#  # ###   #.#
#  #     $ #.#
#  #  ###  # #
## #  # ## #@#
#  ####  # # #
#        # #.#
######## ###.#
#    # #$$ # #
# ## #       #
#    #   #   #
##############
Solution: u5l3u1l1d3r2d2l1u1l4d1l1u3r1u1l2u1l1d3u2r2d3r1l1u3l2d2l1d2r1d3r6d2u2l6u3l1u2r1u2r2d3r4u3r4d11l2u1l2r4u10l4d3r2u1l1d1l5u3l2d2l1d2r1d3r6d3r4u10l4d2r1d1l4r3u3r4d11l1u1l3u3l6u3l1u2r1u2r2d3u3l2d2l1d2r1d3r6d4l2u1r4u1l1r1d2r2u11l4d3l4u3l2d2l1d2r1d3r6d2r1d1l1r3d1r1u8d7l4d1l2u1r5d1r1u7d6l4u3l6u3l1u2r1d4l1d1r6u1r1d3r1d1l1d1l2u1r5d1r1u3d2l4u3l6u7r2d3r1d2l1u4r1u1l2u1l1d7l1d1r6u1r1d3r1d1l1d1l2u1r5d1r1u2

;62
#########
###    ##  ####
#    * ##  #  #
# ****  ####$.##
#  *@*      $. #
#  **** ####   #
## *    #  #####
##    ###
#########
Solution: undefined

;63
    #####
    #   #
   ##.$.##
  ## $ $ ##
### $.$.$ ###
# .$.*.*.$. #
# $ $.#.$ $ #
# .$.*.*.$. #
### $.$.$ ###
  ## $ $ ##
   ##.$.##
    # @ #
    #####
Solution: undefined

;64
 ####
 #  #######
 # $* #   #
 #  ..$ # #
### # *   #
#   * #@###
# # $..  #
#   # *$ #
#######  #
      ####
Solution: d1l2u2r2l2d1l2r2u1r2d2r1d2l1u1r1u1l1u2l2u1l2d3r1u1r1u1r2u1l2r2u1r2d2l2u1l2d2l2u2r1l1d4l2u2r2u2l1u2r1d1l1d1r1

;65
 ####
 #  ###
 # $* #######
 #  . $ #   #
### # . $ # #
#   .*#*.   #
# # $ . #@###
#   # $ .  #
####### *$ #
      ###  #
        ####
Solution: d1l2u1l3u1l3d2r2u1r1u1l1d1r3l3u3r2d1r3d1r3u2l2d1l1d1r1u1l2u1l2r1d1r3d3l2u2r1u1l1d2l2d1r2u2r2l2u2l2d2l1d1r1u4d1r2d1r2u1r2d2l3r1d2r1d2l1u4r2u2l2d1u1r2d2l2u1l2u1l2d3l2d1l2u2r3l1u2l1u2r1d4l2d2r2u1d1l2u2r2

;66
  #######
###  #  ###
#   $*$   #
# # .$. # #
# #$.+.$# #
# # .$. # #
#   *$*   #
###  #  ###
  #######
Solution: undefined

;67
  #######
###  #  ###
#   **$ $ #
# # .$.   #
# ##.+ ## #
#   .$. # #
# $ **$   #
###  #  ###
  #######
Solution: undefined

;68
########
#   #  #
#  $*$ #
#  .$. #
###.  ###
 # .@.  #
 # $*$  #
 #  #   #
 ########
Solution: undefined

;69
 #######
 #     #
## **$ ##
# $.$.  #
# #.@.# #
#  .$.$ #
## **$ ##
 #     #
 #######
Solution: undefined

;70
    ####
#####  #
# $ $$ #
# ..*  #
##. $# #
 #..@  #
##. $# #
# ..*  #
# $ $$ #
#####  #
    ####
Solution: undefined

;71
     ####
 #####  #
 # $ $$ #
 # ..*  #
###.#$# #
# $..@  #
#  . $###
###.  #
  ##$ #
   #  #
   ####
Solution: undefined

;72
     ####
   ###  ###
  ## $$ $ #
 ## ...   #
 # .## $ ##
##$.$.*$##
# $.##.  #
#   ...  #
## $ $$@##
 ###  ###
   ####
Solution: undefined

;73
   #####
   #   #
####   ###
#  $$$$$ #
#   . .  #
## #.#.###
 # #*+.  #
 ###.#.# ##
 #  . .   #
 # $$$$$  #
 ###   ####
   #   #
   #####
Solution: r2l2r1d2l2u2r2d3r1u1l3d1r1d2u3l3d1r1u1r2d1l1r1d2l1u3l2d1r1u1r1d1u1r2u2d2r1d1u1l1u2l2d1u1r2d2r1d1u1l1u2l2r2d2l1d1l3u1r2u2r2d2r1d1l3u1r1d1r1u2d1r2u2l2u2l2d1u1r2d5l1d2r1u3l4d1r2u1r2d2l1u1r1u1l1d1l1u1r1d3l1u2r2u1r3d1l2u1l2d2r1u1r2u3l2u3d1l2u1d1r2l2u1l1r1d1r2u1l1u2r1d4u1r2u1l1d1l2u2r1d2l4r1u1r2u1r1d1r1d1l2u1l1d1l3u1r4u1r1d1u2l2d2

;74
####
#  #####
# @$ $ #
# ...  #
##$.$ ##
 # .$##
##$. ###
# ...  #
# $ $$ #
#####  #
    #  #
    ####
Solution: undefined

;75
   ####
   #  #####
   # @$ $ #
   # ...  #
#### $.$$ #
#   ##. ###
#   .$.##
### #.  #
 #  $ $ #
 #  #####
 #  #
 ####
Solution: undefined

;76
    ####
#####  #
# $.$ *#
#  . . ###
###*. $$ #
 # .@.   #
##$. $.###
# $ #$ #
#      #
########
Solution: undefined

;77
####
#  #
#  ###
# $$@#
## . #
 #$.##
 # .#
##$.####
#  ... ##
# $ $$  #
#  ##   #
#########
Solution: d1l2u1d1r1d4r3d2l1u1l1u1l3d2r1u1l1u1r2l1d1r3d1r2u1l4u1l2d1r4l3r1u3l1d1r1d2l2u1r1d1r1l1r1u1l1u2r1u2l1d4l1d2u2r1u5l1u2r1d3r2u1l1d1l1u1r1d3l1d2r1u4d4u4l1d2r1d3u1l2d2r1u1l1u1r1d1r1u3l1d1r1d2l2u1r1d1r1u1l1u5l1u2r1d7u4r2u1l1d1l1u1d3r1u1l1d3r1u2d2l2d2r1u1l1u1r1d1r1u2l1u4l1u2r1d7l1d2r1u1l1u1r1d1r1u1d1r2d1r2u1l4u1l2d2r1u1l1u1r1

;78
      #######
      #     ##
      # $ $  #
  #########  #
### $ *.$.* ##
#   $ . . . #
# $ #@.#.#.$#####
#   # . . . #   #
##### * $ *  $# #
   #  ######    #
   #  $ $ ## # ##
   ##     ##   #
    ############
Solution: undefined

;79
#############
#    ###    #
# $$ $ $ $$ #
### .#@#. ###
  # ..  . #
  ##.#*#.##
  # .  .. #
### .# #. ###
# $$ $ $ $$ #
#    ###    #
#############
Solution: undefined

;80
 #####
 #   #
 # # ####
 # $.*  #
 # .$ * #
###*#$.@#
#  .$ * #
# #$.*  #
#    #  #
#   #####
#####
Solution: undefined

;81
    ####
    #  #
    # $#
  ###  #
  # $ $###
  # ..$  #
  ##.@*  #
   #.. ###
####.$$###
#   . $  #
#   ##   #
######  ##
     #  #
     ####
Solution: undefined

;82
 #####
 #   ####
 # # #  #
 # $.*  #
 # .$ * #
###*#$.@#
#  .$.$ #
# #$.$. #
#    #  #
######  #
     ####
Solution: undefined

;83
###########
#   @ #   #
# $ $ # # #
####$...  #
   # .# * ###
   #$...$#  #
   # .#.$ $ #
   #$.$$.   #
   #  #  ####
   ####$ #
      #  #
      ####
Solution: undefined

;84
 ####
 #  #####
 #  $ $ #
## #*.. #
#  .   ###
# $$..$$ #
###   .@ #
 # ..*# ##
 # $ $  #
 #####  #
     ####
Solution: undefined

;85
     ####
  ####  #
  #  #  #
  # $$$ #
###.....#
#  #$.$##
#   $. ###
# $  . @ #
####$.$  #
   #  ####
   ####
Solution: undefined

;86
    ####
 ####  #
 #  #  #
##$.#$.###
# $.$ .  #
#  .#$.$ #
##$.@ .$##
 # $*.  #
 ##   ###
  #   #
  #####
Solution: undefined

;87
 #######
 #  #  ##
 #.$#$. ##
 #.$ $.  #
 # . . $ #
##$.#.$###
# $ . $ #
# @ #   #
##  #####
 ####
Solution: undefined

;88
    ############
   ##     ##   #
   #  $ $ ## # ##
   #  ######    #
##### *   .  $# #
#   # .#.#. #   #
# $ #@.#.#.$#####
#   $ . . . #
### $ $.$.$ ##
  #########  #
      # $ $  #
      #     ##
      #######
Solution: undefined

;89
 #######
 #     #
## #$# ##
# . $ . #
# $. .$ #
### * ###
# $.@.$ #
# . $ . #
## #$# ##
 #     #
 #######
Solution: undefined

;90
#######
#  #  #
#.$#$.###
# * *   #
#  .  $ #
## * ####
#  * #
#  @##
#####
Solution: undefined

;91
#########
#   ##  #
#  ..*$@#
## $ .  #
 ###.####
 # .   #
 # ***$#####
 #   $     #
 ####$#    #
   #  ###  #
   #      ##
   #####  #
       ####
Solution: undefined

;92
       #
 #############
 #  .     .  #
 # .$.$$$.$. #
##.$$$.*.$$$.##
 # .$.$$$.$. #
 #@ .     .  #
 #############
       #
Solution: undefined

;93
      # #
 #############
 #    .$.    #
##.$  $.$  $.##
 #$.*** ***.$#
##.$  $.$  $.##
 #@   .$.    #
 #############
      # #
Solution: undefined

;94
      ###
 #############
 #  $.   .$  #
##  * .$. *  ##
##  $.$*$.$  ##
##  * .$. *  ##
 #@ $.   .$  #
 #############
      ###
Solution: undefined

;95
     # # #
 #############
 # $       . #
 # .**   **$ #
## *  ***  * ##
 # $**   **. #
 #@.       $ #
 #############
     # # #
Solution: undefined

;96
     ## ##
 #############
##   .   .   ##
## $$*$$$*$$ ##
 #.....*.....#
## $$*$$$*$$ ##
##@  .   .   ##
 #############
     ## ##
Solution: undefined

;97
   ### # ###
 #############
 #     .     #
## .$ $$$.$. ##
##*$.$...*.$*##
## .$.$$$ $. ##
 #@    .     #
 #############
   ### # ###
Solution: undefined

;98
  # # # # # #
 #############
##  .  .  .  ##
 # $$* $$* $ #
##.*.* * *.*.##
 # $ *$$ *$$ #
##@ .  .  .  ##
 #############
  # # # # # #
Solution: undefined

;99
  ## ## ## ##
 #############
##  . . . .  ##
## $.$.$.$.$ ##
 #*$$$ * $$$*#
## $.$.$.$.$ ##
##@ . . . .  ##
 #############
  ## ## ## ##
Solution: undefined

;100
  ### #### ###
 ##############
##            ##
 #$.$  .$.$.$.#
##.$.$.$.$.$.$##
##$.$.$.$.$.$.##
 #.$.$.$.  $.$#
##@           ##
 ##############
  ### #### ###
Solution: undefined

;101
  ## # ## # ##
 ##############
##            ##
##**.**$$$*.**##
 #  $. ..$.$  #
 #  $.$.. .$  #
##**.*$$$**.**##
##@           ##
 ##############
  ## # ## # ##
Solution: undefined

;102
  ####    ####
 ##############
##   ..  ..   ##
## $*$*$$$$*$ ##
 # *. .. .$.$ #
 # $.$. .. .* #
## $*$$$$*$*$ ##
##@  ..  ..   ##
 ##############
  ####    ####
Solution: undefined

;103
  #####  #####
 ##############
## $ . $. $ . ##
##  $ $.$. .  ##
##.$.$.  $.$.$##
##$.$.$  .$.$.##
##  . .$.$ $  ##
##@. $ .$ . $ ##
 ##############
  #####  #####
Solution: undefined

;104
                      ####   ##### ####
    #####  ########   #  #   #   ###  #
    #   ####  #   #####  #   #        #
#####         #          ######## ##  #
#   #####     ## ###### ##  #   #  # ####
#         #####  #   #      #      # #  #
## ###### ##  #      #   #  ## ##  # #  #
 # #   #      #  ## ###### ###  #### #  #
##     #   #  ####  #   #       #  # # ##
#  ## ###### ##  #      #   ##  #      #
#  #  #   #      #  ## ##########  ##  #
#  #      #   #  ##### ##    #  ## ##  ##
####  ## ###### ##  ## #     #      #   #
   ##### ##  #         #  ####  #   #   #
   #   #  #  #   ##  # ## #  ## #########
   #      #  #########  # #      #   #  #
##### ##  #             # #  #   #      #
#   #  #####  ####  #  ## ## ###### ##  #
#      #  #####  ## ####  ##  #   #  # ##
### #  #          #  #    #   #      # #
  # ####  ### ##  #### ## #  ### ##  # #
  # #  ## ###  # ## ####  ## ###  #### #
  # #      #   #    #  #          #  # ###
 ## #  #   #  ##  #### ##  #####  #      #
 #  ## ###### ## ##  #  ####  #####  #   #
 #      #   #  # #             #  ## #####
 #  #   #      # #  #########  #      #
 ######### ##  # ## #  ##   #  #  #   #
 #   #   #  ####  #         #  ## #####
 #   #      #     # ##  ## ###### ##  ####
 ##  ## ##  #    ## #####  #   #      #  #
  #  ##  ########## ##  #      #   #  #  #
  #      #  ##   #      #  ## ###### ##  #
 ## # #  #       #   #  ####  #   #     ##
 #  # ####  ### ###### ##  #      #   # #
 #  # #  ## ##  #   #      #  ## ###### ##
 #  # #      #      #   #  #####$.@      #
 #### #  #   #  ## ###### ##     #####   #
   #  ## ########          #         #####
   #        #   #  #####   #  ####   #
   #  ###   #   #  #   ########  #####
   #### #####   ####
Solution: undefined

;105
                ####  ####
               ##  ####  ##
               #          #
               #  ##  ##  ###
   #### ######### #####  #  ######### #######
####  ###  #  ##  #  ##      ##  #  ###  #  ##
#      #       #      ##  #  #       #       #
#   #  #  ###  ##  #  ##### ##  ###  #  ###  ###
####  ###  #  #  ##  #  ##  ###  #  ###  #  #  ##
   #       #      #      #       #       #      #
   ##  #  ###  #  ##  #  ##  #  ###  #  ###  #  #
    ####### #### ###### ######### ####### #### ##
   ##  #  ###  #  ##  #  ##  #  ###  #  ###  #  #
   #       #      #      #       #       #      #
 ###  ###  #  #  ##  #  ##  ###  #  ###  #  #  ##
##  #  #  ###  ##  #  ##  #  #  ###  #  ###  ###
#      #       #      #      #       #       #
#  #  ###  #  ##  #  ##  #  ###  #  ###  #  ##
## #### ######### ###### #### ####### #######
#  #  ###  #  ##  #  ##  #  ###  #  ###  #  ##
#      #       #      #      #       #       #
##  #  #  ###  ##  #  ##  #  #  ###  #  ###  ###
 ###  ###  #  #  ##  #  ##  ###  #  ###  #  #  ##
   #       #      #      #       #       #      #
   ##  #  ###  #  ##  #  ##  #  ###  #  ###  #  #
    ####### #### ###### ######### ####### #### ##
   ##  #  ###  #  ##  #  ##  #  ###  #  ###  #  #
   #       #      #      #       #       #      #
 ###  ###  #  #  ##  #  ##  ###  #  ###  #  #  ##
##  #  #  ###  ##  #  ##  #  #  ###  #  ###  ###
#      #       #      #      #       #       #
#  #  ###  #  ##  #  ##  #  ###  #  ###  #  ##
## #### ######### ###### #### ####### #######
#  #  ###  #  ##  #  ##  #  ###  #  ###  #  ##
#      #       #      #      #       #       #
##  #  #  ###  ##  #  ##  #  #  ###  #  ###  ####
 ###  ###  #  #  ##  #  ##  ###  #  ###  #  # @ #
   #       #      #      #       #       #   $ .#
   ##  #  ###  #  ##  #  ##  #  ###  #  ###  ####
    ####### #### ###### ######### ####### ####
              #  ##  ##  #
              #          #
              ##  ####  ##
               ####  ####
Solution: 46-37l2d1l1u3r1u1l4u1l1d3r1d1l4d1l1u3r1u1l4u1l1d3r1d1l4d1l1u3r1u1l3d1l1u4l1u1r3d1r1u3l1u1r4u1r1d3l1d1r4d1r1u3l1u1r4u1r1d3l1d1r4d1r1u3l1u1r3d1r1u4r1u1l3d1l1u3r1u1l4u1l1d3r1d1l4d1l1u3r1u1l4u1l1d3r1d1l4d1l1u3r1u1l3d1l1u4l1u1r3d1r1u3l1u1r4u1r1d3l1r1l1d1r4d1r1u3l1u1r4u1r1d3l1d1r4d1u1d1r1u3l1u1r3d1r1u4r1u1l3d1l1u3r1u1l4u1l1d3r1d1l4d1l1u3r1u1l4u1l1d3r1d1l4d1l1u4r1u1l3d1l1u3r1u1l7u1l1d4l1d1r3u1r1d3l1d1r3u1r1d4r1d1l3u1l1d3r1d1l3u1l1d4l1d1r3u1r1d3l1d1r3u1r1d4r1d1l3u1l1d3r1d1l3u1l1d4l1d1r3u1r1d3l1d1r3u1r1d4r1d1l7d1l1u4r1u1l3d1l1u3r1u1l4u1l1d3r1d1l4d1l1u3r1u1l3d1l1u4l1u1r3d1r1u3l1u1r4u1r1d3l1d1r4d1r1u3l1u1r3d1r1u4r1u1l3d1l1u3r1u1l4u1l1d3r1d1l4d1l1u3r1u1l3d1l1u4l1u1r3d1r1u3l1u1r4u1r1d3l1d1r4d1r1u3l1u1r3d1r1u4r1u1l3d1l1u3r1u1l4u1l1d3r1d1l4d1l1u3r1u1l3d1l2u1r3u1r1d3l1d1r4d1r1u3l1u1r4u1r1d3l1d1r3u1r1d4r1d1l3u1l1d3r1d1l4d1l1u3r1u1l4u1l1d3r1d1l3u1l1d4l1d1r3u1r1d3l1d1r4d1r1u3l1u1r4u1r1d3l1d1r3u1r1d4r1d1l3u1l1d3r1d1l4d1l1u3r1u1l4u1l1d3r1d1l3u1l1d4l1d1r3u1r1d3l1d1r4d1r1u3l1u1r4u1r1d3l1d1r3u1r1d4l1d1r7d1r1u4r1u1l3d1l1u3r1u1l3d1l1u4l1u1r3d1r1u3l1u1r3d1r1u4r1u1l3d1l1u3r1u1l3d1l1u4l1u1r3d1r1u3l1u1r3d1r1u4r1u1l3d1l1u3r1u1l3d1l1u4l1u1r7u1r1d3l1d1r3u1r1d4l1d1r4d1r1u3l1u1r4u1d1u1r1d3l1d1r4d1r1u3l1u1r4u1r1d3l1d1r3u1r1d4r1d1l3u1l1d3r1d1l4d1l1u3r1u1l4u1l1d3r1d1l4d1l1u3r1u1l4u1l1d3r1d1l3u1l1d4l1d1r3u1r1d3l1d1r4d1r1u3l1u1r4u1r1d3l1d1r4d1r1u3l1u1r4u1r1d3l1d1r3u1r1d4r1d1l3u1l1d3r1d1l4d1l1u3r1u1l4u1d1u1l1d3r1d1l4d1l1u3r1u1l4u1d1u1l1d3r1d1l3u1d1u1l1d4l1d1r3u1r1d3l1d1r4d1r1u3l1u1r4u1r1d3l1d1r4d1r1u3l1u1r4u1r1d3l1d1r4

