;1
#########
#       ###    ###
# $ $ $ ##########
#  ## $          #
# #      ######  #
#  $ #$ ##    ## #
# $ $   #  ..  # #
# #   ### .  . # #
# # $ # # .  . # #
###$ $   $.... # #
# # $ ### .  . # #
# #  #  # .  . # #
# $ $#$ # .  . # #
#       ######## #
####  #    @     #
   ###############
   ####      ####
Solution: 4-11u1,5-10u1,8-9r3,12-10u3,3-10u1r7,11-10u3,5-7d1,4-9r5,10-8d3,4-13u3,3-9r6,10-8d2,4-7d1,3-9r6,10-10u2,1-12r2,4-13u3,3-9r7,11-8d1,12-10l1,4-5d3,3-9r7,11-10u1,12-8l1,2-5r1,4-4d4,3-9r9,13-8d3,1-6r2,4-5d3,3-9r9,13-8d2,3-9u2,2-6r1,4-5d3,3-9r9,13-10u2,6-11d1,7-13l2,4-14u4,3-9r9,13-8d1,6-4d1,7-6l2,4-5d3,3-9r8,12-10u1,11-8r1,7-2l1d3,7-6l2,4-5d3,3-9r9,5-1d1,3-2r2,6-1d4,7-6l2,4-5d3,3-9r8,1-2r4,6-1d4,7-6l2,4-5d3,3-9r7,5-2d1,4-4r1,6-3d2,7-6l2,4-5d3,3-9r6

;2
#############
#           ##
# # # # # #  ##
## ........#  ##
#  .$$$$$$ # ###
## .$    $ #   #
#  .$    $ ##  #
## .$$$$$$$$ # #
#  ....... $ # #
###. # # #.$ # #
#  .$$$$$$.#   #
## .$    $.# # #
#  .$    $.# @ #
## .$    $.# # #
#  .$$$$$$.#   #
###....... #  ##
#  # # # #   ##
##          ##
#############
Solution: undefined

;3
   ######
   #    ##
####$$$  ##
#   ...$  #
# $$.@ .$ #
### .  .$ #
  # ...$$ #
  ##.  .$ #
  # .  .$ #
  # ...$$ #
  ##$$$   #
####  ## ##
##    #  ##
##   ##  ##
 ## ## # ##
  #      ##
  ########
Solution: undefined

;4
  #########
  #       #
  # #$$$ ##
  # ....##
  # .$$###
  # *    #
  # .$$$ #
####* # ##
##@ .   #
 ## . ###
  #####
Solution: undefined

;5
     #######
     ##   ##
    ## $.$ ##
   ## $. .$ ##
  ## $. $ .$ ##
### $.$ $ $.$ ##
## $.$ $$$ $.$ ##
# ............. #
# .#$#$#$#$#$#. #
#       @       #
#################
Solution: undefined

;6
  #######
 ##  .  ##
## .....@#
# $$$.$ ##
#   $.$##
# # $.$ ##
#  $$... #
# $  .$$.#
##$$$$$ .#
#      . #
##### . ##
    #. ##
    ####
Solution: l3d8u2r1l1u2r1d3r2u2l1d1l2u1r2u1r1d1l5u1l2d1r6l6u3r3l3d3r4u5d2l2u1d1r2u2r2d1l1u1l1d4r2u1l1u2l1u1r1d2l3u1r1d1r1u1l2d1l2u1r2d1r1u1d1l1d1u1d1u1r3d2l1u2l1u1r1d1r1u1d5l1u4d3l2u1r3d3l4u2l1u1r4d3l2u2l1u1r2d1l1d1r1d1r1u1l1u2l1u1r1l1d1l2u2r3

;7
#########
##  @  ##
# $.... #
# $.$$$ #
# $.  $ #
# $...$ #
# $.  $ #
# $.$$$ #
#  ....##
### ## ##
#########
Solution: 5-6d1,4-6d1,7-6l1d1,5-4u1,4-4u1,7-4l1u1,7-5l2,5-3d1,6-6l1,1-2r1,1-3r1,1-4r1,4-4l1,2-3r1,5-6l1,3-5d2,1-7r1,1-6r1,1-5r1,1-4r1,3-3r1,6-3l2

;8
 #####   #####
##   #####   ##
# .$   .   $. #
# $.$$$.$$$. ##
##  .@$.$ . ##
 ## $.$.$. ##
  ##$....$$##
  ## .$.$.$ ##
 ## .$ . $.$ ##
## .$ $.$ $.  #
# .$   .    . #
###############
Solution: undefined

;9
##########
#@   #   #
# $..... #
##$$$$.$ #
#   $. $ #
# $$.$$$##
# $....$ #
#  $$$ . #
##     . #
#  .... ##
##########
Solution: undefined

;10
    #####
   ##   ##
  ##  #  ##
### $ $ $ ##
## .$$ $$. #
 # .$@ $.. #
 # .$$$.$. #
 # .$ . $. #
 # .$.$ $. #
## .. ##$. #
## . ### . #
 ## ## #  ##
  ###  ####
Solution: r3l1d1r1l1d2r1u1r2d3l2u1r2u2l1d2u2l2d1r1u1r1d1l2u1l2d1r3l1u3r1d1l1d1r1l3d1l1d1l2u2r1d2u1r2u1l1d1l2u2r1d2r4u3l3d3u3r1d2u2r1d1l4u2r1u1r1d3r1d1l1u1l1d1l1u3r1d2r3u2l2u1l1d2u2r1u1r1d2r1d1l2r3u2d1r1l3u3r2d1r1d2u2l1d3u2l2u1l1d1r1d1l1

;11
   ###
  #####
#########
#  ....##
# $$$$. #
# $@ $.##
#  $ $. #
## $ $.##
#  .$$. #
##  .. ##
#########
 ##   ##
Solution: r1d3r1l1u1r1l1u1r1l1u1r1u1d4l3u2r2u1r1d3u2l4u3r4l2d1r2l2u1l2d1r3d1r1u1d2l2u2l1u1r1d4l1u3l1u1r1

;12
###########
# #     # #
##@     ###
##.$$$.##
 #.$ . ###
 #.$.$ # #
##..$ $# #
##..$  ###
 #.$.$$# #
 #.$ . ###
##.$$$.# #
##    ## #
##########
Solution: d2r2u1d1l2u2r2l2d9r2u1r1u3r1u3d3l1d3l1d1l2u7r2u1l1d1l1d2r1u2r1u2l1d1r1d1l1d3l1d4r3u4l2r2d4l3u5r1d1r1d1l1r2d3l3u4d1r3d2l2u2r1u1l1d1r2d1l2u4r1d2r1d1l2r2u1r1u1l2u2d2r2u2l1d2r1d1l2u2l1u2r1d4u6r2d1l1d3l1r2u2d4l1d2r1u5d1l2d1u1r1d3u7r2d1l1u1l1d2u2l1d3

;13
     ######
   ###    #
#### #  $ ##
## ###$..$ #
##  # .$$. #
#####$. $. #
##  # .$ . #
##  #$.$$. #
##### .$ . #
#### ..$$. #
   #  @  $ #
   ######  #
        ####
Solution: undefined

;14
      #
     ###
   ######
 ###    ##
##  $..  ##
## $.$$.  #
 # $. $.$ #
 # $.@$.$ #
 # $.$$.$$#
 # $. $...#
## $. $.$.#
###..$$...#
  ##    ###
   ######
Solution: undefined

;15
#########
#   @   #
# * $ * #
# ** ** #
# * * * #
# * $ * #
# * $ * #
# * $ * #
# * $ * #
#   $   #
# $ $## ###
# $ $ ....#
# $ $#....#
# $$$ ....#
#  $  ....#
###########
Solution: l3d8r2d2r5l5u2l2d5r7l5u1r5u2l4d1u1r2d3l3u1r4d1r1u1l1u1r1l2d2l5u3r6l6d2r6d1r1u1l7u2r1d1l1d1r6l3u2l1d2l1d1r5u5l3d1l1d1r3l5u2r1d1l1d1r4l1u2l1d1l2u9r2d11l1d1r3d1r1u1l2u4r1u4l1u1l1d8l1d1r4d1r1u1l3u4r1u3l1u1l1d7l1d1r4l2u4r1u2l1u1l1d6l1d1r3l1u4l1u2r1d6l1d1r3l5u5r2u1r1d5l1d1r2l1u10l1u3r2d1l1d1u2l1d1

;16
     ##
    ####
   ##  ##
  ## $  ##
### . $. #
###$.$ .$#
# # .$$. #
###$....$#
# # .$$. #
###$. $.$##
### .$$. ##
# @       #
#   ###   #
###########
Solution: undefined

;17
###########
#@        #
# $$$ $$$ #
# $. #. $ #
# $.# .#$ #
# $. #. $ #
# $.# .$$ #
# $...... #
# $.##.$.##
# $. $.$. #
# $. $..* #
###########
Solution: d4r1l1u1r1l1u3r2d1r1l1u1l2d6r3l3u2r1d1l1d1r2l2d3r1l1u2r1l1d2r1u3r1l2u6r8d6l3d2l2r2u1r1d1l3d1r1u1r2u2r1d1u1r1u6l3d7u1r3u4l2r2u2l3d6r3u2l1d2l2u1r1d1r2u2l1d1r1d1l1r1u4l1d3u1l1r1u2l2d3u5l2d1r1u1r1d4u4l5d1r1l1d4r1l1u4r1d4l1d1r1u5r3u1r1d3u1r3u2l1d1l1u1l1d2u1r3d1l2

;18
#########
#   #   #
# $$$$$ #
# $...$ #
# . $ . #
##.$@$.##
# . $ . #
# .$$$. #
#  ...  #
##  #  ##
 #######
Solution: undefined

;19
########
#      #  #####
# $##  ####   #
# ....$#   $  #
#@.$$.$   $  ##
# . $.$# $  ##
# .$ . #  ###
# . $. ####
#########
#  ##  #
########
Solution: undefined

;20
   ##
 ######
##    #
# ...$##
# . $. #
# .$$.##
#@... #
# .$ ####
# .$$#  #
# .$    #
# $ $$  #
# $$    #
#  ######
####
Solution: undefined

;21
  #####
  # @ ##
 ##$.. #
## . $.#
# $.$ $#
# $. $ #
#  .$ $#
###. $.#
## $..##
 ##   #
  #####
Solution: undefined

;22
#########
#   #  ##
# $ #$@##
##.....#
## $.$ ##
 # $.$ ##
 # $.$ #
## $.$ #
##  .  ##
#########
Solution: undefined

;23
##########
#        #
# *....$ #
## $.$$$ #
# # .$@$ #
## $...$ #
# # .$$. #
## $.$ . #
# # .$$. #
#  #     #
##########
Solution: undefined

;24
 ######
##    ##
# .$ $.#
# $.$$.#
# $$.$.#
#  $@..#
# $ $$.#
# .$ $.#
#  ... #
########
Solution: undefined

;25
    #########
   ##       ##
   # $$...$$ #
  ## $ $.$ $ ##
 ### $.....$ ##
#### .$$*$$. ##
#### .  *  . ##
 ### .$$*$$. ##
  ## $.....$ ##
   #   $.$   #
   ## $...$  #
   ##   @   ##
    ##########
Solution: undefined

;26
###########
#    #    #
# .$$$$ . #
#  . $ .  #
#   .$.   #
## # .@# ##
#   .$.   #
#  . $ .  #
# .$$$$$. #
#    #    #
###########
Solution: undefined

;27
##########
#    #  ##
# $$$$ $#
# .$ $. #
# .$ $.$#
# .$@$. #
# .$ $.$#
# .$ $. ###
# .$ $.$  #
# ....... #
# # # # . #
########  #
       ####
Solution: u2l1r1d1l1r1d1l1r1d1l1r1d1l1r1d1l1d1l2u8r2d7r1d1l1u8l2d1r1u1r1d7r1d1r2u1l1d1l1u1l1u2r1d2r2u1r1d1r1d1l2u4r1d3l1d1r1u1r1d1u1l2u5r1d5l1d1r1l1u8r1d7l4u7r1d6l1d1r2l1u2r1d1r1d1u1l2d1r1u1r2u2l1d1l2u4r1l1d4r3u5l1d4u3l2d1r1l1d1r1l1d1r1

;28
##########
#        #
# $.$$$.##
#  .$ $. #
## .$ $.##
# $.$ $. #
#  $....##
# # $ $. #
# # $# .##
# #  #$. #
# @  # . #
##########
Solution: undefined

;29
  #####
 ##   ##
## $ $ ##
# . $ . #
# .$$$. #
# . $ . #
##.$$$.##
# . $ . #
# .$$$. #
# ..... #
# $$.$$ #
##  @  ##
 #######
Solution: undefined

;30
###########
##       ##
 # $$$$$ ##
 # .$.$. #
## .$.$. #
###.$.$.##
## .$.$. #
 # .$.$. #
 # ..... #
## $$$$$ #
##   @   ##
###########
Solution: undefined

;31
               ###
               # ###
################   ##############
#                           $   #
# ####$# ####### # #   ## $ #   #
# #... #$      # # #  #  $ # #  #
# #...$# $$$  # $# # # $  #   # #
# ###. # $   # $ # ###  $ #   # #
# #...$# $@ # $  # #..#  $##### #
# #... #$  # $ $ # #...#  #   # #
# #...$#  #      # #....# # $ # #
# #... # ####### # #....# # $ # #
#   $ $         $ $ $ $     $   #
####  ########        ###########
#   $ #      #  ##  ###
#     #      ########
#######
Solution: d1l1d1l1d2r6d1r6u4r2d1r1d1l1r1d1l1u1l2d2r1u3l1u1r1d4l4u1r3d1r1u2l1u1r2d2l3d1r2u1r6u3r2d3l7u1l2d2r1u2l1u1r1d2r8u1l1r1u2l1d2r1d1l8d1l2u1r1d1r1u1l1u1r2d1r6u2l1d1r1d1l7d1l2u1r1d1r1u1l1u1r1d2l6u1r5d1r1u4d3r10u9l13u1l2d1r1u1r1d9u9d1r13d9l10d1l4u1r3d1r1u3d2r10u9l6d2l1d2r1d4u4l1u2r1u2r6d9l10d1l2u1r1d1r1u2d1r4u5l1u2r1d6u8r6d9l10d1l2u1r1d1r1u1r4u5l2d1r1u1r1d4u8r6d9l10d1l1u3d2r5u5l3u1r2u1r1d6u8r6d9l10d1l1u2d1r5u9r2d1l1u1l1d8u8r6d9l10d1l1u1l12r10u9l17d9r2u1r2d2l1u4r1u1l1d4l3u9r18l1d9l13d1l1u3r1u1l1d2u1r1u1r1d2l1d1l4u9r17d9l13d1l1u2r1u1l1r1u3r1d3l1u5r1d3l1d4l4u9r5d2l1d5r1d1l1d1l4u9r18l1d9l13d1l1u1r1u1l1r1u3r1d3u2l1u4r1d3l1d3l1d1l3u9r17d9l12u1l2d2r1u7r1u1l2r2d6l1d1l4u9r18l1d9l12u1l2d2r1u6r1u1l2r1d9l2u1r1d1r1u9r1u1l1d3u1r1d5r7l7u9r10d8u8r2d9l13d1l1r1u2l1d1r1l2r1d1r1d2l2u1r1d1r1u8r1u1l1r1d6r10u4l1d1l1d1r1u1r1d2u8r2d9l13r1u9l5d9r3d1r1u7d7u1r11u6l1d3l1d1r1u1r1d2u8r2d9l13r1u9l5d9r3d1r1u6d5r12l1u2l4u1r3u1r1d3u9d1r2d9l13r1u9l5d9r3d1r1u5d4r11u5l2d2l1d1r2u1r1d2u8r2d9l13r1u9l5d9r3d1r1u4d3r3u2r1u1r1u2l1u1l1u2d2r1d1r1d2l1d1l1d2l2u9r11u1r1d9u8l2d10r3u1l14r1u9l5d9r3d1r1u3d2r3u2r1u1r1u2l1d1l1d3u3r1u2l1u3r8d9l11u1r1u8l5d9r3d1r1u2d1r3u4r1u2l1d5u8r9l1d9l11r1u9l5d9r3d1r1u1r3u4r2d1l1u1l1d3u8r8d9l11d1l1u4d4r1u1r3u4r3u1r1u2l1d1r1d1l3u1l1d5u8r9l1d9l11d1l1u3d2r4u3r1u1r2u3l1d1r1d1l2u1l1d5u8r8d9l11d1l1u2d1r4u5r2u2l1d3l1d4l2u9r2d8u8r8d9l11d1l1u1

;32
###########################
#....#  #      ...........#
#....   ## #   ...........#
#....   # #    #..........#
#....#  #  ##  ...........#
####    #   # # ###########
#  $$$$ #   #             #
#  $        $ $     $$$   #
#  $       $ $ $   $   $  #
#  $   $$$ $ $ $   $   $  #
#  $$$     $ $ $ $ $ @ $  #
#  $   $$$ $ $ $   $   $  #
#  $       $ $ $   $   $$ #
#  $       $ $ $    $$$ $ #
#  $ #####                #
#    #   ##################
######              ##
Solution: d2l3u4l2d6l6u1l4u4l1u2l1u2r2u2d2l2u1d1r2u2l4u1l1d1r2d1r1d3r2u3r1u1l4u1l1d1r4d4l1u1l1u1r1d1r1u2r1u1l3u1l1d1r3d9l2u9r1u1l3d1l1u1r5d9l1u5r1u1l1d1l1u3r1u1l2d1l1u1r2d13l2u1r1d1r1u12r1u1l1d1l1u1r1d12l2u1r1d1r1u12d11l2u1r1d1r1u9d1r2u2l4r2d9l2u1r1d1r1u9r1u1l3r2d9l2u1r1d1r1u7d1r2u2l3r1d7l2u1r1d1r1u7r1u1l2r1d7l2u1r1d1r1u5d1r2u2l2r1l1d5l2u1r1d1r1u5r1u1l1d5l2u1r1d1r1u2d5r4u1l1d1l1u6r1u1l2r1d4r3d1l2d1l1u6r1u1l2r2d6r3d6r4u7l1u1r1d1r1u2d1l2u2r11l9d2r1d7l1d1l1u7r1u1l1d1l1u4l1u1r12u1r1d1l12d5r1d7l2u1r1d1r1u7r1u1l1d1l1u4l1u1r10u1d1r1u1r1d1l11d5r1d6l2u1r1d1r1u6r1u1l1d1l1u4l1u1r10u1r1d1l10d5r1d5l2u1r1d1r1u5r1u1l1d1l1u4l1u1r9u1r1d1l9d5r1d4l2u1r1d1r1u4r1u1l1d1l1u4l1u1r8u1r1d1l8d5r1d3l2u1r1u6l1u1r7u1r1d1l7d8r1u3r1u1l1d1l1u4l1u1r6u1r1d1l6d11l1d1l2u7r2d1r1u5l1u1r5u1r1d1l5d12l3u1r3d1r1u7r1u1l1d1l1u4l1u1r4u1r1d1l4d12l3u2r3d1r1u6r1u1l1d1l1u4l1u1r3u1r1d1l3d12r3u5l1u4d1l2u2r10l10d6r1u3l1u1r1d1r1u2d1l2u2r9l8r1d4r1d3l1u6d1l2u2r8l6d3r1d6l1u8d1l2u2r7l7d7r1d1r1u7d1l2u2r6l4d3l5d1r4d1r1u4d1l2u2r5l5d4l3d1r4d1r1u5d1l2u2r4l4d5l3d1r4d1r1u6d1l2u2r3l3d4l3d3r4d1r1u7d1l2u2r2l2d4l5d1r4d1r1u7l1u1r12l11d12u2l4u3l1u1r4d1r1u6l1u1r11l10d10l6u1r5d1r1u9l1u1r10l9d7l7d1r6d1r1u8l1u1r9l8d9r5d1l3d1l1u6r1u1l1d1l1u4l1u1r8l7d5r5d3l4d1l1u8l1r1l1u1r7l6d10r7u1l6d1l1u9l1u1r6l5d10r7u2l6d1l1u8l1u1r5l4d8r7u1l6d1l1u7l1u1r4l3d8r7u2l6d1l1u6l1u1r3l2d6u2r12d3l11d1l1u7l1u1r2l1d4r12d2l11d1l1u7l1u1r12l11d8r9u2r1u1l9d1l1u5l1u1r11l10d7r9l1u1r1u1l8d1l1u5l1u1r10l9d7r7u1r1u1l7d1l1u5l1u1r9l9r1d13r7u7r1u1l7d1l1u5l1u1r8l7d13r8u7r1u1l8d1l1u5l1u1r7l7r1d13r9u7r1u1l9d1l1u5l1u1r6l5d6r12d4l2u4r1u1l10d1l1u5l1u1r5l4d13r10u7r1u1l10d1l1u5l1u1r4l3d13r9u7r1u1l9d1l1u5l1u1r3l2d8r12d4l1u6r1u1l11d1l1u5l1u1r2l1d13r10u7r1u1l8d1l1u2

;33
#####################
#....# #            #
#.....   #  #  $$$  #
#.....   #  # $   $ #
#....##  #### $     #
######   #  #  $$$  #
# $   $$ #  #     $ #
# $   $       $   $ #
# $   $        $$$  ##
# $ @ $ $$$          #
# $   $     $$$$$$$$ #
# $   $ $$$          #
# $   $         $   ##
# $   $   #   $$$$$ #
#  $ $  # # #   $   #
#   $           $   #
#####  ######## $   #
#............#  $   #
#............#  $   #
#....##......#   $$ #
#....##......#      #
#####################
Solution: d1r1d7r1d1l1u1l1r1d1l3u1l1d2u1r3u1r1u3l2d1r1u1r1d3r1d1l3u1l1d2u2r3u2l4u1r3u1r1d4r1d1l4u1l1d1u1r4u2l4u2r3u1r1d5r1d1l3u1l1d1u1r3u2l4u3r3u1r1d6r1d1l2u1l1d2u2r2u2l4u4r3u1r1d7r1d1l1u1l1d2u1r1u3l4u5r3u1r1d8r1d1l2u1l1d1r2u3l4u6r3u1r1d9r1d1l1u1l1d1u1r1u2l4u7r3u1r1d10r1d1l4r3u3l4u8r3u1r1d11r1d1l3r2u1r1u2r1u2l2u1l1d2l1d1r1u1r1d2r1d1l4r3u2r2u3l2u1l1d3l1d1r1u1r1d2r1d1l3r3u2r1u4l2u1l1d4l1d1r1u1d1u1r1d3r1d1l2r2u3r1u5l2u1l1d5l1d1r1u1r1d2r1d1l2r1u4r2u4l2u1l1d6l1d1r1u1r1d3r1d1l1u6r2u4l2u1l1d7l1d1r1u1r1d2r1d1l1r1u6r1u2d1r3d1r1d1l4u1l1d6l1d1r6u1r1d2u2l6u7r3d1r1d1l3u1l1d6l1d1r5u1r1d2u2l5u7r3d1l2u1l1d7l1d1r4u1r1d2u2l4u7r1u7r1u1l6r1d1l2u1r6d6l2u1r1d1r1u5r1u1l5d1l1u1r6d5l3u1r1d1r1u4r1u1l4d1l1u1r4d5l6u1r5d1r1u4r1u1l3d1l1u1r4d10r1d1l2u1l1d5l1d1r3u1r1d2u2l3u9r6d3r1d1l6u1l1d6l1d1r2u1r1d2u2l2u2r9d5r4u5l12u1l1d3l1d1r6u1r1d1u1l6u2r13d2l3u1r1u1l10u1l1d3l1d1r5u1r1d1u1l6u3d1r14d5l1u4r1u1l12u1l1d3l1d1r4u1r1d1u1l4u2r13d5l2u4r1u1l11u1l1d3l1d1r3u1r1d1l2u1l1u2r12d4l2u3r1u1l10u1l1d3l1d1r2u1r1d1l2u3r10d3l1u2r1u1l9u1l1d3l1d1r1u1r1d2u2l1u2r13l1u3r1u1l12u1l1d7l1d1r1u1r1d1u1l1u3d1r11u1r1u2l11u1l1d5l1d1r6l5u2r10l1r2u2r1u1l11u1l1d6l1d1r6l5u3r10l2u1r2d1r1u2r1u1l11u1l1d5l1d1r5l4u2r10u2r1u1l10u1l1d6l1d1r5l4u3r11l2u2r1u1l9u1l1d5l1d1r4l3u2r8u2r1u1l8u1l1d6l1d1r4l3u10r6d1r1d2r1d1l7u1l1d5l1d1r3l2u5r6u3r2d2r1d1l8u1l1d6l1d1r3l2u6r9l2u3r2d2r1d1l9u1l1d5l1d1r2l1u5r8u3r2d2r1d1l10u1l1d6l1d1r2l1u5r3u1r6u3r2d2r1d1l11u1l1d5l1d1r1u5r9u3r3d2r1d1l12u1l1d6l1d1r1u6r13u1r1u1l14u1l1d8u5r7u5r1u1r1d4r1d1l9u1l1d6u4r8u5r2d3r1d1l9u1l1d7u4r1u1r4u5r5d3r1d1l10u1l1d6u4r3u4r1u1l2d1l1u4r1u1l6u1l1d1r7d7r2u1r1u1l3d1l1u5r1u1l5u1l1d1r6d7r10u2l10d1l1u5r1u1l4u1l1d1r5d5r11u1l11d1l1u4r1u1l3u1l1d1r3d4r12u2l1d1r1d1l11d1l1u5r1u1l6r6d1u2r11l1d5r1d1l11d1l1u4r1u1l6r6u2r10d2l1d3r1d1l10d1l1u4r1u1l5r5u2r9d5r1d1l10d1l1u4r1u1l4r4d4r9u3l1d2r1d1l9d1l1u4r1u1l3r3u2r8d5r1d1l9d1l1u4r1u1l2r1u1r1u1r8d2l1d3r1d1l8d1l1u5r1u1l5r5u1r7d5r1d1l8d1l1u5r1u1l4r4u1r5d2r1d3r1d1l7d1l1u5r1u1l3r3u1r7d5r1d1l8d1l1u5r1u1l2

;34
   #######################
####     ####      #     ##
#    $$$      $$$$   $$$  #
##  $   $  @  $     $   $ #
#   $   $     $     $     #
##  $   $ $$$ $     $    ##
#   $$$$$     $$$ $  $$$  #
##  $   $ $$$ $         $ #
#   $   $     $  #  $   $ #
##  $   $     $ ###  $$$  #
#          #              #
############  #############
      ##  ##  # #  # #
      ######  ########
      #........#
      #........#
      #........#
      #........#
      #........#
      #........#
      #........#
      ##########
Solution: r2d3l1d13r1d1l5r4u6r1u10l1d14r1d1l5r4u13l1d2l1d1r1u1r1d9r1d1l5r4u14l1d4l1d1r1u1r1d8r1d1l5r6l2u11l2d1l1d1r2u1r1d8r1d1l5r4u12l3d1r2u1r1d10r1d1l5r4u6l2d1l3u1r4u1r1d5r1d1l5r4u5l5u1r4u1r1d12r1d1l4r3u13l1d1l4u1r4u1r1d12r1d1l4r3u10l2d1l7u1r8u1r1d9r1d1l4r3u9l9u1r8u1r1d9r1d1l4r3u8l10u2r9u1r1d9r1d1l4r3u14l4u1l2d2r1d2r4u1r1d10r1d1l4r3u9l1u1l3d3l1d1r4u1r1d5r1d1l4r3u9l5d2l1d1r5u1r1d12r1d1l3r2u18l2d3l3u1r4u1r1d15r1d1l3r3u18d1l5d5l1d1r4u1r1d10r1d1l3r2u13l6d2l1d1r6u1r1d9r1d1l3r2u12l7d2l1d1r7u1r1d8r1d1l3r2u7l10u3r9u1r1d9r1d1l3r2u7l11r1u3r9u1r1d9r1d1l3r2u12l3d1l3d4l1d1r6u1r1d12r1d1l2r1u11l10u5r9u1r1d15r1d1l2r1u17l4u1l1d4l1d1r5u1r1d12r1d1l2r1u16l7d2l2u1r3u1r1d5l1d1r5u1r1d9r1d1l2r1u15d1l10u1r2u1r1d3l1d1r7u1r1d11r1d1l2r1u6r3u1l2u1l1d6r1d1l2r1u5r3u2l2u1l1d6r1d1l2r1u6r3u1l2u1l1d1l1d1r1u1r1d12l1d1r1u13r4u2l1d1r1d1l4u1l1d13r1d1l1u13r4u2l1d2r1d1l3u1l1d11r1d1l1u14d2r3u2l1d2r1d1l1u1l1d11l1d1r1u11l2u4r2d13l1d1r1u13r2u2l1d2r1d1l2u1l1d11r1d1l1u1l1d1r2l1u15r1d14l1d1r1u16r1d3r1d1l3u1l1d4l1d1r1u1r1d8r1d1l1u15r1u1r2d2r1d1l3u1l1d12r1d1l1r1u15r3d2r1d1l3u1l1d12l1d1r1u12r6d2l5u1l1d9l1d1r1u14r4d5r1d1l5u1l1d8r1d1l1u8r7d2r1u1r1u1l7u1l1d7l1d1r1u9r4d1r2d4r6u3l12u1l1d7r1d1l1u4r9u2r1u1l8u1l1d13u12r12d2l1u1r1u1l12u1l1d13u12r13d3l2u2r1u1l10u1l1d12u10d2r9u2r1u1l10u1l1d12u11r13u1l1u1l10u1l1d13u11r7u1r1u1l8u1l1d14u12d1r8d1r3u1r1u1l10u1l1d12u10r7d1r2u1r1u1l10u1l1d12u9r10u1l8u1l1d10u14r2d1r5d2r1d1l8u1l1d11u12r8u2r1d3r1d1l8u1l1d10u13r5d1r2u1r2d3r1d1l11u1l2r1l1d1r1u1r1d10u12r8u1r4d1l2u1l1d5r1d1l8u1l1d7u12d1r12d1l13u1l1d6l1d1r1u1r1d5

;35
########################
#........#  #  #  #   ###
#........################
#........#            ###
#........     #    $$  ##
#........#        $  $ ##
#........   # # # $  $ ##
#........#        $$$$ ##
#######$$$$   #   $  $ ##
    ## $   $      $  $ ##
     # $   $      $  $ ##
     # $   $ $$$        #
     # $$$$   @  $$$$$$ #
     # $     $$$        #
     # $           $   ##
     # $          $$$  ##
     # $   ####    $   ##
   ###   ########  $   ##
   ##############  $   ##
                #  $   ##
                ##  $$ ##
                ##     ##
                #########
Solution: l2d1l4u2r1u2l1u4d1r2u2l8d1l1u3d2r7d5r1d2l1u6d1r2u2l7d1l1u3r6d15l2u1r1d1r1u12d1r2u2l6d1l1u3d4r5d11l2u8r1u4r1u1l3d1l1u3d3r3d4l1d2r1u8r1u1l6r6d3l1d5r1u5d1r2u2l4d1l1u3d5r2d3l1d3r1u10r1u1l5r5d1l1d9r1u7d1r2u2l6d1l1u2d2r3d2r1d4l1d4r1u12r1u1l3r3l1d12r2u1l1d1l1u10r1u1l6r6l1d8r1d2r1d2l1d1l1u13r1u1l2r2d11r1u2r1u1l2d1l1u7r1u1l5r4d11r4u2l3d1l1u9r1u1l4r4d9r4u1l3d1u1l1d1l1u8r1u1l3r2d8r5u1l4d1l1u7r1u1l2r2d7r4u1l4d1l1u5r1u1l6r6d6r3u3l1d1r1d1l3d1l1u5r1u1l5r4d5r3u1l2d1l1u4r1u1l4r7d8r4u2r1u1l8d1l1u5r1u1l3r2d8r6u2r1u1l6d1l1u5r1u1l2r2d8r6u2r1u1l7d1l1u4r1u1l6r6d1r3d9r2u4r1u1l6d1l1u5r1u1l5r5d9r6u3r1u1l7d1l1u5r1u1l4r4d9r8u1l8d1l1u8r1u1l3r3d6r11u1l11d1l1u5r1u1l2r1d6r2d3r1u1r12u1r1u1l15d1l1u5r1u1l6r6d7r13u1r1u1l14d1l1u5r1u1l5r8d7r9u2l1u2r1d1l1d1r1d1r2u1l14d1l1u5r1u1l4r4d7r11u1r1u1l12d1l1u5r1u1l3r3d7r10u2r1u1l11d1l1u4r1u1l2r4d9r1u1r6u2r1u1l10d1l1u4r1u1l6r6d3r11u1l11d1l1u2r1u1l5r5d3r8d1r7d2l1d1l14d1l1u7r1u1l4r4d6r13d3l1u3r1u1l13d1l1u5r1u1l3r3d6r7d3r3u3r1u1l11d1l1u5r1u1l2r2d7r12d2l2d1l1u4r1u1l10d1l1u11r1u1l1d11r13d4l1u3r1u1l12d1l1u10r1u1l1d10r13d6l2d1l1u7r1u1l10d1l1u8r1u1l1d10r13d5l1u5r1u1l12d1l1u8r1u1l1d9r14d2l3d5r1u7r1u1l12d1l1u7r1u1l1r1d12u2r14d6l1u8r1u1l14d1l1u6r1u1l1d9r15d6l2u7r1u1l13d1l1u6r1u1l1r1d7u1r14u3l14d1l1u9d9r15u2l13d1l1u8d9r11u3l3u1l1d1r1d1l8d1l1u7d7r15u2l6u1l1d1r1d1l7d1l1u7d8r9u6d1r1u1r2d3r1d1l13d1l1u6d5r10u3r1d2r1d1l10d1l1u6d6r11u1r1u3l2d1l1u1r1u1l7d1l1u1r1u1l3r3d1r5u2r5d1r1d1l11d1l1u1r1u1l2r2u1r4d2r4d3r1d1l12d1l1u4d3r15u2l11u1l1d1r1d1l2d1l1u3d2r2u1r12u2l1d1r1d1l11d1l1u1r1u1l3r3u3r9d3r1d1l10d1l1u1r1u1l2r2u3r7d5r1d1l11d1l1u2d2r14u7l2d5r1d1l11d1l1u2

;36
            ###
           #####
          ########
          #      ##############
########### $  $ ##           #
#           $  $  #   .....   #
#           $  $ #   .     .  #
# $$$       $  $  # .       . #
# $  $       $$  #  .       . #
# $  $ ###        # .       . ##
# $$$   @  #####    .       . ##
# $  $ ###       #  .       . ##
# $  $      $$$   # .       . ##
# $  $       $   #  .       . ####
#            $    #  .     .     #
#            $  ......     ......#
##########  $$$                  #
## #     #      ##################
# ##     ########
## #
# ##
####
# ##
####
Solution: r2d5r16d1r1u9d9l9u1l7d2r1u1l1u1r15d1r1u7r1u1l1d1l1u3d9l14d2r1u1l1u1r14d1r2u1l2d1l1u10d10l5u1l9d2r3u1l1u1r10d1r1u10d10l13u5r1d3l1d1r11d1r1u10d10l12u5r3d3r1d2l2u1r9d1r1u9r1u1l1d1l1u1d10l10u4r2u1r1d3l1d1r7d1r2u1d1l1u8r1u1l1d1l1u1d9l10u3r3u1r1d2l1d1r5d1r1u8d8l8u2r1u1r1d1l1d1r6d1r1u7d6l18r1u2r8u1r1d2l1d1r8d1r1u6d5l19u2r10u1r1d2l1d1r8d1r1u5d4l18u1r4u6l1d1l1d4l1d1r3u1r1d1l1d1r13d1r1u4d3l16u6l1d5l1d1r17d1r1u3d2l14u5l1u1l1d5l1d1r16d1r1u2d1l14u4l1u1l1d4l1d1r24d1r1u8d7l24u4r1d3l1d1r23d1r1u7d7l16u1l6u10l3d9l1d1r25d1r1u6d5l27u8r1u1r1d8l1d1r25d1r1u5d4l27u7r1u1r1d7l1d1r25d1r1u4d3l27u6r1u1r1d6l1d1r25d1r1u3d2l27u5r2u1r1d5l1d1r24d1r1u2d1l27u4r2u1r1d4l1d1r23d1r1u1l26u4r1d3l1d1r19d1r1u1l20u7r1u1r2d7l1d1r28l27u10r1d9l1d1r26l17r2u3r1u9l3d4l7u1l1d8l1d1r25l13u8l11u1l1d8l1d1r25l12u7d1l2u1r1u1l8u1l1d8l1d1r22l18r1u6r4u1l7u1l1d7l1d1r21l10u12d1l2u1l1d4r1d1l7u1l1d7l1d1r15l5u4r1u6l1u1l1d3r1d1l8u1l1d7l1d1r14l3u9l1u1l1d2r1d1l9u1l1d7l1d1r14l2u12d1l4u1l1d4r1d1l5u1l1d7l1d1r12l1u10l4u1l1d3r1d1l5u1l1d7l1d1r11l1u2d1r1u8l9u1l1d9l2d1r11

;37
            ####
#############################
##                          #
#  $ $       $$ $$     $$$  #
# $   $     $  $  $   $   $ #
# $   $ ### $  $  $   $     #
# $ @ $     $  $  $ # $     #
# $   $ ### $  $  $   $ $$$ #
# $  $$     $  $  $   $   $ #
# $   $$    $  $  $   $   $ #
#  $$$ $    $  $  $    $$$  #
##                         ##
######## # ##################
#........ .#
#........ .#
#........#.#
#........#.#
#........ .#
#........ .#
#........#.#
############
Solution: undefined

;38
    ####################
    ##                ##
   ###      $$$$$$$$$ ###
#####  .        $     #########
##     .        $             #
##   .....   @  $....     ... #
##  .  .  .     $.   .   .   .#
## .   .   .    $.   .   .    #
## .   .   . ###$.   .   .    #
## .   .   .    $....  #  ... #
## .   .   . ###$.   .       .#
## .   .   .    $.   .       .#
##  .  .  .     $.   .   .   .#
#    .....      $....     ... #
# $$$  . $$$    $ $     $$    #
# $    .$   $   $ $    $  $ ###
# $     $         $    $  $ ##
# $$$    $$$  ### $    $$$$ #
# $         $ # # $    $  $ #
# $     $   $ # # $    $  $ #
# $$$    $$$  # # $$$$ $  $ #
#             ###           #
#############################
Solution: l1d6r2d5r3u3r4d1r1d7r3u1r1d1r1u14l1u1r2l1d15l2u2r1d1r1u14l1u1r1d16l1u1l1u2r1d1r1u13d12l2u2l1u4l1u1r2d1r1u6d6r1d6l2u1r1d1r1u7l1u1r2l1d7l2u1r1d1r1u5l1u1r2d1l1d4l1u3l1u1r3l4d3r1u8d9r1u6l1u1r2l1d9l2u7l1u1r1d1r1u3d6l3d1r3d1r1u7r1u1l1d6l4d1r1l1d1r3d1r1u7l1u1r1d6l4d2r3d1r1u8d8u1l4d1r4d1r1u5l1u1r1l3d3l2d3r4d1r1u6d7l4u8l1u1r2d9l7u7r8d1r1u1d1l3u1l6d1r3d1r1u9d9l1u1l3d1r3d1r1u9d7l4d2r3d1r1u9d7l4d2r4d1r1u3r1u1l1d1l1u5d6r1d4l1u9d9l1u8l1u1r1d2r1d7l4u2r2u1r2d2l1u14d15l1u3l1u1r1d1r1u8d11l3u1r2d1r1u7d1l1d1l4u3r3l3d1u2r1l1u1r1l4u2r6l6d2r4u1d1l4u2r5l5u2r5d1r1d2r1d2l1u1r1u1l1u2r1u1l1d1l1d1l5u2r4d1u1l4d2r5u1r1u2l1d2u1l5d5r2d2r3d1r1u1d2l2u2l1u1r1l1u2r1u4l1u2r3l2d1l1d1r1u1r1d1u2r1u2r3u2l4d5u5r1d3u1d1l10r9u1l9r10u2r2d2r1d1l3u1l1d2u4r2d2r1d1l2u1l1d1u1l5d2l2r2d8r1d3l1u4r1u1l1u4l1u6r1d4r1d1l1u1l1d4u8r2d5r1d1l2u1d1u1l1d2u7r3d5r1d1l3u1l1d1u6r4d5r1d1l4u6r5d1l6u1l1d4u1l2d9r4d2l3u9d9r1u2d2r2u1l2d1l1u5r1u1l1d1l1u4d6l2d3l2u9l1u1r3l1d10l2u9l1u1r3d13l1u12l1u1r1d13l1u11l1u1r1d8r1d3r1d4l2u13d13l2u1r1d1r1u12d12l2u2r1d1r1u10d9l2u1r1d1r1u8d7l2u1r1d1u1d1r1u6d1r6d3l1u5r1u1l1d1l1u4d5l1d5r1u9d13r1u7r1u1l1d1l1u5d9r2u3r1u1l2d1l1u5d11r2u5r1u1l2d1l1u5d8r3u4r1u1l3d1l1u3d5r1d1r3u4r1u1l2d2r3d3l5d1l1u6d2r6d4l4d1l1u6d7r3u2r1u1l4d1l1u5d2r5d4l4d1l1u6d2l6u2r5l5d1r4d1r1u3d7l2u8d2l3u1r3d1r1u1

;39
######################
######################
#                    #
# $$$      $  $  $$$ #
# $  $  @  $  $   $ ##
# $  $     $  $   $ #
# $$$$ ### $  $   $ #
# $        $  $ # $ #
# $    ### $  $   $ ##
# $        $  $   $  #
# $         $$   $$$ #
# ....... #          #
#.........############
#.........#
#.........#
#.........#
###########
Solution: undefined

;40
  ##################
  #      #######   ###
  # $$$$  #####      #
  # $      ###   $$  #
  # $$      #   $  $ #
  # $  $        $  $ #
### $ $$  @     $$$  #
#   *  $     ...$  $ #
#  ... $      ..$  $ #
# . . .      . .     #
#   .       .      ###
#   .      .       #
### .     .        #
  # .    .         ###
  # .   .            #
  # .  .        $$$$ #
  # . .      .  $    #
  # ..        . $$   #
  # ............$    #
  #           . $ $$ #
  ########## .  $  $ #
           ###  $ $  #
             #  $ $$ #
             ##      #
             #########
Solution: d5r2d2r6d1r2d4l15r15d5l3u3r1u2r1u2l1d1r1d1l13r14d1l1r1d2l1u2r1u1l13r12d2l1u1r1u1l11r9d1l2r2d1l3r3d1l1r1d2l2u4r1u1l7r9u2l4r3d1l2r3d1l8r7d5l1u4r1u1l6r9d5l1u4r1u1l8r7d4l1u3r1u1l6r5d5l1u4r1u1l4r2l1u4r1d3r1d1l2u4r2d3r1d1l2r1u3d1r2u1r1u1l14u1l2r1d3u1r13d1r2u1l13u1l1d1u7d2r2u9l1r1d2l3d8r1d1l1u1l1d5u3r1u8r1d7r1d1l2u1l1d3u2r3u2l1u7r2u3l3d13r1d1l1u14l2d1r1u1r1d12r1d1l1u13l2d2r1u1r1d10r1d1l1u10l2d1r1u1r1d8r1d1l1u9l2d2r1u1r1d4r1d1l3r2u4l2d1r1u1r1d2r1d1l2r1u2l1d4r4u2l3u1l1d2r4u2l3u1l1d2r4u2l3u1l1d2r4u2l3u1l1d2u5r2d6r1d1l1u7r1d7r1d1l1u1r1d3r9u3l7u1l1d7r1d1l2r8u5r1u3l9u1l1d6l1d1r1u1r1d1r4u3r6u1r2u1l10u1l1d5u3r11u2l9u1l1d5u1r2u2r8u4l1d4r1d1l8u1l1d2u2r9u3l2d3r1d1l6u1l1d1r6u4l1d3r1d1l4r3u3l3u1l1d1r4u1l2u1l1d3u1r2l1u3r1d3r1d1l2r2l1u6r1d7r1d1l2r3u5l3u1l1d4u5r3d4r1d1l3

