;1
###############
###.....     ##
#######$$$$$  #
#           $ #
# $ ########.##
# $$.......$  #
# $ #######$$.#
#          $@ #
### $$$########
####     ...###
###############
Solution: l9r3l1d1u1l2d1r1d1r6,6-7d1,5-9r4,5-7d1l1d1r4,12-4u1l1u1,13-2l1,12-1l8,7-3u1,8-1l3,8-3u1,9-1l3,9-3u1,10-1l3,10-3u1,11-1l3,11-1d1,3-4d1,1-5r6,12-5l2,12-7l1,11-7u1,12-5l1,11-6r1,10-3r1u1r1d1,1-7r2u1,2-5r4,2-3d1l1d1r4,2-7u1l1u1r3,5-7l1d1l1u2,2-5r1

;2
#############
###   #   ###
###   @   ###
##  $ $ $  ##
#  $$$$$$$$ #
####  $   # #
#     $ $   #
##  # $ # ###
#... # # ...#
#.*.  $  .*.#
#...#   #...#
#############
###       ###
Solution: 9-3d6,10-8d1,7-9l3,3-10u2,3-9l1,1-10u1,7-6l1d2,7-9l4,4-6r1,2-10u2,7-6r1,9-5d3,10-9l7,2-8d1,3-10l1,7-3r1,9-2d6,10-9l7,2-8d1,5-3r3,9-2d6,10-9l6,3-8d1,2-6d1,3-6d1,5-5r1d3,7-9l5,3-3r5,9-2d6,10-9l7,11-4l1,9-3d5,10-9l6,6-5r2,9-4d4,8-9r2,11-8d1,7-3d1r1,9-3d4,8-8r2,6-5r2,9-4d3,8-8r1,5-3d1r3,9-3d5,8-9r2,5-6u1,4-3d1r4,9-3d5,8-9r1,2-4r6,9-3d5,4-6u1,3-4r5,9-3d4

;3
###############
## ###      # #
# ####$#$## ###
#####       # #
# ### $$$$#####
# ##  $ $  ## #
###  $ @ $  ###
### $ ### $ ###
##..*#####*..##
#.*...###...*.#
###############
Solution: r2d1r1d1,11-9l1r2,10-5d1,11-6d2l1u1l1u2r1d1l1d1r1d1u2r1d1l1d1r1l1d1r1,6-6l1,9-3d2,8-6r1u1r1d1l1d1r1u1r1d2,7-5r1,9-4d1,8-6r1u2d1r1d1l1d1r1u1r1d1,8-3d2,7-6r2u1r1d3,5-5r3u1r1d1l1d1r1u1r1d2,5-7l1d1,3-9r1,3-9l1,4-5d1l1d2r1d1l1,5-7l1u1l1d1r1d1l1,6-3d2,7-6l2u1l1d1r1d1l1u1l1d2,8-4l2u1l1d2r1d1l1u1l1d1r1d1l1u1l1d1,6-1d4,7-6l2u1l1d3,8-1d4,9-6l4u1l1d2

;4
###############
#######@#######
######   ######
#####  #  #####
#### # $$$ ####
###    $    ###
## $#$ $ $   ##
#  $  $ $  $  #
## #$ #$#$## ##
#..*.........##
##.# $ # $ #.##
####.#.#.#.####
###############
Solution: 6-5r2,8-6r1,10-7r1,12-6d3,8-10r1,10-9d1,4-10r1,6-9d1,4-9l2,4-7d3,4-7l1,3-5d1,2-6d3,4-7l1,2-6d2,9-7d1,10-9l6,5-5d3,6-9l1,8-6l1,7-7d1,6-9r2,9-8d1,10-10l1,8-9d1,9-7l1,7-6d2,8-9l1,10-5d1,11-7l1,9-6d2,8-9r2,10-5l1,9-3d5,8-9r1,4-10u1,5-9r2,7-7l1,5-6d2,4-9r1,4-7d1,6-5d1,7-7l1,5-6d2,7-5r1,9-4d2,8-7r3,12-6d2,8-3d3,9-7l1,7-6d2,6-4r2,9-3d5

;5
###############
##          ###
# $$$$$ $ $  ##
#     $   ##  #
##$ $ ##    # #
##   $## # $$ #
##    #  #   ##
#######$$$ ####
######....#####
#####....######
####....#######
###+...########
###############
Solution: 8-8u2,7-6d2r1d1l1u1l1d1r1d1l1u1l1d1r1d1l2,8-6u2,10-7l2u1l1d2r1d1l1u1l1d1r1d1l1u1l1d1r1d1l1,11-4d1,13-5l2,7-3r1,9-4u1,10-6u1,11-4l2,8-3d3,9-7l1u1l1d2r1d1l1u1l1d1r1d1l1u1l1d1,12-6l1,10-7u2,11-4l2,8-3d4,9-8l1u1l1d1r1d1l1u1l1d2,8-1d6,9-8l1u1l1d1r1d1l1u1l1d1r1d1l2,9-1d1,11-2l2,8-1d6,9-8l1u1l1d1r1d1l1u1l1d1r1d1l1,9-4u1,10-2l1,8-1d6r1d1l1u1l1d1r1d1l1u1l1d1,3-1d2,2-3d1,4-3d1,2-4r1,5-3r2,8-2d5r1d1l1u1l1d2,5-6u2,4-3r3,8-2d5r1d1l1u1l1d1r1d1l2,2-1d1,1-3r6,8-2d5r1d1l1u1l1d1r1d1l1,2-6u2,1-3r6,8-2d5r1d1l1u1l1d1,3-5r1u1,3-3r4,8-2d6,5-6u2,4-3r3,8-2d5,7-8r1,5-1d1r2,8-1d5,9-7l1,7-6d1,8-8l1,4-3r3,8-2d4,9-7l1,7-6d1,4-1d1,3-3r4,8-2d5

;6
#############
####     ####
#### $$$ ####
#### $ $ ####
#### $ $ ####
#### $ $ ####
#####  $ ####
#+#.#$ $ .#.#
#**. $.$ *.*#
#...$  $$...#
#.#.#   #.#.#
#############
Solution: d2r2u1l1d1l1u1r4d1l1u1l1d1r3l1u2r1d1u2d2u1r2d1r1d1r2u1d1l2u1l2r1l4,3-9u1,11-8l9,7-10u1r3u1r1d1,5-9r3,9-8d1,7-7d1l1d1r4,6-1d6,7-8l4,6-2r1u1r1d6l1d1r3,6-6r1,8-5d2l1d1r2,6-5r1,8-4d4l1d1r2,6-3r1u1r1d6l1d1r1,7-3d4l1d1r2,4-5r1d2r1d1l2,6-4d4,7-9l5,4-4r1,6-3d5,7-9l4,4-2r1d5r1l1d1r1d1l2,6-1d6

;7
###########
#  ....#  #
#@$*##.$  #
# $....   #
##$####$###
#        ##
# #$##   #
##   $ $##
#  $     #
# $ # $  #
#.#$#$ #.#
#.#    #.#
##########
Solution: 6-2r1,7-3d2,5-9r2,8-8d2,8-6l1d2,6-9r1,8-8d1,2-8r1,3-9l1,1-8d2,4-7r1,5-8l2,2-7d1,3-9l1,1-8d1,8-1d1,9-3l1,7-2d6,1-3r6,2-3u1,1-1r4,2-5u3,1-1r3,9-3l6,2-4u2,1-1r2,3-7u1,2-5r4,7-6u2,8-3l5,2-4u2,1-1r1,5-7r1,7-8u5,6-2r1,8-1d1,9-3l5,6-7u1,5-5r1,7-6u3,6-2r1,8-1d1,9-3l4,5-11u3,4-7r2,7-8u5,6-2r1,8-1d1,9-3l3,8-9l1,6-10u2,5-7r1,7-8u5,6-2r1,8-1d1,9-3l2,3-11u3,2-7r4,7-8u5,8-2l1

;8
###############
####@#####.####
### $ ###...###
## $ $ #.#$  ##
# $   $#. $$$ #
# $ $ $.. #   #
# $   $#.$ ## #
#  $ $ #.$    #
##  $  #. $$ ##
###   ###...###
##  $  #.....##
###   ###...###
###############
Solution: d1,3-2d2,4-7d1,5-5r3,11-9u1,11-5u1l1u2,13-4l1,12-3l1,11-5u1,10-4u1,12-3l1,11-2l1,10-4u1,8-4r2,11-5u2,11-8l1,8-8r2,10-6l1d3,10-10l1,9-6u1,8-4r3,12-7l1d2,10-10r1,10-6d4,8-5d2,13-4l4,8-5u1,6-7u1,5-5r3,9-4d2,8-7r1u1r1d1l1d1r1u1r1d3,5-2d1,6-3d1,4-4r1,5-5r3,9-4d2l1d1r1u1r1d1l1d1r1u1r1d2,6-3d1,5-5r3,9-6u1,8-4r2,3-3u1r1d1l1d1r2u1r1d1l1d1r3u1r1d2l1d1r1u1r1d2r1l1d1,4-7r1d1r1u2l1u1r3u1r1d6,2-7r3d1r1u2l1u1r3u1r1d5,1-4r4u1r1d1l1d1r3u1r1d2l1d1r1u1r1d2l1d1r1,1-6r4d1r1u1l1u1r3u1r1d2l1d1r1u1r1d2,3-4d1r5u1r1d4,1-5r7u1r1d2l1d1r2d1r2u1l3r4u3l4d1l4d2l2u1l1u1r6d1r2d1r3u3l4d1u1r4d3l3u1l1u1l6d5r1d1r1u5l1u1r3l4d5r1u4l1u1r3

;9
##############
###   ##   ###
##. $ ## $ .##
#. $ $  $ $ .#
#. $  $$  $ .#
#. $ $  $ $ .#
##.$ $ @$ $.##
##.$  $$  $.##
###.$$  $$.###
####. $$ .####
#####....#####
###........###
##############
Solution: r1d4l1d1r2l1u3l2d2r1d1l3r2u3r1d2l1d1r2u5l2d4r1d1l2r1u4l1d3u3l1d1u2l1d1r1u2l2r2u1l2r2u1l2r1u2r2d1l2d4r2d2r3u1l5r4u2l1d5u3r3d1l5u4r1d5u3l1u4r1d3u2r1d6u6r1d7u6r1d6u5r1d2l1d1r1u1r1l1u1r1l1u1r2l2u1r2l2u1r2l1u2l2d1r2l2d7u4l4d1r2u1r1d4

;10
##############
##. $    $@.##
##.$ $  $ $.##
##.#  $$  #.##
#####$  $#####
##### $$ #####
### $    $ ###
###        ###
##  $####$  ##
#.....##.....#
##############
Solution: l1,9-2r1,11-1d1,8-3d1,7-4d2,9-7d1,10-9l1,4-7d1,3-9r1,3-6r1,8-7l4,3-6d2,4-9l2,6-4d2,7-7l3,3-6d2,4-9l1,5-5d1,6-7l2,3-6d2,6-4u1,5-3d3,6-7l1,4-6d2,10-6l3,8-4d2,7-7r2,10-6d2,9-9r2,6-5d1,5-7r4,10-6d2,9-9r1,8-3l1,7-1r3,7-2r3,4-2l1,2-1d1,5-1l2,5-3r2,8-2d4,7-7r2,10-6d2,6-1d1l3,5-3r2,8-2d4,7-7r1,9-6d2

;11
###########
#         #
# $  $ $$ #
# $  $  $ #
## $$$$$ ##
#### @ ####
####$#$####
##...$...##
####.#.####
#....$....#
###########
Solution: 6-5d2l3,4-9r4,6-7d1,5-9r2,4-5d3,5-9l3,6-5u2,4-5u2,4-1d7,5-9l2,6-1d7,5-9r1,6-2l1,4-1d7,5-9l1,6-3l1,4-2d6,4-4r1,6-3d5,9-3l2,6-2d5,1-3r2,4-2d5,2-4r1,4-3d3,5-7l1,8-4l1,6-3d3,5-7r2,8-1d1l1,6-1d5,5-7r1,9-3l2,6-2d4,1-2r2,4-1d5

;12
###############
#             #
# $$$$$@$$$$$ #
# ....$.$.... #
# .##.$#$.##. #
# *****.***** #
#             #
###############
Solution: 2-1d2,7-3l4,5-6u1,7-5l1,6-3d1,12-1d2,7-3r4,9-6u1l1,8-3d1,9-3d1,9-1d2,10-1d1,11-1d1,7-2r1,9-1d1,3-1d1,4-1d1,5-1d1r1,7-1d1

;13
###############
#@            #
#.$ $  #  $ $.#
##.$ $ $ $ $.##
###.$  #  $.###
####*$$*$$*####
#....  .  ....#
###############
Solution: 6-4d1,8-4d1l1,7-6l5,7-6r5,6-4d1,7-6l4,5-4d1,6-6l2,5-4l1,4-3l1,3-2l1,9-4r1,10-3r1,11-2r1,9-4d1,8-6r3,9-2d3,8-6r2,11-2l1,9-1d4,8-6r1,5-2d3,6-6l1,8-3l1,6-2d2,5-5r1,3-2r2,6-1d4,5-6r1

;14
###############
##.#.# . #.#.##
##.#.# $ #.#.##
#  . # $ # .  #
# $ $ $ $ $ $ #
#.#$ $ $ $ $#.#
#.# $ $@$ $ #.#
#.#    *    #.#
###############
Solution: r1d1r3u3r1u1r1d3u2l2d1l1u3d2u1r1d1r1u2d1l1d4l1u4d4l2u1r2d1r1u2l1u1r2u1r1d2u1l2d3l3u2r2d1r1u2l1u1r1d1r1u1,9-7l1u1l2d1l3u2r1u3d3l1u1l1u1l1d3,4-3l1d1l1u2,6-5l2,3-6u1,4-4l2u1l1d2,4-7u2,5-4l3u1l1d1,6-6l2,3-7u3,4-3l1d1l1u1,8-5l3d1l1u3,7-4l3d1l1u1r9u1r1d1,6-2r1u1r1d2,7-4r3,11-5u1,7-4u2

;15
############
# . . . .$ #
# #$#$#$#$.#
# . . . .  #
# #$#$#$#$ #
# . .$. .  #
# #$#$#$#$##
# . . . .  #
# #$#$#$#$ #
# . . . .  #
###$#$#$#  #
#@         #
############
Solution: undefined

;16
          ###
         ##.##
        ##.@.##
       ##.$$$.##
      ##.     .##
     ##*$$$$$$$*##
    ##*    $    *##
   ##. $   $   $ .##
  ##.   $  $  $   .##
 ##. $$$$$ $ $$$$$ .##
##.$$     $$$     $$.##
#..........*..........#
#######################
#######################
Solution: d1l1,11-3r1,10-4d2,12-4d2,10-9d1,12-9d1,14-7r2,18-9d1,17-11r3,19-9d1,18-11r1,8-7l2,4-9d1,5-11l3,3-9d1,4-11l1,10-10r9,5-8d2,6-11l2,6-8d2,7-11l2,7-8d2,8-11l2,9-8l2,6-7d3,8-8d2,9-8d2,12-9l4,7-8d2,8-6u1,9-4d5,10-10l7,13-8d2,13-8r4d2,16-11r2,15-8d2,14-8d2,15-9r3,12-6d3,11-10r4,16-9d1,14-6u1,13-4d5,12-10r5,18-9d1,10-6d2,11-9l7,12-8l7,12-5l1u3,10-6u3,10-7r1,12-8u5,11-5d4,10-10r6,17-9d1

;17
###
#.##
#*.##
#.$.##
#.$ .##
#. $ .##
#.$ $ .##
#. $ $ .##
#.$ $ $ .##
#. $ $ $ .##
#.$ $ $ $@.##
#. $ $ $ $ .##
#.$ $ $ $ $ .##
#. $ $ $ $ $ .##
#.$ $ $ $ $ $$*##
#*.............*##
##################
Solution: 12-13d1,11-15r2,13-13d1,11-12d2,10-13d1,3-4l1u1,1-3u1,1-5u2,2-13d1,5-14l3,4-13l2,3-12l1,10-11d1,9-12d2,8-13d1,10-12d1,9-14r2,12-13d1,7-14l3,3-13d1,6-13r6,7-12r4,8-11r2,2-9d1r1d1r1d1r1d2u2l1d2u3l1d2l1d1r3u1r1d1l3u3l1u2l1u2r1d1r1d1r1d1r1d1r1d2l1d1r1u1r1d1u2l1u1r1u1r2l2d1l2u1l1u1d1l2r1u1l1u1l1u3r3l1d1r2l1d1r2l1d1r2l1d1r2l2u1l4r2u1l2r1u1l1d6r2u7d3r2d1l3d1l1u6r1u1l1d5r5d2l4d1l1u6r1u1l1d9r4u1l3d1l1u7r1u1l1r2d5r5d1l5d1l1u8

;18
#######      #######
####################
#                  #
#  $### #   ## $ $ #
#  $    ##   #$ $  #
#  $  $$  #    $ $ #
# ## $  $  # #$ $  #
##  $    $ # # $ $ #
#  $   # $ #  $ $###
# $  #@  $   $  ...#
#$# ###### # ## ...#
#.....   ###  # ...#
#..... $$$ #####...#
#.....#         ...#
####################
     ##########
Solution: u1l2d1l1d2r5d1l2r1d1r10l10u1l1u1l1d1r2d1r3u1l5u1l1d1l1u3r1u1r2u1r1u3l2r1l2d3l1d4r1d1l1u1l1d1r1u4l2d4u3r1u1r1d2u1l2d2r5l3u4r2d1l1u1l1d3u1l2d2r3l1u3r3u2l1u1l1d2r1d1l1u1l1d3u1l2d3r3u1l1u4r4u3l1d2r1d1l2u1l1d1r1d1l1u1l1d4u2l2d3r7l5u5r2u2r4d1l4u1l1d2r1d1l1u1l1d4u2l2d3r5l3u5r2u1r5d1l5u1l1d1r1d1l1u1l1d4r1d1l1u1d1r3u1l1d1l2u5r7d2r2u4l1u3r7d5u5l7d3r3u1r2d1l2r1d2r1d2l1d1r2u1r1d2l1d2l9u1l3r3u1l2d1r1d1r3u1l4r4d1r6u6l1u2r1d5l1d1r2l1u5r2d1l1u1l1d3l1d1r2l1u3r2u4l1u1l1d7l1d1r1d1r1u1l1u1r1l2u2r1u4r2d1l1u1l1d7l1d1r1u1r1d2u3l1u5r1d2r1d1l1u1l1d4l1d1r1u1r1d1l1u5d1l1u1r1u2l2d1r1u1r1d6l1d1r1l1u5r1u4l1d2l1d1r1u1r1d5l1d1r1u8l5d3r4u1r1d4l1d1r1l1u2l1u1r1u4l4d3r4u1r1d8u7l4d4r3u1r1d3u2l3u1r2u1r1d3u8l2d6l1d1r2u1r1d1u7l9d4r1d1l3u1l1d1r1d1l1u1l1d1r1d1l2u1l1d3u3r4u3r3d4r7l6u1r1u1l5u1l1d1r1d1l1u1l1d1r1d1l2u1l1d2u2r5u4r1u2l6d3r3u1r1d3r1d1l2u1l1d5u5r1u2l2u1r1l1u2r1d2l1d1r3u1r1d1r1d1l1u1l1d2r1d1l2u1l1d4u2r1u1r1u4l1d1l2u2r1d1l1d1r2u1r1d3r1d1l2u1l1d3

;19
###########
#         #
# *$$#$$* #
# .. # .. #
# .$.$.$. #
# * $+$ * #
# .$###$. #
# .$ # $. #
# .$ # $. #
#    *    #
###########
Solution: undefined

;20
       ###
      ##.##
     ##...##
    ##  $  ##
   ##   $$$ ##
  ## $# # #  ##
 ##   ##  #   ##
##.$  ## $  # .##
#..$  $   $# $..#
##.#$## $  $$ .##
 ##   #$ #$#  ##
  ##  # $$ @ ##
   ##.......##
    #########
    #########
Solution: undefined

;21
    ########
   ##......##
  ## $$$$$$ ##
 ## $   $  $ ##
## .$$....$$. ##
# ...$*$$.$... #
## .$$....$$. ##
 ## $  $$  $ ##
  ## $$..$$ ##
   ## .  .@##
    ########
Solution: undefined

;22
    ######
   #......#
  #. $$$  .#
 #.$  $  $ .#
#.  $ $ $   .#
#.$  $ $  $$.#
#.$$# $ # $ .#
#.$  $@$  $$.#
#.  $#$#$  ..#
#. $  $  $  .#
 #.   $    .#
  #. $$$  .#
   #......#
    ######
Solution: undefined

;23
#######   ########
#.... #####      ##
#....  ###  $ $   ##
#...#  ##  # $ $ $ ##
#...#$$$ #  $ # $ $ ##
#.*$      $$ $ #    .##
#..  ##$$$ ##  $$# $$.#
######    ####     ...#
     #  @##  ##########
     #####
Solution: undefined

;24
   #########
  ##.......##
 #### #$#$$ ##
##.         ###
#..$$$$$$$$$#.#
#..$   @   $..#
#.#$$$$$$$$$..#
##     #   $.##
 ##  $### $ ##
  ##.......##
   #########
Solution: l5u1l1d1r1u2r8l1u1d1r2u1l1u1l5r5d2l1u1r1u1l4r3d2l2u1d1r2u2l2d2l5d2r8u2r1u1l1d1l1u1r1u1l2r2d4l1u3r1u1l1r1d4r2d1r1u1l4d3u1r1d1u1r1l1u1l1u1r3l2d1r2l2u3r1d1l1d1r1l3r1u2l7d2r1u1l1u1r7d1r1u1r1u1l1d1l1u1d1l6d2r1u1l1u1r6d1r1u2d3l7r1d2r1d1u1l2d1r1d1r3l3u2r1d1l1d1r2l2u4r1d3l1d1r1l1u2l1u1r1u1l2r3u1d1r4u2l6r1d4r2u1l1u1r5u1r1d1l1d1r1l2d1l1u1r1u1l6r5d1l2u1l1d3u5r2d1l5r1u1r6d1l6r5d1l3u1l1d4

;25
      ######     #####
  #####   #########  #
 ##  $    #    ..# $.#
##  $  $#$ $ $ ..*.*.#
#  $     $  ### *....#
# $ $# $#  ##  #.***.#
#  $  $   ##   #*.+.*#
##  $    ##    #######
 ##   $ ##
  ##   ##
   ## ##
    ###
Solution: u1r1l1r1u1r1u3d3l1d1l2u1r2l1u1r1l1u1r1d1l3u1l2d1r4u1r1d3u2l4d1r2u1r1d2u2l3u1l3d1r3u1r1d1l1d1r1u1r1d2u2l2u1l3d1u1l1r1d1l1d1l1d1l1r1u1l1d2l1d1l3d1l2u1l1u1l1u2r1u1r1u1r4l1d2r3u1r6u1r1d1l1d1r3u1r1d1u1l10d2r1u1l1u1r6d1r2u1l1d1l1u1r1u1l3d1l2d1l5u2r1d1l1d1r3d1r1u1l1u1r5u1r2d2l1u1r1u1l1d1l6d1l3u2r1u1r2d2u2l2d3r2d1r1u1l1u1r6u1r1d1l1d1r1u1r1d1u1l8d1l2u2r1u1r1d2u1l2d2r2d1r1u1l1u1r6u1r1d1l1d1r2u1r1d1u1l9d3l2u1l1u1r3d1r1u1l1u1r6u1r1d1l1d1r3l3u1l5d2l1d1l1d1l2u2r1u2l2d1r4d1r1u1l1u1r6u1r1d1l1d1r2l1u1l7u1l6d1r3u1r1d1l1d1r3d1r1u1l1u1r6u1r1d1l1d1r1u1l7u1l6d1l1d1r7d1r1u1l1u1r6u1r1d1l3u1r2l1d1l3u1r3d1l5d3l4d3r1u4r1u2l2d1r4d1r1u1l1u1r9l8d2l1d1l2d1l2d1l2u1r3d1r1u3l1u1r3d1r1u1l1u1r8l8d3l5u1l1u1r6d1r1u1l1u1r7l7d3l1d1l6u2l1u1r8d1r1u1l1u1r6l6d3l3d1l3u2l1u1r7d1r1u1l1u1r5

;26
########
#.....#######
#....##     #
#..*$$  $ $ ##
#.*. $ $# $ ##
#....##  $$  #
#######$     #
     ## $ ####
 ######$ $####
 #@$ $ $  ##
 #       $##
 #######  ##
     #######
Solution: undefined

;27
########
##..  .##
 ##.$$ .##
  ### $ .#####
   # # #     #
   #  $ ##$# #
   # $ $   # #
  ##  $ #  .##
 ##. $ $@#.##
##..  $ $.##
###########
Solution: l1d1l4r5l4r1l1u2r1l1d2r3u2l1d1r1d1l3r2u1l2r2,6-6r1u1l1u2l1,10-4d2,9-7r1,7-6r2,10-5d2,6-3l1r1l1u1l1r1d1r2u1l1u1l3r1d1r1u1r1d1l1d1r2,4-5r1,6-6u3,7-2l1d1l1u1,6-1l2,4-7r1,6-8u5,5-2r1,4-6r1,6-7u5

;28
            ##############
##############..         #
#. $@$ $ $    .*#####$   #
#.$ $ $ $  $#...$      ###
#. $        #*$$$$$$$$$###
#############. $ $ #....#
            #.     #....#
            ########....#
                   ######
Solution: l1d1l1d1r5l2u1l1d1r3u1l1u1d1r3l3u1l1r1d2u1r2u1l1d1r2d1r2u1l1d1l2r3u1l1u1r3d1r2l2u1l4r4d1r2u1l4r3u1r8d4l1d1r1u3l1d1r1d2l2u1r2l1u2l1d3r1u3r1u2l1d2l1d1r1u1r1d3u3l1u2l6d2r6d4r1l1u5r1d4u2l2u1l7d2r1u1l1u1r8u1r1d3u2l8d3r4u2d2l4u3r6d1r2u2d1u1l1d1l1d1r1u1r1d1l3,18-5u1,17-3r3,21-4u1,16-5r1,18-6u1,17-3d1r3u1r1d3,16-5r1,18-6u1l1u1r2u1r1d2,14-5r3,18-6u1l1u1r2u1r1d1,15-3d1r5u1r1d2,15-6u1l1u1r6u1r1d1,8-3r2l1u1r4,14-1d3r1d1l1,11-4u1l1u1r3,14-1d2r1d1l1,7-2r7,15-1d1l1d1r4,4-3r6d1r1u1l1u1r4,15-1d1l1d1r2,5-2r8,14-1d1r1,18-3r1,16-3r1,13-3r2,2-3r8,11-4u1l1u1r4,3-2r10,8-4l6,3-2l1,17-3l3,19-3l4,21-3l5,21-3u1,22-1l7,24-1l8

;29
    #######
    #     #
    #$$ $ #
    #  $$ #
    #$$   #
    #  $$ #
#####$$ $ #
#.... # $ #
#....   $ #
#..###$## ########
#....       $ ...#
#....$$# $  $$$$*#
##### $@#     ...#
    #   ##########
    #####
Solution: d1l2r2u1l1u1l3,1-11r2,5-10r3,8-11r1,10-10l7,2-11u3l1u1r2,10-12u1,11-10l8d1l2r1u3l1u1r1,5-13u2,6-10l3,2-11u3,6-8d1,5-10r3,10-10l8d1l1u3,11-10r4d1,14-12u1r1u1l12d1l1u1,13-12l1u1,13-10l11d1l1u1,9-8l7,7-4d3,6-8r2,9-7d1l1,9-8d1,10-10l3,6-9d2l4,7-12l1,5-13u1,6-11l3,5-5d2,6-8l3,7-7r1,9-6d3,10-10l3,6-9d2,7-12l1d1l1u1,6-11l2,7-6r1,9-5d4,10-10l3,6-9d2,7-12l1d1l1u1,6-11l1,7-5r1u1r1d5,10-10l8,14-12r1,12-11r1d1r1u1l1r1l1u1r1,5-6r3,9-5d4,10-10l7,7-2d5,6-8r2,9-7d2,10-10l3,6-9d2,7-12l1d1l1u2,6-10l2,7-3r1,9-2d7,10-10l3,6-9d2,7-12l1d1l1u2,6-10l1,5-3d4,6-8l2,5-1d6,6-8l1,5-4r3u1r1d6,8-10r5,8-1d6l1d1r1u1r1d3,8-11r3u1r1d1l1d1r3,5-2r3u1r1d9,8-11r2u1r1d1l1d1r3

;30
     ###
    ##.##
   ##.*.##
  ##  $  ##
 ##  $+$  ##
##  $ $ $  ##
#..$  $  $..#
#.$   $   $.#
##.$$$$$$$.##
 #.   $   .#
 ##.$$$$$.##
  ##..*..##
   #.....#
   #######
Solution: l1,6-4r1,7-3l1u1,5-4u1,3-7d2,4-9d2,5-9d2,9-7d2,8-9d2,7-9d2,7-11l1,5-9r1d2,4-7d3,8-9l1,7-7d3,8-7d3,5-9u1r1d2,3-7l1,4-6l2,9-7r1,8-6r2,6-8r3,10-7d1,5-6d2,6-9l3,3-4r3,7-5u2,7-6l4,6-8u1,5-6r4,6-6u3,9-4l2,8-4d3,7-8r2,4-4d3,5-8l2

;31
################################
#                              #
# *       * *       $ *    *   #
#  *     *  * ***** $ *    *   #
##  *   *   *   @   $ *    *  ##
 #   * *    * ***** $ *  *****#
 #    *     *       $ *       #
 #                            #
 #         .....              #
 #*       * *         *       #
 # *     *  *   ***** *  *****#
 #  *   *   *         *    *  #
##   * *    *   ***** *    *  ##
##    *     *         *    *  ##
################################
Solution: 14-4d3,15-8l3,15-4d3,16-8l3,16-4d3,17-8l3,17-4d3,18-8l3,18-4d3,19-8l3,21-5l6,20-7u1,21-5l5,21-4l1,19-3d1,20-5l3,21-3l1,19-2d2,20-5l2,20-1d3,21-5l2

;32
#######################################################
#                                                   ####
# $                                                   ##
# $                                  $     $    $$$$$ ##
# $   $$   $$  $   $     $$$$     $   $   $     $   $  #
# $  $  $ $  $  $ $  $$$    $ $$$$$$   $ $  $$$ $   $  #
# $  $  $ $  $   $        $$        $   $       $$$$$  #
# $  $  $ $  $  $ $  $$$    $ $$$$$$   $ $  $$$ $   $  ##
# $$$ $$   $$$ $   $     $  $     $   $   $     $   $  ##
#            $            $$         $     $    $$$$$  ##
#            $$                                        ##
#           $$  $                                      ##
#          $ $ $ $        @                            #
#           $$   $                                     #
#               $                                      ####
#              $$$                                     ####
#                                                         #
#                                                         #
#                                                         #
# . #   #   #   ##### ### #   #   #   ##### # #   #   #   #
# . ## ##  # #  # # # #   ## ##  # #  # # # # #  #   # #  #
# . # # # #   #   #   #   # # # #   #   #   # # #   #   # #
# . #   # #####   #   ##  #   # #   #   #   # ###   ##### #
# . #   # #   #   #   #   #   # #####   #   # #  #  #   # #
# . #   # #   #   #   #   #   # #   #   #   # #   # #   # #
# . #   # #   #   #   ### #   # #   #   #   # #   # #   # #
# .                                                       #
# .                                                       #
# .                ..........         .......             #
# .               .          .       .       .         ####
# .              .            .     .         .        ####
# .             .              .   .           .       ##
# .             .              .   .           .       #
# .             .              .   .                  ##
# .             .              .   .                  ##
# .             .              .   .                  ##
# .             .              .   .                  ##
# .             .              .   .      ......      ##
# .             .              .   .           .     ###
# .             .              .   .           .     ##
# .             .              .   .           .     ##
# .             .              .   .           .     ##
# .              .            .     .         .       #
# .               .          .       .       .        #
##...........      ..........         .......         #
#                                                     #
#######################################################
####            #####        ########            ######
####                           #####              #####
                                ##
Solution: undefined

;33
########################
#              .       #
# $ $$$$$$$$$$. .$$$$$ #
# $$         . # .   $ #
# $ $ $$$   . # # .  $ #
# $  $     . #   # . $ #
# $ $ $   . #     # .$ #
# $    $ . #       # . #
#........ .         # .#
#.$     .  . #     # . #
#.$ ### . # . #   # .$ #
#.$ ### . ## . # # . $ #
#.$ ### . ### . # .  $ #
#.$     .      . .   $ #
#................ $  $ #
# $ $ $ .       . $  $ #
# $ $ $ . ##### . $  $ #
# $ $ $ . ##### . $  $ #
# $ $ $ . ##### . $  $ #
# $ $ $ . ##### . $  $ #
# $ $ $ .   @   . $  $ #
# $ $ $ ......... $  $ #
########################
Solution: l3u6l4d7r7l4u7l5d7r8l8u7l2d7r9l9u1r1l1u6r2d6l1d1r7l6u1r1l2r1u6r2d6l1d1r4l3u1r2u1r1d1r8u7r1u1r2d9l4r4u11r1u1r2d12l6r6u1l2u1l1d1r1d1l3r2u1l2r2u1l2r2u1l2r2u1l2r2u1l2r2u1l2u1l12d1r2l2d1r2l2d1r2l2d1r2l2d1r2d1l4u1r2u1r1d1l1d1r2l4u11l1r1d1l1r1d1l1r1d1l1r1d1l1r1d6u4l1r1d5l2u5d5r2u5r3d1r1u1l1u1r1d5l4u1r3d1r1u4d3l4u1r2d1r1u3d2l3u1r1d1r1u2d1l1d4l3u1r2d1r1u5d4l3u2r1u2r1u7r5u2l1d1l1d1r1u1r1d5u6r1u3l1d8u4l3u1r2u1r1d5u4d1l5u1r4u1r1d4u6l1d4l1d1r1u1r1d1l2u1r3d1r1d1r1d1r1d1r1d1r1d1r5d1l9r8d6r4u6l11r11u1l8d1l1u2d1r9d2l4d1l1u2r1u1l3d1l1u1d1r8d2l4d1l1u2r1u1l6r10d3l4d1l1u3r1u1l5r9d4l4d1l1u4r1u1l4r8d5l4d1l1u5r1u1l3r7u3l1d2r1d1l6r5u1r1u4l2d4r1d1l4r5u5l1d3r1d1l6r5u2r1u6l1d7r1d1l4r4u6l2u1l1u2r1d1l1d1r1u1r1d7r1d1l2d1l1u1r1u1l1r3u11l2d4l1d1r1u1r1d5r1d1l2r2u8l1d6r1d1l1r1u9l1d7u3l2u2r1u1r1d4u5l4d1l1d1r3d1r2u2l1d3u4l1d3u3l1d2u2l6d1r9u1r1d6u6l12d1r6u1r1d1l3d1l1d1u1d1l1u1l1u1r4l3d2l3u1r2d1r1u1l1u1r2l1d2l2d1l2d1l4u1r6l5u1r6u3l3d2l1r1u1r1d1r1u1l1u1r5l3d2l1d2l3u1r1d1r1u1l1u1r4l4u2l1d4l1d1r3u1r1d3l1d1r2u1r1d1l2u2l3d1l6u1r8u1r1d2l1d1r1u3d1l9u1r8u1r1d2l9u2r8u1r1d1l3d1l4u2r5u1r1d3l6d10r1d2l1u9r1u1l2r1d11l2u1r1d1r1u7l1u2r1d3u7r3u2r1u3l1d6l5u3r6u1r1d4u6l3d6u6l1d6u5l1d5u1l2u3r5u1r1d5u6l5d6

;34
######     #######
#...*#     #     #
#..*.####  #  $$ #
#...*...#  # $@$ #
#$$$$$$$#### $ $ #
#           $ $$ #
# $$ $ $ $ $ $$  #
#..*########..####
#...#      #..#
#...#      ####
#####
Solution: d1u1d1l1d3u2d1l1r1u1l6u1d1r3d1r1u1l3d1r1u1l3d1r1u1l3d1r1l1u1l1u1d1r2u1d1l2u1r1u1l1u1l2d6u6r2d3l1d3u2r1d2u6l2d5u3r1l1u2r2d2r1d1l1u1l1d3u2r3d1l1u1l1d2,6-5u1l1d1l1u1d1l2u3d3r5d1l5u1l1d1r1u1r7d1l6u1l1d1r5u1r4d1l7u1l1d1,12-5d2,13-4u1,15-6l1,13-5d1,12-3d1,13-5l11,1-6u4,14-6u1,16-5l14d1l1u3,14-3d1,15-5l13d1l1u2,16-4l3u1l1d1r1d1l10d1l1u3,13-1d3,14-5l11d1l1u2,14-1d3,15-5l11d1l1u3,16-3l3u1l1d2,13-5l9d1l1u2,16-2l3u1l1d5

;35
     ######      ###
    ##############.##
   ##      #*###*#..##
  ##  $ #$$#######...##
 ## $   #          $ .##
##. $ # $ $$$# $ $#   .##
#..$ #  $  $ @##.  #   .#
##.   # $ $  ####. #  .##
 #####  $$  ##  ##....##
     #  $  ##    ######
     #    ##
     ######
Solution: 5-4d1l1d1l2,4-3d1,3-4d2,4-7l1,5-5l1u1l1d1,4-6l1,7-3l1u1l1d1r1d1l1u1l1d1r1d1l2,9-9l1,12-6u1d1l2u1r1u1r3d1r1l1u1r2d1u1r1d2r1d2r2u3l1u1l1,20-3l1d2u1l1u2,16-4r2,19-5u1,20-3l1d1l1u1,12-6u1l1u1r7,19-5u2,9-4r9,19-5u1,20-3l1,10-2d1,9-4r10u1r1d4r1d1l2,7-5r4d1r1u1l1u1r8,20-3d4,21-8l1u3l1u1l9u2l3d1,10-8u3l1u1r10,20-3d4,9-7u1,8-5r3d1r1u1l1u1r8,20-3d1l1d1r1u1d1u1r1d3,9-2d2,8-5r3,12-6u1l1u1r8u1r1d1l1d1r1u1r1d2l1d1r1,9-9u3,8-5r3d1r1u1l1u1r8u1r1d1l1d1r1u1r1d1l1d1r2,7-6r4d1r1u2l1u1r8u1r1d1l1d1r2,7-7r2d1r1u3l1u1r10u1r1l1d2r2u1l1d1l1u1,6-9r2d1r1u4l1u1r3d1r1u1l1u1r8d1r1u1,8-9u3l1u1r4d1r1u1l1u1r9

;36
       ###
      ##.##
     ##...##
    ##.....##
   ##.......##
  ##...$$$...##
 ##.... $ ....##
##..... # .....##
####### . #######
#######$*$#######
#.      *      .#
#.$$$$$ . $$$$$.#
#.$     #     $.#
#.$$$$$$.$$$$$$.#
#.             .#
########.########
#  $ $ $$$ $ $  #
# $ $ $ $ $ $ $ #
#  $ $ $@$ $ $  #
# $ $ $ $ $ $ $ #
#.      .      .#
#################
Solution: d1l1d1l4u1l1u1l1d1r1d1r5u1r2d1r2l2r4u1r1u1r1d1l1d1l3u1r1d1l3u1r1l3d1l2u1l1u1l1r1d2r3u1l1u1l1r1d2r1u1r1u1l1d1r2d1r3u2r1l1d2l2u2r1l1d1l2u1r1l2u1d1r1d1r1d1r3u1l3u2d2r2u2r1u1r1l1d2l1d1l2u2d2r2u1r1u2r1d1l2d3l2u3r1u1r1l1d1l1d1l2u1r1u3r7u4l6u2l2u5d3r4u1r1l1d1r1u1l1d1l3u4d4r1u3d2l2d3r2u1d1l2u2r2u1r1d1l1d1r4l4d4l2u4d1r2u2l2u1l1d1r1d1l4r4d3r1d1r1u4d3l2u4r3u1r1d1l1d1r2l3d2l1d1l1u4r1u1l2u1l1d2r1d1l2r3d5l5u1l1u1r6d1r1u2r1u1l1d1l1u3r1u1l2u1l1d2r1d1l1r2d5l4u1l1u1r5d1r1u2r1u1l1d1l1u2d1r2u2l3u1l1d1r2d6l3u1l1u1r4d1r1u2l1u1r1d1r1u2d1l2u2r3u1r1d1l1d1r1l2d3l5d2r1u1l1u1r3d1r1u2l1u1r1d1r1u2d1l2u2r3u1r1d1l2d4l4d2r1u1l1u1r2d1r1u2r1u1l1d1l1u2d1u1l1u2r2d1l1u1l1d1r1d4r1l1r8d4l6u7d1l2u2r2u1r1d1l1d8r6u2l5r5d2l6u7d1l2u2r4l2d6r5u1r1u1l6d1l1u2l1u1r1d1r1u2d1l2u2r3l1d6r4u1r1u1l5d1l1u2l1u1r1d1r1u2d1l2u2r2d6r3u1r1u1l4d1l1u2r1u1l1d1l1u2d1r2u2l5r5d6r2u1r1u1l3d1l1u2r1u1l1d1l1u2d1r2u2l4r4d6r1u1r1u1l2d1l1u2r1u1l1d1l1u2d1r2u2l3r2l1d4r2d4r5l4u3r1u1l3d1l1u4d1r2u2l2r2d8r2u3r1u1l2d1l1u5l1u1d1r1u2l1u1r1d11r3u3r1u1l3d1l1u6r1u1l1d1l1u2d3r1d8r4u3r1u1l4d1l1u6r1u1l1d1l1u1d2r1d8l2u9r1u1l1d1l1u1r1d10l1u3l1u1r1d1r1u5r1u2d1l3r2d9l2u3l1u1r2d1r1u5r1u1l2r1d9l3u3l1u1r3d1r1u5r1u1l1d9l4u3l1u1r4d1r1u6r1u1l2r1d9l1d1l5u1r2d1r1u3l1u1r5d1r1u5l1u2r2d1l1d9r5u3r1u1l5d1l1u6r1u1l3r2d10l1d3u3r1u1l1d1l1u3l1u1r2d1r1u6d1l2u2r3l1d10l1d4r1d1r2u1d1l2u1l2d2r1u6l1u1r1d1r1u9d1l2u2r2l2d2r1u1d1r1d8l1d5r3u1l2d1l1u5l1u1r1d1r1u8l1u1r3l2d9l1d4r2u1l1d1l1u4l1u1r1d1r1u8l1u1r2l1d9l1d3r2u1l1d1l1u3l1u1r1d1r1u8l1u1r1l1r1d9l1d4r4u1l3d1l1u4l1u1r1d1r1u10d10l1d4r2d2r4u1r1u2l6d1l1u4l1u1r1d1r1u9d9l1d3r5u1l4d1l1u3r1u1l1d1l1u10d10r1d3r7u1l6d1l1u3r1u1l1d1l1u9d9r2l1d2r7d3l1u2r1u1l6d1l1u3r1u1l1d1l1u3l1u1r1d1r1u2d2l1d3r1d2r7d2l6d1l1u5r1u1l1d1l1u3l1u1r1d1r1u1l1d4r1d3r3d3r1u3r1u1l4d1l1u3r1u1l1d1l1u3l1u1r1d4r1d3r3d3r2u3r1u1l5d1l1u3r1u1l1d1l1u2l1u1r1d3r1d5l1d1l3u1r3d1r1u6r1u1l3u1l1d1r1d1l4r6d5l3u1r2d1r1u5l1u1r7u1r1d1l7d5l3u1r2d1r1u4r1u1l7r6d4l2u1r1d1r1u3l1u1r7l6d7l6u1r5d1r1u6l1u1r3d1r1u1l1u1r4l5d2l1d5l5u1r4d1r1u5l1u1r3d1r1u2l1u1r4l2d1l3d2l1d4l5u1r4d1r1u4l1u1r3d1r1u3l1u1r4l2d4l4d3r2d3l1u1l8u1r6d1r1u5r1u1l4d1l1u2r1u1l3r2d3r4d3l4u1r3d1r1u3r1u1l4d1l1u3r1u1l3r2d4r4d4l7u1r6d1r1u4d3l6u1r5d1r1u1

;37
     ###
    #...#
   #.....#
   #.....#
   #.....#
   #. # $####
##### $$    #
#...  #   # #
#...# $ $   ####
#..# $   #     ####
#...$ $$$$ # $ $  #
#...  #  # $  # $ #
####       $$##   #
# @# $ $ $  $ $$  #
# $##########   ###
# $ $ $ $ $ $$ $$ #
#                 #
###################
Solution: l1d3r13u2l1u1l1u1l2u4l1u2d1l2u3r1u1l3d1l1u1r3d3u2l2d2r2d1r2u1l1d1l1u3r1u1l2u1l1d1r1d1l1u1l1d1r4d1l1d2r2u1l1d1l1u2r1u1l3r3d2l1d3r1u2r1u1l1d1l1u3r1u1l3r3d3l3d2r1d1r1u5r1u1l1d1l1u2d1r1d5l2u1l4d4r4u9d10r2u9r1u1l1d7l3d1r2l1d2r2u8r1u1l1d8r1u4r1u1l1d1l1u2r1u1l1r1d5l3r3u1r2d2l2d1l1u4r1u1l2r1d2l2u5d6r2l2d3l1u1l1u1r1d1r1u7d7u1r5d2u3r4d1r1l1u1l2d1u1l2d3r2u1l1d1l1u3r1u1l2u1l2d2r1u6d5r3d1r1l2d2r2d2r1d1r2u1r2u3l2r2d2l1u1d2l1d1l2u1l1u2r1u1d1l1d2r1d1r2u1r1u2l1u1l1u1l3u1l3d2r2u1r1u1l2u1l2d2r1u5d4r2d3r3u1r1u1l3u1l3d2r2u1r1u1l2r1d2l2u5d5r2d1r2u1r1u1l2r1d2l2u2r1u1l3d1l1u7d6r4d1r2d1r2d1r2u1l4d1l1u1r1u1l2r1d2l2u2r1u1l3d1l1u6d7r3d1r2u1r4d3l1u2r1u1l3d1l1u1r1u1l2r1d2l2u2r1u1l3d1l1u5d4u1r1d3r2d1r2d2r2d1r1u3r1u1l3d1l1u1r1u1l2r1d2l2u2r1u1l5d1l1u4d4r3d3u2r2d1r1d1l1d1r4d1r1u3r1u1l3d1l1u1r1u1l2r1d2l2u2r1u1l3d1l1u4d7r3d1r1u1r1u1l1d1l1u3r1u1l3u1l1d2r1d1l5d1l1u2l1u1r1d2r2d2r8d1r2d3r1u5r1u1l3d1l1u1r1u1l2r1d2l2u2r1u1l3u1l1d2r1d1l5d1l1u3l1u1r1d4r3u1r2d1r1d2r2u1l4d1r2u1l4d1r2u1r5l1d1r4d1r1u3r1u1l3d1l1u1r1u1l2u1l1d3u2r2d3l7d1l1u2r1u1l2d1l1u3d3r2d2u1r4d1r6d1r1u3r1u1l3u1l1d1r1d1l2r1u2l2d2r1d1l6d1l1u2r1u1l2d1l1u2d2r2d2r10d1r1u3r1u1l3u1l1d1r1d1l2r1u2l2d2r1d1l6d1l1u2r1u1l3d1l1u3d3r4d2r9d3r3u1l1d1l1u5r1u1l3u1l1d1r1d1l2r1u2l2d2r2d1l7d1l1u2r1u1l3d1l1u2d2r3d2r10d3l1u1d1l2u1r3d1r1u5r1u1l3u1l1d1r1d1l2r1u2l2d2r1d1l6d1l1u2r1u1l2d1l1u1d1r3d2r10d3l6u1r5d1r1u5r1u1l3u1l1d1r1d1l2r1u2l2d2r1d1l6d1l1u2r1u1l3d1l1u1d1r4d1r7d1r1d1r1d2l2u1r2d1r1u5r1u1l3u1l1d1r1d1l2r1u2l2d2r1d1l6d1l1u2r1u1l3r3d3r8d3l6u1r7d1r1u5r1u1l3u1l1d1r1d1l2r1u2l2d2r1d1l6d1l1u2r1u1l2r2d3r8d3l8u1r9d1r1u5r1u1l3u1l1d1r1d1l2r1u2l2d2r1d1l6d1l1u2r1u1l1r1d3r8d3l10u1r11d1r1u5r1u1l3u1l1d1r1d1l2r1u2l2d2r1d1l6d1l1u1r1u1l3r3d2r8d3l12u1r13d1r1u5r1u1l3u1l1d1r1d1l2r1u2l2d2r1d1l6d1l1u1r1u1l2r1d2r11d3l14u3r1d1l1d1r11d1r1l1u1r2d1r1u5r1u1l3u1l1d1r1d1l2r1u2l2d2r1d1l6d1l1u1r1u1l1

;38
           ###
          ##.##
         ##...##
        ##.**..##
  ####### ....# ######
 ##     # $$$# $...*.#
## $  $  # #   $..***#
#  $ $ $ $ $  # #....#
#.#$$$  $   $ $$ #####
#.*..### $$$ $#  #
#.*..# ##  $ $  ##
# ####  ## $@$ ##
#          $   #
#   ############
#####
Solution: undefined

;39
 ####  ##  ###
  ###########
 ##..  $  ..##
 ##.* $ $ *.##
  #..$ * $..#
  # $  .  $ #
  #$$$$$$$$$#
  #..$ $ $..#
###.*$.+.$*.###
###..$ $ $..###
###############
###  #####  ###
Solution: undefined

;40
    ######
    ##   ##
    ## $ .## ######
  ####$ $..# #   ##
 ##    $ .## # $ ##
##  $ $@$##  # #  #
#  $     ##### $  #
# $  $$#$ $   $ $ #
#####      $$   # #
  ##..*.##   $  $ #
 ##..#*.# #####   #
 #.....*.##   #####
 ##.....##
  #######
Solution: d1u1l1u1r2l1u1r2l1u2l2d1r2l1d4r1u2l1u1r1l1d2r1d1l4u1l1u1r3d1r1u1d2l2u1l3d1r3l1u1r3d1l1d1l1d2l1d2r3u2l2r1d1r1d1l3d1l1u1r3u2l1u2r1d3r1d1l4r3u6l2d1r1u1r1d5r1d1l2d1l1u1d1r1u1r1u5l3d1r2u1r1d4r1d1l3r2u5l5d1r4u1r1d4r1d1l2r2u3l1u2r2u4l2d4r1l2d1u1r1d5r1d1l3r2u10r1d3r1d1l1u1l1d6r1d1l2r1u4r3u1d1l3u2r2d1r1d1l2r1u2l2d5r1d1l1r1u4l2u2l1u2r1d1r2u2l1d7r1d1l1r1u3r3d1r3u2l4d1l3u2r2d1r1d1l2r1u2l2d2l1d1r1u1r1d3u3r3d1r2u1l5r1u2l2d2l1d1r1u1r1d2u2r6u1l4d1l3u2r2d1r1d1l2r1u2l2d2l1d1r1u1r1d1u1r8u1l6d1l3u2r2d1r1d1l2r1u2l2d2l1d1r1u1r9d2r2u3l8d1l3u2r2d1r1d1l2r1u2l2d5u3r9d2r2u1l1d1l1u2d1r2u2l8d1l3u2r2d1r1d1l2r1u2l2d4u2r6d1r2u2r3d3l2u2d1r2u2l2r1u4l2d3r1l1d1r1d1l8r1u2l2d3u2d1r5u1r6u2l1d1r1d1l2u1l1d1r1d1l8r1u2l2d2r9u1r1u3l1u1l1d4r1d1l9u1l1d1

