;1
 ####
 #.@#
##$$###
#. .  #
# $   #
###  ##
  #  #
  ####
Solution: d3,1-4r2,2-1d1,1-3r1,3-4u1,5-4l2,3-1d1,2-3r1,3-6u3,1-4r1,3-3d1,5-3l3,3-1d1,4-3l1,2-4u2,3-6u2

;2
################
#.... $ $ $ $@ #
# $        . * #
################
Solution: 14-2l9,11-1r1,9-1r1,7-1r1,5-1r1,3-2r1,1-2r1,8-1l6,4-2r2,2-2r2,10-1l7,12-1l8,6-2r4,4-2r4,14-1l9,10-2r2,8-2r2

;3
  ####
  # .###
###    #
#  $$* #
# $.@ ##
### . #
  #####
Solution: 3-4u1,1-4r2,5-4u1l2,3-1d2,6-2l1,4-1d1,3-5u2r1,5-2d1,1-3r3,3-1d1,4-3l1,4-5u3,6-3l1,4-2d1,5-5u1,4-3d1,1-3r1,3-2d1

;4
########
#......#
# ## $ #
# $    #
#  $#$##
#$$    #
#@##   #
########
Solution: undefined

;5
  #####
###...#
#@*  *#
##$#$ #
 #  $ #
 #    #
 #    #
 ######
Solution: undefined

;6
########
#  .#  ##
#   $   #
##$ #   #
 #. * #.#
 ### $###
   # @#
   ####
Solution: undefined

;7
 #######
##@##  #
# $## .#
#  ##$.#
#  $ $ #
#.    .#
########
Solution: undefined

;8
#####
#@  #
#$$$##
# $  ##
#  #..#
#   . #
#. .$ #
#######
Solution: undefined

;9
     ####
     #. ##########
    ##.....      #
    # . ## $ $   #
#####  ####$######
# $ $$$     #
#  @  ##### #
#######  #  #
         #  #
         #  #
         ####
Solution: r2u1r1u3r6d1r2l1u1l3d1r2l1d4u2d2l1d2r1u6d1u1l1u1l4d3r4l4u3r4d1r1d4u4r1u1d1l2u1l4d2u2r4d1r2u1l5d1l1d2r5u3r3d1l1u1r3d1l1u1l4d3u3r2d1r1l1u1l1r2l3r2l2d5l1d2r1l1u2r1u5l4u1l1d2u1r5d3l5u2d2r5u2r1l1u1d5l1d2r1u6r1u1d1u1l2r4d1l2u1l1d5l1d2r1u6r3u1r2d1l2u1l2d1l2u1r4l3r3d1l2u1l1d5l1d2r1u6l1u1r2l1d3l5u2r1u1r3l3d1l2r1d2l1d1l2u1r7l4u2r1u1r3d1r1d4u3d1l5u2l1d1r1d1l1r1u2r1u2l1d2l1d2r6u2r1u1l5r3d1r1d2l6u2r1u1d1l1d3u1r6d2l1d2r1u6r1u1l5d1l2d3l2u1r7l5u2r2u1r4d5l1d2r1u6d2l6r1l1d1l4u1r9l5u2r2u1r3d1r1d4u2l5u1d1r5u2r1u1l4r2d1r4u1l5r1d1r6u1l6r1d5l1d2r1u6r1u1l1

;10
##########
#      . ##
# $#####  #
##        #
 #$.  .####
##.# ###
#  #$  #
#    $@#
#  #  ##
#######
Solution: undefined

;11
#######
# .+ .#
#   $*#
####$ #
 #  $ #
 #    #
 #    #
 ######
Solution: undefined

;12
#######
#     #
# # # ###
#  $  $ #
#  $ ##.#
# $#$#..#
##   +. #
 #####  #
     ####
Solution: undefined

;13
#######
#     #
#  *. ##
##$ .  #
 # .*# #
 #$.$  #
 # *####
 #$ #
 # @#
 ####
Solution: undefined

;14
    #####
    #  @#
   ## $ #
   # $ ##
#### $ #
#   *. #
#  .*. #
###  ###
  ####
Solution: undefined

;15
  ####
  #  #
###  ##
#  $* ##
#  .*  #
### .  #
  #$  ##
  #@###
  ###
Solution: undefined

;16
#####
#   ####
#  $  .##
# ..*.* #
#####   #
  ###  ##
  #@$ ####
  # #    #
  # #$$  #
  #    ###
  ######
Solution: undefined

;17
   ####
  ##  ##
### $. #
#   ..$###
#   $. $ #
#### .$# #
   ###@  #
     #####
Solution: undefined

;18
 #### #####
 #  # # @ #
## $### # #
#    .*.$ #
# $ *.#   #
#   #######
#####
Solution: l1d3r2u1l1d1l1u1l2d1u1l2d1r1l1d1l2u1r2l2u1r6l5u2r1d2r4d1r2u1l6u1l1d1l1d2r2u2r6u2l2d1u1r2d2l6d2l2u2r5l4u2r1d1l1d1r3l4d1r1d1r1u1l1u1r2

;19
       ####
########  #
# $   $   #
#+**.  $$ #
#. #.    ##
##########
Solution: undefined

;20
      ###
 ######.#
 #. #   #
##  $.*@#
#  #$#.##
#  $  $#
# $   .#
########
Solution: undefined

;21
#####
#   #
#  $#####
#  $. $@#
##  .** #
 # $.#.##
 ##    #
  ######
Solution: undefined

;22
#########
#   ....#
#.$#### #
#@$   $ #
#.$$#  ##
# $    #
####   #
   #####
Solution: undefined

;23
      ####
 ###### @#
##  $ $$*#
#      $ #
#   #### #
##$ #    #
## ##.####
# .    #
#.  .. #
########
Solution: undefined

;24
    ####
 ####. ##
 #@ ..$ #
##$##.*.##
#    #$  #
# $$     #
#  #   ###
########
Solution: undefined

;25
 #######
 # @#  #
##$*.$ ##
#  # #  #
#. $ .  #
# *     #
#########
Solution: undefined

;26
#####
#...#
##.$###
#  $  #
#.  $ #
#.##$ #
# $   #
##$   #
 #@  ##
 #####
Solution: undefined

;27
     ####
 #####. #
 #@$  $ #
##*$. * #
#.  .$  #
####  ###
   ####
Solution: undefined

;28
  #####
### @ ##
#  $*$.#
#  * # #
##$#   #
#.  .$.#
####   #
   #####
Solution: undefined

;29
  ####
  #  ###
###    #
#..$ #.#
# ##$* #
#@$  . #
##  $ ##
 #  ###
 ####
Solution: undefined

;30
 ####
##  ##
# $  #
#..# ##
# $ $@#
#$. #$#
# . * #
#  $..#
#######
Solution: undefined

;31
  #####
  #  @###
  # $$  #
####* **#
# .  .$ #
# $ #.. #
#  $  .##
########
Solution: undefined

;32
#########
#.##  ..#
#    *# #
#  #  # #
#     $ #
###$$####
  #@ #
  ####
Solution: undefined

;33
#########
#.$  $. #
# * .. .#
#   #  $#
### $   #
  #*$####
  # @#
  ####
Solution: undefined

;34
########
#    . #
#$..*  #
#.$$$$##
# .   ##
## .#$ #
 ##    #
  ##@###
   ###
Solution: undefined

;35
#########
#...  $@#
#..$$ $##
#.#  $  #
# *. #  #
## #$$  #
 #   ####
 #####
Solution: undefined

;36
 ########
 # .   @#
 #$# $ ##
 # ## ###
 # .$.  #
## .$ $ #
# **. ###
#     #
#######
Solution: undefined

;37
      #####
  #####.@.#
###  ##   #
#      $$ #
# .$ ### ##
## #### . #
 #.   $$  #
 #  $#  .##
 #   #####
 #####
Solution: undefined

;38
 ####
 # @###
 # .. #
## *.$####
#  $$    #
#   ##   #
##########
Solution: undefined

;39
##########
#...  .  #
# .##  #$##
##.## ##  #
 #     $  #
 # ## ##  #
 #  #$## ##
 # $@$  $#
 #####   #
     #####
Solution: undefined

;40
#####
#...######
##.*#.$  #
##.      #
# $$$$ $ #
#@  #    #
##########
Solution: undefined

;41
  ######
###    #
# .*.  #
#    $ #
###$.$$##
  #.  *@#
  #######
Solution: undefined

;42
########
#.     #
#  # $ #
#.* ## ##
#    *$@#
# .$. $ #
#########
Solution: undefined

;43
  ######
  # .. #
  # #.@#
###$.$ #
#   # ##
#  $$  #
#      #
########
Solution: undefined

;44
########
#  .# .#
# $ *$.#
##@ #  #
# $## ##
#      #
#  #   #
########
Solution: undefined

;45
######
#..  ###
#..  $@##
#.#  $$ #
# $ $   #
##  #####
 ####
Solution: undefined

;46
########
#. #   #
# $. .$#
#.$.#  ##
# $##.$ #
#$$     #
#+$ # .##
########
Solution: undefined

;47
 #####
 #   #
 #   ###
###  $@#
# $ ##.#
# .$  .#
#  $.  #
########
Solution: undefined

;48
######
# . .#
#*$# #
# $  #
# $ ##
# @$ #
# .# #
#   .#
######
Solution: undefined

;49
#########
#.$ . $+#
# # .$###
#. $$  .#
# # $ # #
#   #   #
#########
Solution: undefined

;50
#####
#   ###
#.$.$ #
# *  +#
#  #$.#
#$##  #
#     #
#######
Solution: undefined

;51
 #####
 #@  #
 #$#$##
 # #  #
##    #
#  $ ##
#.# $#
# .  #
#.  .#
######
Solution: undefined

;52
#########
#  .##  #
# *. $. #
## #    #
# $$ ## #
#@*  $ .#
###  #  #
  #######
Solution: undefined

;53
 ####
 #  ##
 # * #
 # . ###
## $*  #
# **   #
#@$.   #
########
Solution: undefined

;54
  #####
  #   #
  # .$#
  #@* #
 ##$*.##
##  *. #
#  $   #
#   ####
#####
Solution: undefined

;55
#####
#   #
# # ##
# $@ #
## $$###
 #  $  #
 ## $# ##
  # $   #
  # # ..#
  # ....#
  #######
Solution: undefined

;56
#######
#.#   #
# $ # ##
# .$.  #
#  #$  #
##$# ###
 #+  #
 #####
Solution: undefined

;57
########
#.     ###
#.####$$ #
#.####@$ #
#.# $ $  #
#.  ##   #
#      $ #
##.#$ ####
 #.  ##
 #####
Solution: undefined

;58
#########
# $  . .#
#   #*  #
#   $  ##
### #.$#
  #$$. #
  #@# .#
  ######
Solution: undefined

;59
  ######
  #.  .#
###  # #
#    $ #
#  *.# #
## # $ #
 #.$$###
 ##@ #
  ####
Solution: undefined

;60
########
#   #..##
# $$#. .#
#  $   *#
##  $#  #
 #@  $ .#
 ########
Solution: undefined

;61
#####
#   ######
#   @#   #
## $$# $ #
 ##*.  # #
  # # .# #
  # #    #
  #.  ####
  #####
Solution: undefined

;62
     #####
     ## .#
  #### *+#
 ##  $ $.#
 #  # $ ##
##$   ###
#      #
# # ## #
#   .  #
########
Solution: undefined

;63
########
# . .$@#
#. $$$##
# #   ##
#.  #$ #
# #    #
#.  #  #
########
Solution: undefined

;64
####  ####
#  #  #  #
# $####  #
# $ $ $  #
#.....  ##
#  . #$$#
###### @#
     ####
Solution: undefined

;65
 #####
 #   #
##   #
#  $ ##
#  #  #
##$$  #
#@$. ###
##*.*  #
 # ..  #
 #######
Solution: undefined

;66
   ####
   #  #
  ##$.###
### $.  #
#@  **  #
#  $.   #
###$.####
  #  #
  ####
Solution: undefined

;67
   ####
   #  #
  ##  ###
###  $  #
#  .... #
# $.$ ###
###$#$#
  # @ #
  #####
Solution: undefined

;68
  ####
###  ##
#  $  #
#+.*..#
# $ $ #
### $ #
  ##  #
   ####
Solution: undefined

;69
     ####
     #@ #
     # *###
 #####$.  #
##    *.*.#
#   $   $ #
#   #######
#####
Solution: undefined

;70
#######
#  .. #
#.*.# #
# .*  ###
## $#$  #
# $$  $ #
#  # # ##
# @#   #
########
Solution: undefined

;71
   ####
   #@ #
####$ ###
# .$.$  #
#. $.*  #
# $ $ ###
###.. #
  #   #
  #####
Solution: undefined

;72
 ##########
 #@  ##   #
##$$$   $ #
# $ #..#  #
# # .*..  #
#    $.####
########
Solution: undefined

;73
   ######
  ##    #
  #   # ##
### . *. #
#  *****.#
#   $  $$#
####  #@ #
   #  ####
   ####
Solution: undefined

