;1
  ####
###  #
# *  ###
# .#   #
## $   #
#  #* ##
# @  ##
#  ###
####
Solution: 2-4r2,4-6u1r1u1l1,1-2r2u1r1d3l1,2-3d2,2-7u1r2u1r1u1l1,2-4d1l1d1r1,4-4l1,2-3d2,6-3l1,4-2d1r1,3-4r1,2-7u4,4-6l1,2-7u3,6-4l1u1l1d1

;2
  ####
 ##  #
 # . #
## * #####
# @*$    #
#  * #   #
###  #####
  ####
Solution: u1r1l1d2r1u1r3d1r2u1l5d2r1u1l1u1r3l2d1l3u1r1u2r2d2l1u1d2l2u1r1d1r1u1r3d1r2u1l5d2r1u1l1u1r2l1u1l1d2l2u1r1d1r2u4l1d1l1d2l1d1r1u3r2d2l1u1l1d1r2d2l1u2l2d1r1u1r4d1r2u1l4

;3
#####
#   #
# #*####
#    $ #
# # * @#
#.*  ###
## # #
 #   #
 #####
Solution: 5-4l1,1-5r2,3-3d1,3-1d2,6-3l3,4-6u1,2-5r1u1r1,3-2d1l1,4-4d1,1-4u1,3-3d1,6-4l2,4-7u2l1u1r1,4-3l1,1-1d1,1-2d2,1-3r1,3-2d1,3-5u2,6-4l1

;4
 #########
 #   ##  #
 #       #
### ###  #
# $ @ # ##
#..* .#$#
# $.$ # ##
### ###  #
 #       #
 #   #  ##
 ########
Solution: 7-4d3,8-8l4,2-8r1,3-6u3,1-4r1,3-8r3,7-9u6,7-1d1,2-2r1,3-3d1,2-5r1,7-4u1,7-1d1,5-2l1,3-1d1,3-2d2,5-6l1u1l1d1,1-5r2,5-4l2,7-2d5,8-8l4,2-8r1u3,1-6r2,3-8r3,7-9u6,7-1d1,3-3d1,5-6l1u1l1d1,7-2d5,8-8l4,2-8r1u5,1-4r1,3-5l1,3-8r3,7-9u6,7-1d1,2-2r1,3-3d1,2-5r1,5-4l1,3-5r1,7-4u1,7-1d1,5-2l1,2-2r1,3-3d1,4-5l1,7-4u1,7-1d1,5-2l1,3-1d3,7-2d5,8-8l4,3-9u2

;5
      #####
     ##   #
     #    #
    ##.#@##
   ## .#  #
  ##. .   #
 ##  $ #  #
##  $ #####
#  $ ##
# $ ##
#  ##
####
Solution: 2-10u1,3-9u1,4-8u1,5-7u1,1-8r1,2-7r1,3-6r1,4-5r2,6-5r1,8-6u3,3-9u1,4-8u1,5-7u1,2-7r1,3-6r1,4-5r3,4-8u1,5-7u1,3-6r1,4-5r2,6-6l1,4-5d1,5-7l1,3-6d1,4-8l1,9-2l1,8-6u1l2,5-4d1,6-6l1,6-2r1,9-2l1,8-3d1,9-5l3,6-2r1,8-1d1,2-7d1,5-4d1,4-5d1,6-6l1,5-7l1,8-2d2,9-5l2,6-6u2,2-7r1,3-6r1,4-8u1,5-7u1,3-6r1,4-5r1,5-7u1,6-6u1,4-5r1,2-10u1,1-8r1,3-9u1,2-7r1,4-8u2

;6
   ####
 ###  ##
##     ##
# ****+ #
#    $  #
##### # #
    #   #
    #####
Solution: 4-2d1r1d1,2-2d1r1,7-3l1,3-4r2u1l1,1-4r1,2-4r1,4-3l1,5-1d1,6-3l1,1-3r1,5-4l2,5-6u1,5-5u1,4-4u1r1,4-1d1,7-4l1,5-5u1,3-4u1,1-4r4u1l1,5-1d1,4-3l1,7-4l2u1,5-1d3,1-3r1,2-2r2,4-3l1,7-3l1,6-2l1,4-1d1,3-4r2u1l1,5-1d1,6-3l1,5-6u2,4-4u1r1,4-1d1,7-4l1,5-5u1

;7
 ####
 #  ###
 #    #
 # ** #
 # * ##
##$@ #
#  .*#
#  # #
##   #
 #####
Solution: 4-4u1l1d1,2-4u1,4-5d1,2-6u1,3-4d1,4-8u3,2-3d1,2-4d1,2-1d2,5-2l1,4-5u2,3-1d2,5-2l1,3-1d1,2-5u2r1,5-3l1,2-3r1d1,5-3l1,3-2d1,2-7u1r1,4-7u4,2-4d1,1-6r1,2-1d1,2-2d1,5-2l1,2-6r1,4-7u4,2-3d1,2-4d1,1-6r1,2-5r1,4-4d1,3-1d1,5-2l1,2-3r1,3-1d1

;8
 #######
## .   #
# $+$  #
# #*# ##
#  $  #
## . ##
 #   #
 #####
Solution: 2-4r1u2r1,6-2l1,5-4l1,1-2r1,2-1r1d1,5-1l1,3-2r1,2-4r1,3-2d2,6-2l1,5-4l1,2-5r1u1,3-2r1,6-2l1,2-1r2,5-2l1,4-6u1,4-2l1d2,4-5l1,1-2r1,5-4l2,1-4r1,2-2r1,3-3d1,2-6u1,1-4r1,6-1l2,3-2r1,5-1d1,4-5l1u2,2-2r2,2-6u1,1-4r1,3-3d1,6-2l3,1-2r1,2-1r1d1,5-1l1,5-4u1,6-2l2

;9
##### ####
#   ###  #
# $ #....##
##$@$   $ #
 #   ##   #
 ##  ######
  ####
Solution: r2,8-4u1,5-3r2,1-2r1,3-1d2,3-5u1,2-4u1r3,1-2r1,3-1d2,2-4r1,7-3l4,2-4u1,9-3l6,8-1d1,9-3l1,7-4u1,8-2l2,4-5u1,3-3r3,7-4u1,8-2l1,1-2r1,3-1d2,3-5u1,2-4u1r5,9-3l1,7-4u1,1-2r1,3-1d1,2-3r5,8-4u1

;10
  ####
  #@ #
###  ##
# $$* #
# #  *###
# . *   #
###  .  #
  #######
Solution: r1d2r1d2l1d1r1l1u1r1u2l1d1l1u1r2d3l2u1l2u2r2d1r2d2l1u1l1u2l2d2r2d1r2u3l2d1r1u1r1d1l2r1l1d2r2u1d1l2r1l1r1u1l1u2r2d1u1d1u1l2d3r2u1r2d1l2u1l2u2r2d1u1l2d2r2l2u2r1u2l1d2r2d2l4u2r2l2d2r2u1d1r2u1d1l2u1r1u1l1u2r1d2l1d2l2u2r1l1d2r2u2r1u2l1d2l2d2r3l1u2d2r2d1r2u1l4d1r1l1r2l2u3l2d2r2u2r1u2l1d2l2d2r2d1r2u1l1u2l3d2r2d1r1u1l3u2r3l1d1u1l2d2r2d1r2u1r2d1l1u1l3u2r1d1l1u3r1d1

;11
    #####
   ## @ ##
 ###  #  ###
 #   ###   #
 #$   #    #
 # ####### #
## . ###   #
#.$ * #  ###
#  .  #  ##
###  ###  #
 #  ##### ##
 #      $  #
 ##  ###   #
  ##########
Solution: 9-11l5,3-12u3,5-7l1,2-6d1r1d3,5-7l1,3-8u1,1-8r2,2-11r6,10-11l1,2-3d4,7-11r1,9-12u1,5-8l1,3-7d3,2-11r1,1-8r1,3-9u1,4-7l2,3-11r5,10-11l6,3-12u4,2-7r1,9-9d1,10-11l6,3-12u3

;12
  #####
  #   #
 ## #.###
## * $  #
#  $ *# #
# #.# # #
# #   # #
#  ###  #
##  @  ##
 #######
Solution: r1,6-3l1d1l2u1d1r2u1l1,5-6u1,1-4r2,5-5u1,3-4r1u1r1d1,2-3r1,3-1d2r1d1r1u1,2-4r1,7-3l3,5-4l2,5-6u1,1-4r1u1r1d1,5-3l1

;13
  ####
###  #
#@*  ##
# **$ #
## .  #
#  # ##
#     #
###   #
  #####
Solution: r2,2-2d3,1-6r2,3-2d1,5-6l1,5-3l2,4-1d3,1-3r1,2-6r1,2-4r1u1,4-2l1,5-4l1,5-6l1u3,2-6r1,4-7u3,5-3l2,2-4r1,4-3d1,4-1d1,5-3l1,3-4u1,4-6u1,5-4l1,3-1d1

