;1
     #######
     #     #
 #####  #  #
##      #$ #
# $ ## $  ##
#   ###$*.#
###$# #  .#
  #@# ##$.###
  ###  # .*.#
       ##.###
        ###
Solution: u3d1l2u1r1u1r4u2r3d7r1l1u7l3d3r1u1l1u2r3d5l2u1d1r2u1d1l2u1r1d1r1u3d5l1u1r1u4r1u2l1d6l1d1r1u3l2,8-7u1,7-3d1r1,9-3d4,7-6u1,6-4r2,9-3d3,7-1d2l1d1r2,9-3d2,3-5u1l1u1r4u1r1d1l1d1r2,9-3d1

;2
     ########
     #      #
 #####  #$$ #
##      # ###
# $ ## $  #
#   ###$# #
###$# #  .#
  #@# ##$.###
  ###  # .*.#
       #...##
       #####
Solution: u2l1r1u1d1l2u1r1u1r4u2r3d7r1l2d1r1,6-4r2,9-3d5,8-6d2,7-2d1l1d1r2,9-3d4l1d1r1,7-6u2,7-2d1l1d1r2,9-3d4,3-5u1l1u1r4u1r1d1l1d1r2,9-3d3,11-2l1u1l1d4

;3
  #######
  #     #
###  #  #
#@$  #$ #
### $  ##
  ##$# ##
   #  . #
   ##$.*#
    # ..#
    ###.#
      ###
Solution: r2u2r3d5r1d2u1,6-8u5,3-4r2,6-3d3,4-6u1,5-8u1r1u1r1d1,6-1d6,3-4r2,6-3d3,4-6r1d1r1,6-5d1,4-2d1l1d1r2,6-3d2

;4
  #####
 ##   ##
 #    .#
##$##$.##
#@$   . #
# $$ *.$#
#  ###..#
#### ####
Solution: r4u1r1u1l1d1r1d2u1r1d1u1l3,4-5r1,2-6u1l1u1r3d1r1u1,4-5l1,7-5l3,5-2d1r1d2l2u1r1d1r1u1l1u3d3l4d2r1u1l1u1r4l3d1r3u4l2d1r2l3d2l1d1r3

;5
         ###
         #.#
######## # #
#.  *  # # #
##$##  ###$#
#   . $ #  #
#  #*  .# ##
## # .# # #
 #$ $ #   #
 #@ #######
 ####
Solution: undefined

;6
     ####
   ###  #
   #@$  #
 ###### ##
##.#.##  #
#..*.    #
##$ *$####
#  $# $ ##
#        #
###  #   #
  ########
Solution: r2u1r1d3r1d1l3d1l1u1l2d2l1d1r5l4u2r1l1d2r1u1d1r3d1r2u1l5u1l1u2r3d2u2l3d2r1u1d2r2u3l2d1l1u1d1r1u1r2d1l1r1d2l2u2l1u1r1d3u2l1d1l1d1r1u2r3d2l1d1l1u2d1r2u2l2d1l1u1d1r1d1r3d1r2u1l4d1l1u3d2r4u1l1d1l3u2r2d1r1d1l2d1l1u2l1u1r1

;7
    ###
    #.###
 ####*  #
## $....###
#@$ *#*   ###
### .  $#$$ ##
  ### $      #
    ###  #   #
      ########
Solution: r1u1r2d1u1l2d1r1d1r2d1r4l2u1l2r1u2l1u1d1r2u1l1d2u1r1d1l1d2r4d1r2u1l5u2r2d1u1l2d2r2l2u1l1u3r1d1l1d2r1d1r2u2l2d1l1u1r1u1l1r1d2l2d1r1u2r3d2l1d1l1u3r2d2r1d1r2u1l4d1l1u2d1r2u2l2d1l1u1r3d2r2u1l1d1l3u2r2d1r1d1l2d1l1u2d1r2u2l2

;8
     ####
   ###  #
   #@$  #
  ##### ##
### .##  #
#.....   #
##$ * ####
# $ #$$ ##
#   $    #
###  #   #
  ########
Solution: r2u1r1d3r1d1l3d1u1l3r1d3r2u2l1u1l1r1d1r1d2l4u1d1r2u2d2l2u1r1d1r3u2l2d1l1r1l1d1r1u2r1u2l1d1l1d2r1u1l1u1r1d1r1u1d1r1d2l1d1l1u3l1u1r1d2l2d1r1u2r3d2l1d1l1u2d1r2u2l2d1l1u1d1r1d1r3d1r2u1l4d1l1u3d2r4u1l1d1l3u2r2d1r1d1l2d1l1u2l1u1r1

;9
  ####
  #  #
 ##  #
 #   #
 # $##
 #  #
 #.$####
##.* $ #
#.*..# #
##@$#  #
 #$   ##
 #  # #
 ##   #
  #####
Solution: u4d3r1d2r2d2l2u1l1u2r1u1l1d2r1l1u5r1u2l1d6u1r2u1l1u1d1u2d3l1u1r1u2l1u2r1d4l1d1r1d3l1u2d2r1d1r2u3r1u2l3u4r1u2l1d8l1d2r1u3d4r2u2l1r1d2l2u3

;10
######
#.. .#
#.$$.#
#$ $ #
#  $*#
#  $+#
######
Solution: l1r1u2l1u1d1r1d2l1u1l2u2r1u1r1l1d1l1d3r2u1l2u2r1d1l1d2r2u1r1u1l1d2l2u1d1r2u2l1r1d2l2u2r1u2r1d2l2d2r1u1r1l1u2

;11
   #####
   #.$+###
   ## $#.#
    ##.#$####
###### $   .#
#  ##  $ ####
# $##* $##
#   .   #
#####.###
    ###
Solution: l1r1d3r4l2u1d1l2d1l1d2r1u5d2r2d1l1u1l1d1l1d2r1u3d3r1u1l1u2r2d1l1u1l1d1r1d1l1d1l5u2r1d1l1d1r2

;12
  ###    ###
  #.# ####.#
### ###.##.####
#@$ # $$     .#
## $ . . $ ####
 #### #$$###
    #    #
    ######
Solution: r1d1r1u2d2r2d2r3u2l1u1r5l4d3l3u2r2u1r1d1u1r2d1l1u1l2d1l2u1r4d1r1u2d1l5d3r2u2l1u1r3d1r1u1d1l4r1d2r1u1l1u2r2d1l1

;13
     ####
######  ###
#    #    #
#   *  $# #
# ##*.*.  #
# $  .  ###
#######$#
      #@#
      ###
Solution: u2l2u2l2r2d2r1l1r1u1r1u1d1l2u1l1u1l3d3r4u1r2u1l2r1u2r1d1r2d2l2r2u2l3d1l1r1u1r3d2l2u1d1r2u2l2d1l2d1r2l2d1l4u3r2d1r2l1u1l3d1r2l2d2r4u1r2d1l3r1u2l2r2d2r2u3r2d2l2d1l2u2r1l1d2r2u1l1r3u2l2d1u2l1d2l3u1l2d1r2l2d2r3

;14
     ####
######  ###
#    #  $@#
# $ .$  # #
# ##..**  #
# $  .* ###
##$ ##.  #
 #  ##   #
 #########
Solution: undefined

;15
    ####
 ####  #
##@##  ##
# $*.*  ###
#  ** $   #
###..$    #
  #########
Solution: d1r1d1r1d1r3l1u1d1l2r1l1u1r1d1r2u1r2d1l4u1r2l4u1l2d1r4u1l1r1d2r2u2l2r2d1l3r2u3l1d1r1d3r3u1l4

;16
 #######
##.  $@#
#.*$$###
##*.  ###
 #.$ $  #
 #.$    #
 #.######
 ###
Solution: l3r1l1d1l1d1r1l1d2r1u1r2l2r2d1l2u1l1u2r1d1l1d1r1d1r2u2l2d1l1u1r1u2r1d1l1d3r2u2l2r2d2l1u1r1u1l1d2r3u1l4

;17
#####  ###
#   ####.####
#  $ $ $* $@#
#     ...* ##
############
Solution: l1d1l2u1d1l4u1l1r1d1l1r3u1l1d1r3u1l1d1r3u1l1d1l6u2l2d2r7l5r2u1l1d1r3u1l2d1l4u2r1d1l1d1r6l5u2r1d1l1d1r4u1l2d1l2u2r1d1l1d1r3

;18
      ###
#######.##
#   ##.*.####
#  $ $$$* $@#
#     ...$ ##
############
Solution: l1d1l2u1d1l2u1d1l2u1l1r1d1l1r3u1l1d1r3u1l1d1r3u1l1d1l6u2l2d2r6u2d2l2u1r1d1r1u1l3d1l3u2r1d1l1d1r5l4u2r1d1l1d1r3

;19
#########
#+$   ..#
#$$$$  $#
#.#.* . #
#########
Solution: d1u1r2d1r1l1u1r1l3d1r1u1r2d1r1d1r2u1l1u1l4r2d1u1r2d2l1u1l1u1l2d1r3d1r2u1l1u1l2d1r1u1r1d1l4u1r3

;20
#########
#+$   .##
#$$$$$  #
#.#.. . #
#########
Solution: d1u1r2d1u1r1d1r1l1u1l3d1r1u1r2d1r1d1r2u1l1u1l4r2d1u1r2d2l1u1l1u1l2d1r3d1r2u1l1u1l2d1r1u1r1d1l4u1r3

;21
#########
#+$   ..#
# $$$  $#
# *.* . #
#########
Solution: r2d1r2d1r2u1d1l2u1l2u1r1l3d1r1u1r2d1r1d1r2u1l1u1l4r4d2l1u1l1u1l2d1r3d1r2u1l1u1l2d1r1u1r1d1l4u1r3

;22
#########
#+$   ..#
#$$ $  $#
#.*#* . #
#########
Solution: d1u1r2d1r2d1r2u1d1l2u1l2u1r1l3d1r1u1r2d1r1d1r2u1l1u1l4r4d2l1u1l1u1l2d1r3d1r2u1l1u1l2d1r1u1r1d1l4u1r3

;23
#########
#     *+#
#  $$$$$#
#**.. ..#
#########
Solution: d1u1l2d1u1l2r4d1l1d1u2l3d1l2u1r5d2l1u1r1u1l3d1r2u1r1d1l5u1r4

;24
#########
#+$   .##
# $$$   #
# *.* . #
#########
Solution: r2d1r2u1r1l1d1l2u1r1l3d1r1u1r2d1r1d1r2u1l1u1l4r2,5-3u1l1u1l2d1r3d1r2u1l1u1l2d1r1u1r1d1l4u1r3

;25
#########
#+$   .##
# $$$$  #
# #.. . #
#########
Solution: r2d1u1r1d1r1l1u1l3d1r1u1r2d1r1d1r2u1l1u1l4r4d2l1u1l1u1l2d1r3d1r2u1l1u1l2d1r1u1r1d1l4u1r3

;26
#########
#+$   .##
#$$ $   #
#.*#* . #
#########
Solution: d1u1r2d1u1r1l1d1r1l1u1l2d1r1u1r2d1r1d1r2u1l1u1l4r4d2l1u1l1u1l2d1r3d1r2u1l1u1l2d1r1u1r1d1l4u1r3

;27
#########
#.    ..#
#.$$$$$$#
# *.. *@#
#########
Solution: u1d1l2u1d1r2u1l1u1l4r1d1l1u1r4d2l1u1l1u1l2d1r3d1r2u1l1u1l2d1r1u1r1d1l4u1r3

;28
#########
#+$   ..#
# $ $  $#
# *#* . #
#########
Solution: r2d1r2d1r2u1d1l2u2d1l2u1r1l3d1r1u1r2d1r1d1r2u1l1u1l4r4d2l1u1l1u1l2d1r3d1r2u1l1u1l2d1r1u1r1d1l4u1r3

;29
#########
#+$   ..#
##$$$$ $#
#*.#. . #
#########
Solution: r1d1u1r2d1r1d1r2u1l1u1l4r4d2l1u1l1u1l2d1r3d1r2u1l1u1l2d1r1u1r1d1l4u1r3

;30
#########
#    .$+#
#  $$$$$#
##*.. ..#
#########
Solution: d1u1l4d1l2u1d1r2u1r3l1d1u1r2d1l1d1l1r1u2l3d1l2u1r5d2l1u1r1u1l3d1r2u1r1d1l5u1r3

;31
#########
#     *+#
#   $$$$#
#**#. ..#
#########
Solution: d1u1l2d1u1r2d1l1d1l1r1u2l3d1l2u1r5d2l1u1r1u1l3d1r2u1r1d1l5u1r4

;32
#########
#     *+#
#  $$$$ #
#**.. .##
#########
Solution: l4d1u1r2d1u1r2d1l1u1l3d1l2u1r5d2l1u1r1u1l3d1r2u1r1d1l5u1r4

;33
#########
#+$    .#
#$$$$$$ #
#..#. ..#
#########
Solution: d1u1r1d1u1r2d1l1u1r3d1l1d1r1u2l3d1r1u1l3d1r2u1r3d2l1u1r1u1l4d1r3u1r1d1

;34
#########
#+$   .##
# $ $   #
# *#* . #
#########
Solution: r2d1r2u1r1l1d1l2u1r1l3d1r1u1r2d1r1d1r2u1l1u1l4r4d2l1u1l1u1l2d1r3d1r2u1l1u1l2d1r1u1r1d1l4u1r3

;35
#########
#.    .##
#.$$$$$ #
# *.. *@#
#########
Solution: l2u1d1r2u1l1u1l4r1d1l1r1u1r3d2l1u1l1u1l2d1r3d1r2u1l1u1l2d1r1u1r1d1l4u1r3

;36
#########
#+$   ..#
#$$$$$$ #
#..*.  .#
#########
Solution: d1u1r1d1u1r2d1l1u1r3d1l1d1r1u2l3d1r1u1l3d1r2u1r3d2l1u1r1u1l4d1r3d1r1u1

;37
#########
#+$   ..#
## $$$ $#
#* #. . #
#########
Solution: r3d1r1d1r2u1l1u1l4r2d1u1r2d2l1u1l1u1l2d1r3d1r2u1l1u1l2d1r1u1r1d1l4u1r3

;38
#########
#+$   .##
#*$$$$  #
#*.#. . #
#########
Solution: r1d1u1r2d1r1d1r2u1l1u1l4r4d2l1u1l1u1l2d1r3d1r2u1l1u1l2d1r1u1r1d1l4u1r3

;39
#########
#   . $+#
#  $$$$$#
##*.. ..#
#########
Solution: d1u1l4d1u1r2d1u1r2d1l1d1l1r1u2l3d1l2u1r5d2l1u1r1u1l3d1l2u1r2d1r2u1r1d1

;40
#########
#@$    .#
#$$$$ $$#
#.... ..#
#########
Solution: d1u1r2d1u1l2d1r1d1r3u2r2d1u1l4d1u1r2d2l2r2u2r2d1l1u1l3r1d1u1r2d1l2u1l1d1l2u1r5

;41
#########
#     ..#
#$$$$ # #
#..#+$  #
#########
Solution: r1u2l3d1u1l1d1u1r4d2l1u1r1u1r2d2l2u1l2u1r2l4d1r2u1r2d2r2u2l4d1r1u1r3d2l2u1l1u1r2l1d1l4u1r4

;42
#########
#    .$+#
#   $$$$#
##*#. ..#
#########
Solution: d1u1l2d1u1r2d1l1d1l1r1u2l3d1l2u1r5d2l1u1r1u1l3d1l2r4u1r1d1l5u1r3

;43
#########
#    .$+#
#  $$$$ #
##*.. .##
#########
Solution: l2d1u1r2d1l1d1l1r1u2l3d1l2u1r5d2l1u1r1u1l3d1r2u1r1d1l5u1r3

;44
     ###
######+#
#     $######
#   #       #
##### ###   #
    #  ######
    #  #
    #  #
    ####
Solution: d1l1d1r4d1r2u1l5u1l1d3r1d2l1u4r1u1l3d1l2u1r4d1r1u1

;45
     ####
######.@#
#      $#####
#   #       #
##### ###   #
    #  ######
    #  #
    #  #
    ####
Solution: d1l1d1r3d1r2u1l5u1l1d3r1d2l1u4r1u1l3d1l2u1r4d1r1u1

;46
     #####
######.#@#
#       $####
#   #       #
##### ###   #
    #  ######
    #  #
    #  #
    ####
Solution: d1l1d1r2d1r2u1l5u1l1d3r1d2l1u4r1u1l3d1l2u1r4d1r1u1

;47
  ########
###      ###
#@$  #$$ $ #
### $  ##  ##
  ### ..##  #
    ##*...  #
    ## .    #
    #  # ####
    # $  #
    #    #
    ######
Solution: r2u1r3d2l1d1r1d2r2d3l3u1r2d1r1u3l2d1l1d1u1r1u1r3u1l1d1l2d1l1d1r2d1r1u2d1l2u2r3l3u5r2d1l1u1l1d6u1r3u1r1u3l2u1l2d6l1d1u1r1u2r3l3d2l1d1r2d1r1u3r1u1l1d1l2u5r2d1l1u1l1d6l1d1r2d1r1u3l2u4r3d1r1d1r1d1l1r1d1l3r3u2l1u1l1u1l3u1l3d2r2l2u2r3d3u1l3u2r1d1l1d1r2l1u2r2d2

;48
######
#    #####
# #      ###
#   ##   $@#
## ..##  ###
 ##.#.#$ #
  # #  $ #
  # # #  #
  #  $####
  #   #
  #####
Solution: l2u1l5d7r2u3d2l2u6r5d2l1u1r1u1l4u1l1d2l1d1r1u2r5d4l1u3r1u1l4u1l3d2r2d5r2u2r1l1d2l2u5l2u2r2d3,7-7u4r1u1l4u1l1d2

;49
  ######
  #    #
  # $# #
  # $  #
####$# #
# $ .. #
# **.  #
#  .$###
##*.$@#
 #.####
 ###
Solution: l1u1l2d1u1r2d1l1u1l2u2r3d1u1l1r1l2d1u1r2d1l1d2u2r3u5l3d2r1d2l1d1r1l1d2r1u1l1u2l2d2r1l1u2r2d2u2,6-5l3,4-7u1l1u1r1,6-6l2u1l1,6-5l1d1l1u1,1-5r3l1d1,4-3d2,5-6l1,4-1d4,6-3l1,4-2d2

;50
          ####
 ####     #  #
##  ##    #  ##
#  $ ##   #.$ ###
# # $@#  ##$ *  #
#    #####.$ .$ #
###  #     #  .##
 #      ########
 # #  #.   #
 #     ##  #
 ##    .## #
  ######   #
      #. $ #
      ######
Solution: l1u1l1d3r1d3l2u2r1,4-6d3l1d1r3,10-12l2,1-3r1u1r1d4,2-7r1,2-7r4u1r1d1u1r3u1r2u2d3r2u1d1l2u3l1d1r1d1l1r1d1r2u1l1d1l1u1l1u2r2d2l1d1r1u3d2r2u1l1d1l3u2r2d1l1d1r1l1u2l1u2r1d2r1d2l2u1d1r2u1r2l2d1l2u2r2d1r2d1l1u1l1u1l2d1r1u3l1d1

;51
###########
# # ## @  #
#  ## #*$ #
##  ### ###
# #  # .###
# $  #   ##
# $  ## ###
#  ##     #
# *. $  # #
#   .#.   #
###########
Solution: d7u1r2d2l2u8r2d1l1u1l1d6r2d2l2u6,6-8l2d1l3u2r1d1r4,7-9u4,1-9r2,1-5r1d2l1d1r1,3-4d1r1d1l1u1l1d2

;52
#####
#   ##
# $ .#
### .####
# $ *   #
#...*   #
###.* $ #
  # $ ###
  #$#$#
  #@  #
  #####
Solution: u4r1u2d2r1l2d4r2u3d3l2u2r1l1u2r1d1r1d1u1l1u3d1r3d2l2u1l1u1r1d1l2d4r2u3d3l2u2r1l1u2r1d1r1l1u3l1d1r1d2r3u2l2r2d2l3u2d2l1d3r2u2d2l2u3r2l2d1r1u1r1d1l1u3l1d1r1u1r3d2l2r2u2l1d1u1l2d1r1l4u1r2d1r2d2l1u1r1u1l3r2d2l1u1r1u1l1u4l2d1r1u1r1d4r1d2l1u1r2u2r2d2l3r3u2l1d1r1d1l2d1l2d2r2u3r1u1l1

;53
#########
#.# *..##
#  .# .##
# $ # *##
#$$$$$ .#
#@$   . #
#########
Solution: r4u3d2r1u2l1d3l2u2d2l2u3d3r2u1r1d1r1u1r2d1l2u1l2d1l2u1r5u2l1d1r1d1l3d1l2u1r4d1r1u2d1l5u2r1d1l1d1r4d1r1u1l3d1r2

;54
#########
#.# #. ##
#  .# .##
# $ # .##
#$$$$$ .#
#@$   . #
#########
Solution: u3d3r2u2d2r2u3d3l2u1r1d1r1u1r2d1l2u1l2d1l2u1r5u2l1d1r1d1l3d1l2u1r4d1r1u2d1l5u2r1d1l1d1r4d1r1u1l3d1r2

;55
#########
#.#### ##
#   #*.##
#$$ # .##
#  $$$ .#
#     *+#
#########
Solution: l4u1l2u2d2r2d1r3u2l1,1-5r5u2l1d1r1d1l3u1r3l5u2r1d1l1d1r4d1r1u2d1l4u2r1d1l1d1r3d1r1u1l5d1r4

;56
#########
#.#@## ##
# $*# .##
# $ # .##
# $ $$ .#
#     . #
#########
Solution: d3l1d1l1u3r1l1d3r4u1r2d1l4u1r3u2l1d1r1d2l2u1r1d1r1u2d1l5u2r1d1l1d1r4d1r1u1l5d1r4

;57
#########
#.## # ##
# $.# .##
#  #  .##
#$$$$$ .#
#@$.  . #
#########
Solution: u3r1l1d3r4u1d1l3u1d1r3u1r1u2l1d1l1d1l1r3l3d1l2u1r3u1r2d1l1d1l2u1r1d1r1u1l1u1r1d1r1u1d1l5u2r1d1l1d1r3d1r1u1l1u1r1d1l4d1r1

;58
#########
#.## # ##
# $.# .##
# $## .##
# $ $$ .#
#@$   . #
#########
Solution: r2u1l1d1l1u3r1l1d3r4u1r2d1l4u1r3u2l1d1r1d2l2u1r1d1r1u2d1l5u2r1d1l1d1r4d1r1u1l5d1r4

;59
#########
#*#@**.##
##**# .##
#   # *##
# $ $$ .#
# $   . #
#########
Solution: d2l2d2r4u1r1u2d2l1d1l2u2d2r2u1r2d1l4u1r3u2l1d1r1d2l2u1r1d1r1u2d1l3u1l2d1r4d1r1u1l5d1r4

;60
#########
#.#### ##
#  #. .##
# $@# .##
# $$$$  #
#     . #
#########
Solution: d1l1d1l1u3d3r4u2r1u1l1d2r2d1l4u1r2d1r1u2d1l5u2r1d1l1d1r4d1r1u1l5d1r4

;61
#########
#.#### ##
#   #*.##
#$* # .##
#  $$$ *#
#     *+#
#########
Solution: l4u1l2u2d2r2d1r1l1u1l2d1r5u2l1d1r1d1l3u1r2d1r1u2d1l5u2r2d1u1l2d2r4d1r1u1l5d1r4

;62
#########
#.#### ##
#  ##*.##
#$$ # .##
#   $$ *#
#     *+#
#########
Solution: l4u1l2u2d3r5u2l1d1r1d1l3u1r2d1r1u2d1l5u2r1d1l1d1r4d1r1u1l5d1r4

