;1
######
#*.*.#    ######
#..$.#######   #
##$$         $ #
 #  $#  $$$.$@##
 ##..####.  .#
  #. ##########
  #.* $ $ $ $ #
  #.          #
  #############
Solution: l1u1l3d1u1r2d1u1l2d1r1d1r1l1u2l6d1u2l2r2d2l2u2d1r1d1r1u2d1r8u1r2d1l10d1l2u1r1d1r1u1r5d1r1d1r1u1r1u1l5d1r3u1l7d1l1u1r1d2u1r1d1l1d3r2u1l1d1l1u2d1r1u1d2r3u1l2d1r4u1l3d1r5u1l3d1r5u1l3d1l7u2r1d1l1d1r3u1l2d1l1u1d1r5u1l4d1r6u1l5r7d1l8

;2
        ###########
      ###         #
      #   $##$#$$ #
      # $$@  $    #
      ### $ $  $# #
#######.#    $    #
#... .  ##$$ $# ###
##.....         #
 ##.... #########
 ########
Solution: r1d3r1d1l5d1l1u1l1u1r1d1r1u1d1r4u2l1d1r1d1l8,10-3d3r1d1l7,14-5l3u1l1d2r1d1l6d1l1u1r1u1l3,13-5d1,14-7l9d1l1u1r1u1l2r1,12-3d3r1d1l8d1l1u1r1u1l1,14-3l1,10-1d5r1d1l6u1l1d1r1d1l1,13-1d5,15-7l10,15-3d1,16-5l3u1l1d2,13-7l7d1l1u1,13-3l2,10-2d4r1d1l5,9-2d1,7-3r2u1r1d4r1d1l4u1l1d1r1d1l2,9-5u1r1u2l2d1r1u1r1d4r1d1l4u1l1d1r1d1l1,15-1d3,16-1r1l1d1,17-3l6,16-5l3u1l1d2r1d1l6u1l1d1r4u2l1u3r1d4r1d1l4

;3
     ######
     #.   #
  ####.$$ #
  #..$.. ##
  #@##.# #
 ####### #
##       #
#  $ #$$ #
#  $## # #
##       ##
 #######  #
   # $ .  #
   #     ##
   #######
Solution: u1r3u2r2d2l1r1u2l2d2u2r1d1r1d1l4r4d3,8-8u5,9-2l2u1l1d1r1d1l2,6-8u1r1,8-8u5,9-2l1u1l1,5-6r2,8-7u4,7-1d1,9-2l1d1l1u1r1u1l1,4-11r2,4-7u1d1l1,3-9u2,1-7r1u1r5d1r1u4l1u2r2d1l2,3-8u1l1u1r5d1r1u4l1u2r2d1l1u1l1d1

;4
    ####
#####  #
#      ##
# ..#.* #
##$ $$  #
 #  #  @#
 ########
Solution: l1u2l1u2r1d2r1d2l2u1d1r2u2l1u1l3d3l1u1r1u2l2d1r1u1r4d1r1d2l1u1l3d1l1u1

;5
 ####
##  ###########
#@$           #
# **********. #
#             #
###############
Solution: r10,10-4u1r1,8-4u1r1,6-4u1r1,4-4u1r1,2-4u1r1,2-1d1,5-2l2,7-2l2,9-2l2,11-2l2,13-2l2,9-3r1,7-3r2,5-3r2,3-3r2,1-3r2,2-1d1,5-2l2,7-2l2,9-2l2,11-2l2,7-3r1,5-3r2,3-3r2,1-3r2,2-1d1,5-2l2,7-2l2,9-2l2,5-3r1,3-3r2,1-3r2,2-1d1,5-2l2,7-2l2,3-3r1,1-3r2,2-1d1,5-2l1,3-1d1

;6
###########
#        ##
# *****   #
#     *$$@#
#*.****   #
#*.*******#
###*****###
  #****##
  ######
Solution: 2-1d3,7-4u1l4,2-2d1,4-1d1l1,6-1d1l2,8-2l3,8-4u1r1u1l2,5-3r1,3-3r2,7-2l1,7-4u1r1u1l1

;7
  #######
  #     #
### *** #
# $ *+* #
#   *** #
###     #
  #  ####
  ####
Solution: l1d1l1d2r1u1r3u4l4d3l2u1r3l1u2r4d4l3d1l1u2l1u1r1

;8
#################
##             ##
# # $  $  $ $*# #
#   *.***.*** * #
# $ $ .@.$ .    #
# $  * *..$.  * #
# # ** ** * *.# #
##             ##
#################
Solution: 9-5r3u1r1d1,11-2d2,13-1d2l1,11-2d1,13-5u2,12-1d1,9-2r1u1r1d1,9-3d1,8-2d2,6-2r2u1r1d1,3-2r4u1r1d1,3-4r4,3-3r1,4-7u3,6-6l1,5-4d1,1-4r4,1-5r3

;9
#####
# ..#####
#  .. @ ######
# $ $$$.. ...###
#####   $$$    #
    #####   $$ #
        #####  #
            ####
Solution: 5-4u1,6-2l3,3-3r1,1-3r1u1l1u1r1d2r1u1r4d2l1u1r1u1l4d1l1u1r4d2l1u1r1u1l3d1r1u1r2d2l1u1r1u1l1d1l4u1r1d1r9d2l2u1d1r2u2l4d1r1u1r3d2l2u1d1r2u2l2d1l4u1r1d1r3d1r1u1r4d2l1u1r1u1l1d1l1u1l2d1r2u1r2d2l1u1r1u1l2d1l1u1

;10
 ######
 #    #
##$$  #######
# .#$.#.....#
# *$  # $$$ #
# $.$.  $@$ #
#     # $$$ #
#######.....#
      #######
Solution: r1d1r1u2d1l3u1l1d2u1r1d1u1r1d1u2d1r1u1d2l2u1l3d1l2u1r4d1r1u1r1u1l1d1l1u1d1,1-5r9u1r1d2,2-3d1r2u1r1d1l4d1r1u1r3u3l3d2u2r2d1l1u1l1d1r3d2l1u1r1u2l2d1r1u1r1d1

;11
#######
#+.   ######
# $ $$  #.#
####      #
#..*  ##  #
#$# $*#####
#     #
#######
Solution: r1l1d1r1u1r2d1r1d2l1u2r1u1l3d1r1u1r2d2l1u1r1u1l2r1d2r3u1l1d1l2u2r1d1l1d1r4d1r1u1l5d1l1d2l2u1d1r4u1l1d1l1u1r1u2r1d1

;12
 #######  ####
##  .  #  #  #
# $$ .$####$ ##
#@    . $ #   #
#### $$.*   $ #
   ###  ....###
    #########
Solution: r2u1d1l2u1r1u1r1l1d2r5d2r4u2r2d1l2r1u2d2l1d1l2u2l4r4d2r2u1l1r2u3l1d3l1d1l3u2r1d1l1d1r2l1u2r1d1l2u1l2u1l2r2u1r1d1l1d1r2d2l1u2l1u1l2d1r1d1r2u1r1d1l1d1r1u1l3u2r1d1l1d1r1u1r2d1r2u1l4d1r2l2u3r1d2l1d1r1u2l3d1r2l4u1r3

;13
###############
##  #    #### #
#  ...$$$#    #
# $.$..$ $.$$ #
#  $ $.....$ ##
##           #
 ##@##########
  ###
Solution: u3d1l2u1r1d1r2u1d2r2u1l1u3r1d2l1d2l2u1r1d1r1u2r1u2r2d2l2r2u1l1u1l1d1r1d3r2u1l1d1r4u1d1l2u2l1d1l1u1l1u2r1d2r1d2r3u1l2u2r3l2d1u1r2d1l2r1d1l1

;14
######################
#.   .              *#
## $.$.$.$.$.$.$*$.$ #
 #@.$.$.$.$$.$$..$$$ #
 #.** *             .#
 #     #############.#
 #######          ####
Solution: r1u1r1u1l2r4d1l1d1l2u1l1d1r3u2r3d1l1d1l3r2u1r1u1l1r4d1l3r2d1l3r2u2r4d1l3d2r1u1d1r2u1l4r3d1r2l1u3r2d1l1u1l2d3r3u1l4r1d1r7u1l5u2r2d1u1r2d1u1r2l6d3r5u1l1r2l2u2r2d2u1r1d2u1l2d1r1

;15
###
#.###
#  .######
# $  $   #
#$$$.. $$#
#  ...$ .#
### $$ .##
#+. $  ##
#######
Solution: r2u2r2u1r1u1r2d1l1d2l1d1l4r1u2r2d1r1d1l3r3u1r1u1l1d2l3u1r3l3u1l2u3d3r2u2d2l2u1r1l1u2r1d1r1d1r1d2r2u1l1r2u2l1d1r1d1l1u2l1d1l2u1l2d1r4u1l1r3d1l1u1l3d1l2u2r1d1l1d1r2

;16
  ###     ####
###.#######  ##
# *. .$.$.$$  #
# .* .$ . .   #
# $#########$.#
#  #       #  #
# $####### # .#
# $ $ @$ # ####
#        #
##########
Solution: 2-3r1,5-3r7u1r1d3l1r1u2l8u1l2d1l2u1r1d1r1u1r2d1l1r3u1l1d1r3u1l1d1r4u1,3-7r1,1-7r1,2-5d1,2-3d1,4-3l1,12-5u1r1u1l9,11-1d1l1d1r2u1r1d1,2-4u1l1u1r1l1d1r8,2-6u3,2-8u4l1u1r6,4-7l1d1l1u4l1u1r3,6-7l3d1l1u4l1u1r1,8-7l5d1l1u4

;17
     ####
######  ###
##     $+ #
# .#$.$ . #
# $$  $ ###
##.#* ###
# .   #
#    ##
######
Solution: d1l2u1l4d3u1r2d1r1d1l1u3r3l1u1r1l1d1l2d1l2u2r3l1d5l2u3d3r2u1l1d1l1u1r2u3r3u2l1d1r1d1l2u1l1d3r1d1l2r2u2l1u2r2d1r1d1l2r1u2l2d2

;18
##########
#        #
# .$$$.$$#
# ##.$ # ##
# $@.#$.* #
# ##.#..  #
#      ####
########
Solution: r1d2l3u5r3d3u2l1u1r3l5d5r5u1r3u1l1d1l2d1l5u2r2l2u3r5d2l1r1d1u3r2d3r1l1r1d1l1u4l2d1r1u1r1d2u2l4d1r1

;19
  #####
### ..#
# . $ ###
# #.$ ..#
# #.$ $.#
# # $ ###
# $@   #
###$ $##
  #   #
  #####
Solution: r2u2r1l1d2l2u3r3l2u1l1d3r1d1r1u4d3l1d3l1u4d2r2u4l4d4r1l1u4r3d1r1d2l2u2r1u1l1r2d3l1u1r1u1l1d4l1u2d3r2u4l1u1r1

;20
#######
#     #
#@#$.$####
# #.$  $ #
# #  .*# #
# #.$  . #
# #  $####
# #$. #
#   **#
### . #
  #*.$#
  #   #
  #####
Solution: d6r2u1r1u2r1u1l1u1d4r1u2d2l2d2r2u2d2l1d2r1u2l2u2r1d2,4-1d4l1d2,2-8r1,4-7u2,4-9u2,3-3d4,2-8r1u1r1d1,4-5d2,4-3d2,3-1d3,8-3l3,4-4u1,5-1d1,6-3l2,5-7u1,4-5r2l2d1

;21
    ####
    #  #
    # $#
#####  ###
#.$ $*.* #
#    $ $ ##
#*$.. .  @#
##. $*.$$.#
 #### .#  #
    #######
Solution: l6u2l1r1d1l1d1r4u1l2r2d3l1u1r1u2l2d1l1d1r1u2r2d1r3l3u1l2d2r1l1u2r2d2u1r2u1l2r2d1r1d2l1u1l1u2r1d1l1d1r1u1l3d1l2u1r3,7-7l1,6-1d5,7-7u1,4-5r1d1r1u3l1d2,3-4r1,3-4d1,3-7u2,6-6l2,5-3d2r1d1l1,8-5l1,6-4d1,6-1d2,2-4r2

;22
  ####
  # @#
###$ #
#... ####
#.#.#   #
#...$ $ #
# $$$ $ #
#   $$. #
###    ##
  ######
Solution: l1d2l2d2r2u2r1u2l1d1r1d1l1d2l2d2r2u3d2l1d1l1u3d3r2d1r3u1r1u3l2d1l3d1l1u1r4u1r2d1l5d2r1u2r2d1l2d1l1u1d1r1d1r1u2r1u1l1d1l1u1r4d1l3d1r1l2u1

;23
  ####
  # @#
  #$ ###
###    #
#.#.$# #
# $. # #
#. .$$ #
#    ###
######
Solution: l1d4l1d1l1u1r3u2d2l2d2r2u1l2u1r1u2r3d3l2d1l1u2d1r3u3l2d2u2r2d3l2d1l1u1r1u3l1u2r1d4u2r2d3l2

;24
  ############
  #     # ...#
### # #$#@ .##
# $ $.$    ##
# # #$# # .#
# . $ $ ####
###     #
  #######
Solution: d1l2d3l2u3r4d1r1u1l1u1r1l1d1l2,3-3r6d1r1u2l1u1r2,1-3r8,10-4u2l1u1r1,7-1d1,6-3r3d1r1u2,5-5l2,5-5r1d1r1u2,6-3r3u1r1d1,5-1d1

;25
#####
#   ########
# .*.   $  #
# #. .#$@$ #
# . . # $  #
# ## # $ $ #
#          #
############
Solution: d1,9-2l4,3-1d1r1,6-2l3d1,2-4r1,4-5u1l1u1r1,7-4u1r1u1l4,3-1d2,2-4r1u2d1r1d1,9-4u1r1u1l6,3-1d2r1,4-4l1,4-6u1,7-6u3r1u1l4,3-1d1,8-6u3r1u1l5,9-6u3r1u1l5

;26
     #####
     #   ###
     # $$$@######
#### #          #
#  ###  $$*###$ #
# **..*. $. $ $ #
#      $  .##   #
######### ..#####
        # ...#
        ######
Solution: 7-5l2,11-5l5,6-6r3u1r1d2l1d1r2,10-3d4l1d1,13-5l2,10-4d2l1d1r1l1d1r1,8-3d1r1u1r1d4,9-5l2,15-5l4,10-4d2,14-3d1r1d1l7,8-1d2l1d1r2u1r1d2,6-2r1u1r1d2l1d1r2u1r1d1,10-2l1,8-1d2l1d1r2

;27
#####  ####
#  @#  # .#
# $$#  #..#
#   #### .#
# $$ $  $.#
#   .###.$#
# $$###...#
#       $ #
########  #
       ####
Solution: l2d6r6u1r1u3d3r1u4d6l1u1r1u1l1d1,4-4r4,9-5u2,3-5d1,2-7r5,8-8u2,2-5d1l1d1r6,8-8u1,2-3d3l1d1r7d1r1u4,2-4r6,3-1d3l1d1r1,2-1d5l1d1r7d1r1u1

;28
           #####
  #######  #   #
 ##   . ####$ .#
## $ $      $..#
#@ $$$$####...##
##    .#  #####
 #######
Solution: r1d1r2u2r1u1r2d1r5d1r1u1r1u2l2d2r1d1l1u1l5u1l2d1r7u2r2d2l1r1u2l2d2u1r1d1l9d2l2u2r11l9d2r1u1l1u1r8u1r1d1l10u1r2d2u1r1d1l1u1l1d2l1u1l1u1r10

;29
              ####
         ######..#
         #       #
######## # $..*$ #
#     #####$##  ##
# $$$$   $ $..#.#
#    ...*#    @ #
##############$ #
             #  #
             ####
Solution: r1u4l2d1r1d1r1u1l1u1r1d1r1u1l6d1r3,10-5r2,11-5u1,10-3r2,14-8u1,13-6r1d1,15-5d1,10-5l3,5-4d1r6,4-6r2,3-4d1r7d1r1u2,10-3r1,15-8u2,2-6r3,2-4d1l1d1r3

;30
 ######
 #    #
 # $$ #
 #..#.#
### $ ###
# $.#$$ #
# . @ . #
### $####
  #  #
  ##.#
   ###
Solution: d2,5-4l1,3-3d3,3-1d1,5-2l2u1l1d1,5-6u2,7-5l1,5-4d1,4-6r1,1-5r1,3-8u1r1u1l1

;31
     #####
######   ##
#  $  $ $ ##
# *#$#.#   #
# +..... $ #
# $#*#*# * #
#        $ #
######  ####
     ####
Solution: l1d2r1u1,9-2l1,6-1d2,7-4l3,4-2d1,2-2r3,6-1d2,7-4l1,6-6u2,10-4l3,6-2r1u1r1d2r1d1l1,10-6l3d1l1u1

;32
  #########
 ##       #
## $$ $$# #
#..   $ # #
#...##$@# #
#...# $ $ #
#####     #
    #######
Solution: u1l5r3u2l2d1u1r2d2l2u1l1d2u1r1u2r1d1r1d1l2u1l1d1r1d1l1r1d1l1u2,7-1d1l2u1l1d1r1d1l2,7-4u1,5-5r1u1r1u1l3u1l1d2u2l1d2,7-6u1,9-5l2d1l1u1,7-3d1,6-5u1r1u1l4,8-5l1d1l1u2r1u1l3u1l1d1u1l1d1,7-1d3l1d2r2u1l1d1l1u2r1u1l4

;33
############
#         .#
#.#$# #$#*.#
# $@$$$ $..#
#$# # # #..#
#         .#
#########  #
        ####
Solution: 9-1d2,7-3r2,10-4u1l1,9-3d1,10-5l1,5-4u1,5-1d2r3,9-2d1,9-5u2,7-5r1,9-6u1,3-3r2d1,4-5r5d1r1u1,5-3r4,1-3r7,3-3u1,2-1r7,7-1d3,6-5r3,1-5u2

;34
 #######
##   @ #
# $.$. #
# .# # #
# *. $ #
#  #$ ##
##   ##
 #####
Solution: l2d1r1u1l2d1l1d2r1u1l1u1r1u1r2d3l1r1u3l2d1l1d3r1u1r2u3r2d3l3r1u3l2d1l1d3r1d1r2u1r1u1l1

;35
 ######
 #@.$.##
##$$ . #######
# .# $$*. .  #
#            #
####$ ########
   #  #
   ####
Solution: d2l1d1r9l6u2r2d1r2l2u1l2d2r2l2u2l1u1l1d2l1d1r3u2r2d2l2r1d2l1u2r2u2l1d2u2l3d2r2u1d1u1r1u2l1r1d2r3d1r2u1l4u1l2d2u2r2l2d2l2u3r1l1d3r2u2l1u1l1d1r3u1l1d2u1r2d2r2l2u2l2d2r2l1u2d1r1l2d3r1u2r1u1r2d1l2u2l2d1r2l2d2r1l1u2d2r1u1d1u1r3u1r2d1l4r4u1r2d1l2u1l2d1l2u1r4d1l2r4u1l1d1l2u1l2r1d1l1u1l1u1l2d1r3l3d2r1u1l1u2r2d1r1d1l1u2l2d1r2l2d2r1u2

;36
      #########
     ##       #
 ##### $.$.$. ##
 # $ $ .#.#.#. #
 #      #@#$## #
#######$#.#.#. #
# $   $ $ $ $ ##
# $ $         #
# #.#$#########
# ..  #
# #.#$#
#  .  #
###. ##
  ####
Solution: d3l5u1l1d5u2l2u2r2u1r2d1l1u1l1d3l1r2l1u2r4u1l2d1l2d2r2u1d1l2u2r2u1r2d1l2d2l2u3r2d1l1u1l1d1l2d2u2r6u1l2d1l4d4r4u3d1l4u2r4l2r2d2l2d1u1r2u2l2d2u2r1l1u1d1r2u1r2d1l2d2l2u3r2d1l1u1l1d2u1r2d2l2,7-1d1,7-4d2,8-7l4u1l1d2,7-2d4,8-7l4u1l1d1,10-2r2u1r1d1,11-6r1d1r1u1,11-5u2,10-2r1,9-6r1d1r1u3,7-6r3d1r1u1,8-2r1,5-6r3d1r1u3,1-6r7d1r1u1,4-3r2d1r1u1l1u1r1,2-3r4

;37
     #######
     #. #  #
     #  $$@#
     #$.#. ##
     #. *.$ #
######$ #.. #
# $ $ $.## ##
#          #
############
Solution: d2r1d1l1d2l3u3r2u1r1d1u3l1d1r1d2l3d2u2l1u2r1d5r3u2r1u1l1d3l3u5r2u1r1d3u2l3d5l2u1r1d1r1u3l1d1u3r1d1l1d1r1d3l2u1r1d1r1u3d3l4u1r3d1l5u1r4d1r1u2

;38
    ####
    #  #
#####.$#
#      #####
# $@..  .  #
##$###.*#$ #
# $  $$ #. #
#    . .#$ #
######     #
     ##  ###
      ####
Solution: u1l2d1r2u1r3d1r1d3l6u1r1u1d1u2l1u1r2,5-4l1,6-1d2,4-4l1u1r1d1r1u1,1-4r1l1r2,7-4l1,6-7u1,4-6r2d1r1u1,7-9u1,4-6l1,2-5d1l1d1r3,9-6u1r1u1l1,9-8u1

;39
   ######
   #    #
####$$#.####
# $..$.  $ #
#@    #..$ #
# .##      #
 ####$$.####
    #   #
    #####
Solution: 4-3r1,4-1d2,5-3r1,7-4u1,1-3r4d1l2u1l1d1,7-3l3,5-1d1l1d1r1,7-3l2d1l1u1,5-7u3l1u1r1,4-1d1,7-1d4,10-3l2d1l1u1,10-4l1,7-7u2,5-6r1

;40
####
#  ####
# $$  ##
# @..$ ####
### $.  $ ###
  # .$.$..  ####
  #      $ $.$ #
  ###### $.... #
       #   $## #
       ###  ####
         ####
Solution: 14-6l1,11-5d1l1d1r2,8-7r3,11-9u1,9-5d1l1d1r1,6-5r1,9-4l2,7-5r1,4-5r3,5-2d1,6-3d1,4-3d1,2-1d1l1d1r2,4-2l1,2-1d1l1d1r1

;41
   ####
####  #  ####
#  $$ ####  #
#         $ #
## # #.##.  #
# $$ # #...##
# $  # #...#
#@$  # #...#
# $$ # ## ##
## #$#.#  #
#        $#
#   $  #  #
####  #####
   ####
Solution: r1d3r6d1r1u4r1u1l1u1l1d1,4-12u1l1u1r5d1r1u4r1u1l1,1-11r3d1r1u1l1u1r4d1r1u5r1u1l1r1u1r1u2l1d4,4-8d1,3-10r5d1r1u5,1-6r1,2-4d6l1d1r3d1r1u1l1u1r4d1r1u4,4-1d9l1d1r1d1r1u1l1u1r4d1r1u3,2-2r2u1r1d1l1d1r5d1r2u2l1d3,2-6r1,4-7u3,3-3r6,10-2d2,2-5r1d1r1u2,2-3r7,10-2d1r1d1l1,2-8r1u2,4-7d2,3-10r2d1r1u6,2-5r1,4-4d5,3-10r2d1r1u1

;42
 ######
 #  @ #  #####
## $$ #### ..#
#   $ #. #...#
# $$###.$#$*$#
# $    . $.. #
#####  *  .$ #
    #######  #
          ####
Solution: 1-5r4d1r2u1r2d1r2u3d2r1u2l1d4r1u3d2l3u1r1u1d2r1u2d1l4d1l2u1r5d1r1u1l4u2r1d1l1d1r3l3d1r2,2-3d1l1d1r5d1r1u2,3-3d1l1d1r4d1r2u2l1d1l1d1r1l2u1l2u1l1u3r1d3l1d1r4d1r1u1r2d1l1,5-2l1u1l1d3l1d1r7,5-3l1u1l1d2l1d1r4

;43
###########
#@#  ##   #
# $$  #   #
#.$   $  ###
# $#..#..$ #
#$ $.###.$ #
# .## # .$ #
# .   #    #
############
Solution: d2r3u1r1d1l4r6d1r1u1l1u2r2l2d2l6d2u2r7d4r2u3l2u1l1u2r1l1d2l6d2r1u1l1u1r6l4r1l2d4l1u2r1u2r2d2l1r1u2l2d3u3r2u2l1d1r1d3l2u2r1u1r1d2u1l3u1r1d3l1u1r1u2r1u1r1d2r3u2r2d1l1d1u2l1d1r1d1l5u1l1d3u2r6d1r2d3l2u2d2r2u1l1r1u1l1

;44
     ###
######+#
#...##$#
#. $## #
#    * #
# $$ $ #
###    #
  ######
Solution: d3l3u1d1r1d2r2u4d2l3u1l2d1r3d2l1u1r1u1l1u1l2d2r1u1r1u1l1d1l1u1d1r3d2l1u1r1l1r1u1l2r1d2r3u2l2d2r1u1l1u1l1d1l1u2d2l1u1

;45
 ######
 #@#..##
 #$*.. #
## #$$ #
# $    #
# ##   #
#      #
########
Solution: d1r2d2r2u1l1d1l1u2d1r1u1d4l4u2r3u1r1d1u2l3d1u1r2d1r2d3l2u3r1u1l1d4r1u3r1u1l1d4l4u2r3d1r1u2

;46
  ####
###+.##
#  $*.#
# #$ *#
#   $ #
###   #
  #   #
  #####
Solution: r1d1l1r2d2u2l2d2l2u2r1l1d2r2u2r2d2l1u2l1r1d4r1u3l2u1l2d2r3d1r1u1d2l2u1r1u3l3d2r2d1r1u2

;47
####
# @########
# $$ #  # #
# $. #$.  #
# $. $ .# #
# $#.##.# #
#       . #
###########
Solution: l1d5r3u2r2l2d2r5u3l2u1l1d1r3d3l2u2d2l3u2r2u1r1d1,9-3l1,1-4r5,2-4d1l1d1r6,1-3r1,2-1d2l1d1r1,4-2l1,2-3r1u1r1d2,2-1d1l1d1r1

;48
#######
#     ############
# $.$.  $. $.  . #
#  $.$$.     $ $ #
##   ..$. $ *#####
 #.$$. .$.####
 #  @######
 ######
Solution: 8-4l4,5-2d1,11-4l4,14-3l4,10-2r2,16-3l4u1r2,11-4u1l1u1r1,7-2r1,7-5r1,10-3l1,8-2d1,5-3r1,5-3d1,4-6u1r2,3-2r1,2-3r1,2-5r2,3-3d1r1d1l1,1-2r1

;49
#########
#@      #
##.*#.# #
# $$ .#$#
# .   # ##
##### $  #
    #    #
    ######
    #####
Solution: 2-2d1r1,7-5l1d1l1u3,7-2d2,8-5l1,1-4r2,5-3l2d1l1u1,5-4l2,7-5l1d1l1u2

;50
##########
#@       ######
# $ $$$$$ $ $ #
#        .....#
###########...#
          #####
Solution: 11-2l1,13-2l1,8-1d1,7-3r5u1r1d1,10-2l1,12-2l2,8-1d1,7-3r3u1r1d1,10-2l1,8-1d1,7-3r5,4-1d1l1d1r8u1r1d1,5-1d1l1d1r7,2-1d1l1d1r9,6-1d1l1d1r4,7-1d1l1d1r2

