;1
 ###
 #@#
##$###
#    #
#  # #
#  $ #
# $$##
##$  ##
## # .###
#   #.. #
#   $.. #
###  .  #
  #######
Solution: undefined

;2
######
#    #
# $# #
# $  #
#   ##
#  ####
##$#  ####
#  $.*.  #
#    .*  #
###  #..##
  #####$#
      #@#
      ###
Solution: undefined

;3
########
#..    #
# $ $  #
####$ .#
  # *  #
  #  $##
  #. @#
  #####
Solution: undefined

;4
########
#+*  . #
# $ $  #
####$ .#
 #. .  #
 # $$ ##
 # *  #
 ######
Solution: undefined

;5
#####
 #   #######
 #    $  $+#
 #.$ #    ##
###$##### #
#. * #    #
##.  $*####
 #####.#
     ###
Solution: undefined

;6
#####
#   #######
# $ $ $ $ #
##.  .$@$ #
### ##### #
#. . #    #
##    .####
 #####.#
     ###
Solution: undefined

;7
#######
#.   .#
## # #####
 #.    $@#
 # #$## ##
 #  $ # #
 ###    #
   ######
Solution: undefined

;8
###########
#+*.      #
## ###$$  #
 # $  ..###
 #### $ $ #
    ##$.  #
     #  ###
     ##.#
      ###
Solution: undefined

;9
 ########
##   ##.##
#  #  ...#
# ### .  #
# ###$$  #
# $@$   ##
#### $###
   #   #
   #   #
   #####
Solution: undefined

;10
######
#.##.#
#. # #
# $# ###
#$$    #
#@$$*$ #
##  ...#
 #######
Solution: undefined

;11
######
#  #@#
#  *$###
# $$ . #
#. .$$ #
## ..  #
 #######
Solution: undefined

;12
###
#+#####
#$##  ##
# $. . #
# $$$* #
#.     #
#.$.*  #
########
Solution: d3u1r3d1u1l2d1u1r2d1l1d2l1r2u1l1r3d1l1r1u3l1d1l1r1u2l1d1r2d3l1u1l2d1r1u1r2u2l3d1u1l1r4d2l2u1l1u1r1l3d1r1u1r2d3l2u2d2r2u3l2d1l1u2d1r1d3r2u1l1d1l1u1r2u2l1d2l1u1l1u1r1d2r4d1l1

;13
 #####
 #   ###
 #$#  .#
 #@# ..#
 #$  ..#
##   * #
#   # ##
# $#  #
# $ $ #
###   #
  #####
Solution: d1r4d1l1d4l2u1r1d1r1u5l1u1r1u1r1d1l2d1l1d2l2d2r3d1r1u5l1u1r1l1d1l1d2l1d1l1d1r3d1r1u6l1u1r1l1d2l2d3l1d1r3d1r1u5l2d1u1r1u3l2d6l1d1r3d1r1u4l1u1l2d1r2

;14
 #######
 #. .. #
 # $# .#
##$  $ #
# $$$..#
#@$  . #
########
Solution: undefined

;15
  #######
  #..$ .#
###.$$.##
#.$$ . .#
#. $$####
#$    $@#
#   #####
#####
Solution: l3u1l1r1d1l1u2l1r4l3d3l2u1d1r2u3r1l1u1d1r3u2l1,1-5r1d1r1u1r1u2l2d1u1r4u2l1d1r1d1l2d2l1d1l2u1r1u2r1u1r2d1r1u1l1u1r1d2l1u1l2d1l1d1u1r1u1r2d1l1d2l1d1l2u1r1u1r1l1d2r1u1r1u2d2l2u2r2l1u1r2l1d3l1u2

;16
 ### ###
##.###@#
#.   $*#
#.$$$$ #
#.    .#
########
Solution: d2u1l2d1u1r2d1l1d1l3u2r3d2l1u1l2r3u1l3

;17
########
# . .$ #
#. $ *.#
#$  $$ #
#.#  $+#
########
Solution: u2l1r1d2l1u1l2r3u2l3r3d2l3d1r2u1r1u2l2d1r1u1l2d1l2d1u2r2d1r2d2l2u1d1r2u2l2d1r1d1r1u1l2u2l2d2r1u1r2d2l1u1r1u1l2

;18
 ######
##. *@#
#.#$ ##
# $ $ #
#*$ . #
#.   ##
######
Solution: l1d2l1d2l2u2d2r2u2r2d1l1d1l3u2r1l1d2r3u4l1r1d4l3u2r2d1r1d1l2r1u2l2d1r1d1r2u1r1u1l2r1u2l1d1r1d3l2u1r1d1r1u3l1d1r1d2l2u1l1u1r2l1d2r2u1l2r1u2r1d1

;19
 ######
##. . #
#.#$ .#
# $  $#
#*$$$ #
#+$ ..#
#######
Solution: undefined

;20
  ####
 ##  ##
 #@$  #
##$*$ ##
#..*.$ #
## $*. #
# $ .. #
#    ###
######
Solution: d2r1d1r1d2l1u1d1l2u1r1u1d2r2u2l1u1l1r1l1d1r2d1r2u1d1l2d1l2u1d1r2u1l1u2l1u2r1d3u2r1l1d2r1d2l1u3l1u2r1d1r1d2l1d1u1d2r1u1r2u2l1r1d2l3u2d3r1u1r2u2l2r2l2d1u1r1d1l2r1l1r1u1d1u2l1u2r1d1r1d2l1d1l1u1d3l2r3u1d1l3u1r2u2l1d1u1r3u2l3d1u1r3d2l2u1l1u1r1d5u1d1l1r1u4l1d1r3u2l1d1u2l1d1l1d2r1d3l2u1r1u1d2r1u2

;21
   ####
  ##  ##
  # $  #
### .$ ##
#..**.$ #
### $** #
 # $ .*@#
 #    ###
 ######
Solution: l2u1l1u1l2r2d1r1d2l1u1d1l2u1r1u1d2r2u2l1u1l1r1d1r1d1l1u2l1u2r1d3u2r1l1d2r1d1r2u1d1l2d1l1u3l1u2r1d1r1d2l1u1d3r1u1r2u2l2d1u1r1d1l1u2d2l1d2r1u1l1u1r1u2l1d1r1d2l1u1r1u1r2d1l1u1l1d1u2l1u2r1d1r1d2l1d1l1u1r2l2d3r1u1d1l3u1r2u2l1d1u1r3u2l3d2u2r2d1u1l2d2r1d3l2u1r1u1d2r1u2

;22
###########
#     ..$@#
#  $$$.$###
##$ # ...#
 #   *.###
### #  #
# $ ####
#   #
#####
Solution: l2d1l1d1r1u2l2r1d3u3l3d1l2u1r5d2l1u1r1u1l3d1r2l4u1r4d2r1d2u2r1u1l2r1d3l1u1l3u1d1r4u2l1d1u2l2d1r2l1u1l3d1r1d2r3d1r1u1l1u1r1l1u1l2d1l1d1r3d1r1u1l3u3l2d1r1u1r1d2l1d1r3l2d3l2u1r1d1r1u3l1u2r1d1l1d1r2

;23
 #####
##   ###
# $$   #
#  .$  #
## .*.##
 # * *#
 ## $+#
  #####
Solution: u3l1,2-1d1r1d1,1-3r1,2-5r2,3-6r1,4-5u1l1u1,3-1d3,5-3l1,3-4u1,4-1d2,3-4r1,6-2l1,4-1d1,3-3r1,3-6u1,2-5u1,3-3d1,3-1d2,1-3r1,6-3l1,4-2d1

;24
  ###
 ##@##
## $ ###
# $ $$ #
#  $   #
##$....#
 #.*$.##
 ##  .#
  #####
Solution: d1,4-2d1,2-2d1r1d1,1-4r1d1r3,3-5u1,5-4l1,4-2d2l1,3-7u2r1,5-4d2,3-6r1,2-3r1,4-2d3,4-7u1,3-5r1,2-5u1,3-3d2,6-3l1,4-2d2,2-2d1,1-4r1,3-3d1

;25
 #####
##   ###
# $  $@#
#  $$$$#
##$..*.#
 #..$*.##
 ##. *. #
  ####  #
     #  #
     ####
Solution: d4l2,6-4l1d1l1,6-2l1d2,6-8u4,6-2d3,5-2l1,2-1d1r1d1r2,6-2d2,4-1d1,3-3r2,1-3r3,5-2d1,6-2d1,2-3d1

;26
 #####
##   ###
#   $  #
# $$  $#
##@.*..#
 #**$.###
 #   .. #
 #####$ #
     #  #
     ####
Solution: u1,1-2r1,4-1d1,6-2d1,2-6u2,5-4l2,2-2r1d1r1,5-4u1,1-3r1d1r1u1,3-6u2r1,4-1d2l1,2-6u1,3-5r1,6-8u1,7-6l3,2-6r3,3-1d4,2-6r2,6-2l2,3-1d3,1-3r1d1,3-2d1

;27
   ##########
   #...     #
#### **$ #  #
#   $..$$#$##
#   ###   @#
##### ######
Solution: u2,11-1l5d1,6-2l1,5-3l2,1-3r3u1,8-2l2,8-4u2,10-1l3,7-4u1,8-2l1

;28
    ###
  ###.#
  #  *#######
  # ...   $@#
#### *$$$#  #
#   $..$ #$##
#   # .    #
############
Solution: l5,6-3d1l1,5-5l1u2,10-6u2,11-3l3d1l2d1,7-6u1,6-3r2,8-4l1,4-3r1u1,3-2r1,7-3l2,11-3l5,4-5l1,5-6r2,1-5r4,7-5l1,9-6l2,6-3d1,8-6u2,10-3l3

;29
  ###########
###..*..  $@#
#  #  .$$#  #
# $#$#.$ #$##
#     .    #
############
Solution: l3d1l2,6-1l2,4-4u2,8-1l2,10-4u2,11-1l4,2-2d1,1-4r5,8-4u2,9-1l1,6-4r2,4-2r1,8-3l1,10-4l3

;30
  ###
  #@#
###$#
#   ##
# $  #
##  $####
 # $.$  #
 ## .*. #
  # $.. #
  ###.# #
    #   #
    #####
Solution: d3,4-4d2r1d1,1-4r1,2-6r1,3-7r2,5-6l1,4-5l1,5-7d1,7-6l2,3-8r2,5-10u2,3-7u1r1,4-4l1d2,6-6l1d2,4-7u1,4-4d2,3-8u1r1,5-6d1,3-5d1,1-4r1,3-3d1,2-6u1,3-8u1,1-4r1,2-5r1,3-3d1,4-4d2,2-6r1,3-7r1,4-5d1,2-5r1,4-4d1

;31
 ######
 # $ .##
## .*..#
# $.*$$###
#   .  $@#
###  $####
  ##  #
   ####
Solution: l3u1,5-4l1,3-5u2r1,1-3r1,2-1r2d2l1,2-2d1,4-2l1,4-5u2,1-4r1,6-4u1l3,5-6u1,6-4l1,4-1d1,3-3r1d1,4-6u1,3-5u2,4-3d1,1-3r1,2-1d2r1,4-4u1,1-4r1,4-6u1,3-5u1,6-3l1

;32
     ######
######    ###
# @$    $$$ #
#   ##  *.. #
########...##
       #.$##
       # $ #
       #   #
       #####
Solution: r4,9-1d2,9-3l1,8-4r1,8-1d1l5,8-4u1,9-2l1,10-6l1,8-7u4,9-6u1,8-1d3,11-2l1,9-1d1,8-3r1,6-3r2,7-1d1,6-3r1,8-2d1,1-2r6,8-1d1

;33
  #####
 ##   # #####
 #  # ###   #
 #$#@$.     #
## ##### ####
#  ####  #
#$.##.$ ##
#  ######
#. ####
# $  .#
##$  ##
 #.###
 ###
Solution: r1,2-2d5,1-9r3,2-9d1,2-7d1,1-9r1,1-5d2,4-9l1,2-10u3,5-3r4,11-3l4,7-6l1

;34
  ######
 ##@$ .######
 #.$# ###   #
 # .$.$     #
## ##########
#  #
#$.#
#  #
#. ###
# $  #
## $ ###
 #.$  .#
 #######
Solution: r2,5-3l2,3-1d1,2-2d5,1-9r1,2-11r3,2-3r1,2-9u6d5,1-5d2,4-9l1,2-10u3,3-9d1,4-11l1,5-3l1,5-3r4,11-3l5

;35
#####
#   #
# # #
# # #####
#   #   #
##$ $   #
 #  ##$###
 ## #   .#
 ##$#  ######
 # .## .$@#.#
 # #    ###$#
 # .       .#
 ############
Solution: l2d1l1u2l1u1r2l1d4r5u1d1l9u2r1u5d1r2u1r2d1l1d4r1d2l2u1r1d1r1u1l1,4-5r1u1r1d6l1d1r5,3-2d6,2-6u1,1-4r1,3-3d1l1d1r3u1r1d6r1d1l3

;36
    ###
    #@#
 ####$##
 # . . #
 # $  .#
 #  # ##
 # ## #
## ## ######
# .##$     #
# # $  ### #
# *      $.#
############
Solution: d2,4-4l1,6-4l1,1-10r2,3-9r2u5,6-3l1,3-4r2,2-3d4,5-3l1,5-10l2,10-10l3,7-10l1u1,7-8l1,5-9u5,4-10r5

;37
    #####
    #   #
 ####   #
##@##$ $#
# $$    #
#  $ #  #
#  #### #
#### ## #
     #  ##
   ###$..#
   # ..*.#
   #  $..#
   ####  #
      ####
Solution: d1r3u1,7-2d6,6-8d1r1d1,7-12u9,7-11l1u1,4-11r2,7-12u1,8-10l2,7-1d9,6-11r1,8-12u1,5-4r1,7-3d7,6-11r1,6-8d1,2-6u1,1-4r5,7-3d7,4-5l1,2-6u1,1-4r5,7-3d6,5-1d2,6-4l2,2-4r4,7-3d5

;38
  ######
###..  #
#   .  #
# # ..#####
#  ##     #
# $##  #$ #
#     $ $ #
#######  ##
      #  #
      ##$#
       #@#
       ###
Solution: u2,7-6l3,9-6l1u1,9-4l3,5-5u3,6-1l2,8-6l1,8-8u2,8-6u1,9-4l3,5-5u2,6-2l1,4-1d1,5-6r2,8-7u2,9-4l2,2-6r5,8-7u1,7-4l1,5-5u2,6-2l1,8-6u1,9-4l3,5-5u3,6-1l1,2-4d1,1-6r6,8-7u2,9-4l3,5-5u1

;39
########
#      ###
#   .  #@#
# # .###$##
#  ... $  #
#  .#$ #  #
# $  $ $ ##
#######  #
      #  #
      ####
Solution: d2l5,1-4r1,3-5u2,2-2r1,4-1d1,6-6l1u1,6-4l2u1,3-5u2,4-1d1,2-2r1,8-4d2l1,8-8u3,9-4l6,5-6r2,8-7u2,1-4r1,3-2r1,3-5u2,4-4u1,9-4l6,3-6r4,8-7u1,8-6u1,9-4l4,1-6r6,3-1d3,4-1d1,1-4r1,6-2l1,8-7u2,9-4l3

;40
   ###
  ##.###
###..  ###
#   .  #@#
# # ..##$##
#  ##  $  #
# $##  #  #
# $     $ #
####### $##
      #  #
      ####
Solution: d2l2,5-6u3,6-2l2,9-7l1u1,9-5l3,5-6u3,6-2l1,4-3u1,8-7l1,8-9u3,9-5l3,5-6u2,6-3l1,4-2d1,5-7r2,8-8u1,1-7r5,8-7u1,9-5l3,5-6u2,6-3l1,6-7r1,8-8u2,9-5l3,5-6u3,6-2l1,2-5d1,1-7r6,8-8u2,9-5l3,5-6u1

;41
      ###
      #@#
 ###  #$#
 #.## # ###
##*.###   #
# $.$ # # #
# $.    $ #
# .. ######
# $###
#  #
####
Solution: d3,9-6l5,1-5r1u1,2-7u2,4-6l1u1,2-9u1,1-7r1,2-5d1,5-5l1,7-4d1,8-6l4

;42
 #####
##...##
#  .*.####
#   $*#  #
## #  $$ ##
 #  $   $@#
 ####  ####
    ####
Solution: l3,7-3d1l2u1l1u1,5-6u1l1u2,8-5l1,6-4l1,4-3l1,6-6u1,1-3r1,2-5r3,4-3l1,2-4u2,4-5u1,5-3l2,2-4u1,1-2r1,3-3u1,5-4r1,6-6u1,7-3d1l2,4-5u1,5-3l2,2-4u1,1-2r1,8-5l1,6-6u1,7-4l1,5-5u1

;43
 ##########
 #      #@#
##$$$ $ #$##
#.*.**. #  #
##.* .     #
 ##.$ ######
  #####
Solution: d2,10-4l3,3-1d1r1d1r1,5-5l1u1l1u1l1,5-3l1,2-1d1r1d1,7-3l3,4-1d1,5-1d1,6-1d1,7-4l1

;44
        #############
        #          ##
    #####  $ $#$ $###
#####..## #$ $ $    #
#.....  #  $$   $$# #
#........  # $#$  # #
##... .## $$     $$ #
#########  ###@ $  ##
        ##   $  #   #
         #    #######
          ##########
Solution: d1l1r1u2l2r4u1r1d1l5u2d2r1,17-3d1l1,12-4l2,9-3d1r1d1l3u1l2d2r1u2,10-7u1,12-6l2u1,9-7u1r1u1l3u1l1r1d1l1d1l1u2,11-4l1,9-3d1r1d1l4d1l1u1r1u1l4,13-8l2d1l1u2,11-6l1d1l1u1r1u1l7,13-4d1,14-6l4d1l1u1r1u1l6,19-6l9d1l1u1r1u1l5,17-8u1r1u1l8d1l1u1r1u1l4d1l2u1d1l1u1d1l1u1,5-4d1r1d1l3,17-7l2d1l1u1r1u1l5d1l1u1r1l1r1u1l4u1l1d1r1d1l2,17-4d1,18-6l8d1l1u1r1u1l4u1l1d1r1d1l1,14-4r1d1r1d1l6d1l1u1r1u1l4d1l1u1,16-3d2r1d1l7d1l1u1r1u1l3u1l1d1,12-2d3r1d1l3d1l1u1r1u1l8,10-2r1u1r1d4r1d1l3d1l1u1r1u1l7,11-2d1r1d1u1d1l2r1u2l2d2r1d1l6,14-3l1,12-2d3r1d1l3d1l1u1r1u1l5,16-3l3d1l2u2r1d3r1d1l3d1l1u1r1u1l4,17-1d4,18-6l8d1l1u1r1u1l3,15-1d4r1d1l6d1l1u1r1u1l2,13-1d1,14-3l1u1l1d3r1d1l3d1l1u1r1u1l1

;45
          #####
       #####  ##
       #    $  ##
     ### ##$ $  #
########  $ $ $ #
#   .. #  $ # $ #
# ..... $$  # # #
# .... #   $#$  #
#  ..  # #    $ #
### #### ## #####
  ######  @ #####
       ######
Solution: 8-7u1d1r2u1l7,8-4d1r1d1l5,11-4l1d1r1d1l6u1l1d2u2l1d2,11-2d2,10-4l1,8-3d2r1d1l5,13-8u1,14-3l1d1l4,8-3d2r1d1l4u1l1d1u1l1d1u1l1d1,15-4l6,8-3d2r1d1l3d1l1u1r1u1l3,11-2r1d1r1d1l4,8-3d2r1d1l3d1l1u1r1u1l1,13-1d2r1d1l5,8-3d2,9-6l3u1l1d1,3-5r1,1-5r2,13-7u2,14-4l5,8-3d2r1d1l6,11-6u1,12-4l3,8-3d2r1d1l5,11-8u3,12-4l3,8-3d2r1d1l4,15-8l3,11-9u4,12-4l3,8-3d2r1d1l3,15-5l1,13-6u1r1u1l5,8-3d2r1d1l2

;46
############
#     ###  #
# .#... $  #####
# .*.*# #* #   #
#     # . $    #
####### ########
#     # #
# $ $ $ #
# $#$ # #
#     @ #
#########
Solution: 9-4r3,4-3l1,2-4u1,9-2l4,4-1d1,5-4u1l2,5-1d1,5-7r1,7-8u5,8-2l3,4-1d1,5-4u1l1,5-1d1,3-7r3,7-8u5,8-2l3,4-1d1,1-7r5,7-8u5,9-2l4,2-9u1,1-7r5,7-8u5,8-2l2,4-9u1,3-7r3,7-8u5,8-2l1,14-4l5

;47
#############
#    ###   ##
#  $    $$ ##
# $ $ #$$  @#
#     #    ##
#####$#######
#      # .. #
#  $   # .. #
## $$$$$  * #
#      #  $ #
########..*.#
########....#
########....#
#############
Solution: l1u2l1d1l4d4r1l4d3r4u1r2u1r1d4l1d1u1r3u3l1u1l1d3u2r2d2l2r1d1l1r1d1l1u1r1u4r1u1l1d2l4d1l2u1r6l4d1l4u1r7,3-6d1l1d1r6u1r1d4u4r1d4u4r1d4,4-6d1l1d1r7,5-6d1l1d1r5,6-6d1l1d1r3u1r1d3u3r1d3u3r1d3,3-3r1,4-1d1r1d5l1d1r6,3-3r1u1r1d5l1d1r5,1-3r3u1r1d5l1d1r4u1r1d2u2r1d2u2r1d2,3-1d2l1d1r2u1r1d4l1d1r5,9-4u1r1u1l6u1l1d2l1d1r2u1r1d4l1d1r4d1r1u1d1r1u2,8-4u1r1u1l5u1l1d2l1d1r2u1r1d4l1d1r5d1r1u1,8-4l1u1r1u1l4u1l1d2l1d1r2u1r1d4l1d1r5

;48
   ############    #####
   #  #    #  #    # . #
   #  .*.$.#.$#    # * #
   #  #  $ #. #    # . #
  ###@## $    ###### $ #
### $$ # $ $$$ .  $  $ #
# ... .#  . .  .#  . $ #
# .$$$ #################
# # #  #
#   ####
#####
Solution: d1r1d1l3d1l2r2u1r3d2u2l3u1r1d1r1u1d1l2d1l2u1r2u1r3d3l1u1l2u1l2d3r2u2r3u2l2d1l1d1r2l1u2r2d1l2r1u3l1u2r1d4r1d1l1d2r1u1l1u5r2u1r3d2l1r1u2l1d1l2r3d4l2u3l1u2r2d1l1d2r1u1r1u1l1d1l1d3r2u3d3r2l2u2r3d1r1d1l3r1u1r1u1l3r2u3r1d3l1d1r1d1l2u1l1u1r1d1r1u2d1l2u1l2d1r3d1r1u1l4d1r3u1r1d1r1d1r2u1l2u1l2d2r2u2l1d1r1d1r1u1r3d1r2u1l3r4u2r1u1r1d4u1l1u2r1d3l3u1r1l3d1r1u1r2d1r1u2

;49
       ######
       #    #
       #$$$ #
########    ##
#.. $@  $$ $.#
####  #. . ..#
#..$  ###  ###
###$$## $ * #
#.$  ## #$  #
#   ...    ##
#############
Solution: l3r2d2l2r2d2l1u1r1u1l1d2l1r2u4r3d1r3u2l1d1l6r7d2l1d2r1d1l4r3u1r2u1l1u1l1d2r1d1l3u2r2u1r1u2r1l3d1r3l1u1r1u3l2d3l1d1r2u2l1u2l1d3r1d1l1r2u2r1u1l1u1l1d3

;50
##############
#####. .     #
######@$ $*# #
########## #.#
#          # #
# $.$.$.$.*# #
# ########## #
# # .        #
# $$ ###### $##
# .  #    # $.#
######    #####
Solution: 10-3u1,11-1l5,8-2r1,6-2r2,10-3u1,12-1l4,3-7d1,4-9l1,1-8r2,4-9u1,7-5r1,5-5r1,3-5r1,1-5r1,8-2r1,11-9r1u5

;51
#######
#.    #
##  $ #####
## $$ #   #
##$# ##$$ #
#....  $  #
######## #######
#@    .#  ###  #
#*$$.  $      .####
#.  .## $.#*   $ .#
###################
Solution: d1,3-7d1l1,2-9r1,6-8r1,7-8r5,14-8l10,3-9u1,2-7r3,8-3d4,9-8l4,7-9r1,3-8r10,14-9r2,8-5l6u3,3-1l1,5-2l1,4-4u1,7-3d1,8-5l4,2-5r5,8-4d3,9-8l4,4-1d3,3-5r4,9-5l5,2-3r1,4-2d2,4-2l1,2-1d3

;52
 #######
##     #
#  *## #########
# #   *   #    #
# * + # $ #.#. #
# *   #   # # $#
#  ##### ## #  ##
####  #     # $ #
      # $ $ #   #
      # $ #####.#
      #    .*.# #
      ###########
Solution: 5-3r2,1-4r2,2-6u1,3-1d3,4-5l1,9-3l5,3-4u1,8-5u1,9-3l2,11-10r1,14-6d1,13-8r1,15-7d1,14-4d2,15-7l1,13-8u3,11-8l1,9-9u1,8-7r2,11-8u3,7-9r1,9-8d1,8-10r3,8-7d2,7-10r3

;53
     #####
#######.##
#.$  ##$##
#.$ ## $.#
#.$    $.#
#.$    $.#
#+$#######
#  #
####
Solution: 1-4r2,6-3r1,6-4r1,6-5r1,7-3u1,3-4r2,1-5r2,2-7u1,3-5l1,1-4d1,5-5l3,7-4l5,3-3l1,4-2l2

;54
##############################
# $. $. $. $. $. $. $. $. $. #
# .$ .$ .$ .$ .$ .$ .$ .$ .$ ##
# $..$. $. $. $..$. $. $. $. @#
# .$ .$ .$ .$ .$ .$ .$ .$ .$ ##
#    *  . . . . . . . . . .  #
#####  ### # # # #############
    #$ # # $$$$#$$ $ $ $ $ $ #
    #  # #                   #
    #### #####################
Solution: 25-1r1,25-3r1,28-2l1,28-4l1,25-4l1,22-3r1,25-2l1,22-1r1,22-2l1,22-4l1,19-3r1,19-1r1,16-3r1,16-1r1,16-4l1,16-2l1,16-8u2,15-5r10,18-7l1d1l1u2,15-5r8,20-7l3d1l1u2,15-5r6,22-7l5d1l1u2,15-5r4,19-4l1,19-2l1,24-7l7d1l1u2,15-5r2,26-7l9d1l1u4,28-7l11d1l1u2,13-1r1,13-3r1,13-4l1,13-2l1,12-8u4,6-3l1,4-2l1,4-4l1,1-1r1,1-3r1,4-1r1,7-2l1,6-5u1,5-6u1,5-8u2,7-1r1,7-3r1,10-4l1,10-2l1,10-1r1,12-2d2,13-5u2d2l4,10-3r1,12-7l1d1l1u2,14-8u2d1l1d1l1u2

;55
   ########
####      ###
#    $ $    #
#    #.# $  #
# $$ #.# $$ #
#  ###.###   #
# $.......   #
#  ###.###  ##
# $$ #*#    #
#  $ #.# $# ############
# $$ #.# $       $ $ $ #
#..  #.#+# .####       #
#############  #########
Solution: 6-7d3,10-10l1,8-9d1,1-6r4,6-5d4,2-9u2l1u1r4,6-5d3,2-11u4l1u1r4,6-5d2,10-3d2r1d1l4,6-5d1,4-9l1d1r1d1l2,2-8d2,4-8l1d1l1u2l1u1r3,2-3d2l1d1r2,4-4l1u1l1d2l1d1r1,4-2r1u1r1d3,8-2l1u1l1d2,8-4r1u1r1u1l3u1l1d1,10-3r1l1d2r1d1l4,9-8d1l1d1r2d1r1u4,12-6l4,18-10l7,9-10r1d1r1u4,12-6l3,20-10l9,9-10r1,11-11u4,12-6l2,22-10l11,9-10r1,11-9d1

;56
      #####
      #   #
   ####$$ #
   # $   .#
#### $ $###
#   $    #####
# $........  #
#  ###.### $ #
# $$ #*#    ##
# $  #.# $# #############
# $$ #.# $ .   $    $ $ #
#... #.#@# .#### $      .#
#############  ###########
Solution: 6-7d3,7-3d2,8-6l1,6-5d4,1-6r4,6-5d3,7-1d4,8-6l1,6-5d2,3-5r1,4-3r3,9-3l1,7-2d3,8-6l1,6-5d1,7-2r1,9-1d1,1-9r1u2,1-6r4,6-5l1,4-6u1,4-8l1,2-9u2,1-6r1,2-9d1,4-9l1d1,3-9l1,1-8d2,4-3d2,5-3d2,11-8u1,12-6l4,8-10r2,11-11u4,12-6l3,14-10r2,16-11r7,18-10l7,9-10r1,11-11u4,12-6l2,21-10l10,9-10r1,11-11u4,12-6l1,23-10l12,9-10r1,11-9d1,9-8d1,8-10r2

;57
##########################
#..                      #
# ####  ## # #  ## $$$$$ #
# #     #..# #$ .# $ $ $ #
# $$$$$  ..# #   $ $     #
#  @$ ###..# #$$ ######  #
# $$#    ..# #   ......  #
#            #   .. . .  #
##########################
Solution: 5-3d1r3,9-3d2r1d1l2,5-6u1,3-5r1,4-3d1u1d1r4,9-3d2,5-6u1l1u1r4,8-6l1,10-6l1,9-3d2,2-5r2,5-6u1l1u1r5d1r1u2,3-3d1,1-4r8u1r1,2-7u2l1u1r4,10-3d2,5-4r4u1r1d1,9-7u3,10-1d1,7-6r1d1r1u1,5-6r3,2-5u1,4-5u1d1l1,2-6u1l1u1r8,3-7u2l1u1r6,14-4u2r1u1l13,14-6u4r1u1l12,15-4d2,18-4l2u1l1d2l1d1r4,20-4l4u1l1d2l1d1r3,20-3l1,18-2d1r1d1l3u1l1d2l1d1r2,14-7r3,19-1d2r1d1l4u1l1d3l1d1r2,22-1d2l1,24-2l1d4,23-4l6,16-5u1,19-3r3,23-2d3r1d1l3,21-1d2l1d1r2u1r1d2r1d1l2,21-2r1u1r1d4r1d1l1r1d1l3,19-2r3u1r1d5r1d1l1

;58
####
#  #####
#  ...+#
#  # ###
## #   ########
#  # $ $   $  #
# $ $#  $   .##
#  #  .########
########
Solution: 7-6r1,2-7u4,2-1d1,4-7u4,2-4u1,2-1d1r3,6-5l1,4-6u3,2-4u1,2-1d1,3-2r1,2-4u1,1-2r1,8-5l3,4-6u3,13-5l6,6-4d2,8-6r3

;59
   ###
   #+#####
   #.  $ #
   #.#$# # ############
   #.#   # #        .##
   #.## ## #  $. $. $.#
   #.## ## ## #########
   #.## ##  # #
####.## ##  # #
#  $ $ $ #  # #
#      # #  # #
# $$#$## #### #
#        $    #
############  #
           ####
Solution: 4-9l1,6-9l1,8-9l1,8-2l3,5-9r1,3-9r1,4-3u1,6-9l1d1l1u6,8-9l3d1l1u5,6-4u1,7-2l2,1-9r2d1r1u4,5-12u2r1u1l1d1l1u3,3-12u2l1u1r1d1r1u2d1l1d3l1u2l1u1r2d1u1d1r1u1d1r1d2r7d1r1u8r1l2u1r4d1r1l1u1r3d1r1

;60
   #######
   #     ######
   # ##     $@#
   #     # $ $##
   ##....###$  #
###########    ####
#.  ...       ##  #######
## .  ######### $ $     #
 # .    $   $ $       $ #
 # # ####      ##########
 #   #  ########
 #####
Solution: l5u1l1d2r1d1l2,13-2d2r1d1l1u1d2l2u1r1u2r1u1l5u1l1d2r1d1l1,14-5l1d1l1u3r1u1l5,7-1d1,6-3r1u1r1d1,10-3r1,12-4u1r1u1l5u1l1d2,7-8r2d1r2u1l8r1d2l2u3r1u1l1,13-8l8,4-9u2l1u1r2,13-8r4,16-6d1r1d1l12,4-9u2l1u1r1,17-7r2d1l14,4-9u1r1u1l1,23-8l18,4-9u2,21-7l4u1l1d1,17-8l13

;61
  ########
 ##      #
##  ## #$###
#  $#. $ ..#
# $ $. #####
##@$#..#
 #  ####
 ####
Solution: u1r3,6-3r3,8-1d1,7-3r1,6-5u2,2-2d1,1-4r3,5-3d1,3-6u1,2-4r3,6-3d1,6-1d1,7-3l1,3-2d1,2-4r2

;62
#######
#@ .  # ########
# .$.$# #  #   #
#.$#$ # # $$$$ #
# .#..# #  # # #
#$$ $ ### *. # #
#.         .  .#
################
Solution: 4-2d1,5-5l1,1-6u2,2-4u2r1,5-1d2,1-1r1,2-6u3,4-5l1,2-6u1,10-4d1,11-6l9,10-2d2,9-5r1,12-2d1l1,10-2d1,12-3d2,13-6l1,12-3r1,14-2d3,10-3d1

;63
################
#   .    # $ ..#
# ##$.$$$#@#*.##
# # $ .$ # $..#
# #   $* # .*.#
# ###$ $.* *###
#           #
#############
Solution: 10-1r3,13-4l1,10-3r2,13-4u1,12-3u1,11-1r1,10-4r2,11-6u2,10-3r2,8-5r2,11-6u2,10-3r1,12-4u1,6-5r4,11-6u1,10-4r1,8-1d3,7-5r3,11-6u2,10-3r1,6-3r1d1,6-5r4,11-6u1,8-2d2,7-5r3,5-4r2,8-3d1,7-5r1,3-3r1u1,5-4u1,5-6u1,4-4r3,8-3d1,7-1d2,6-1d1

;64
########
#      ##
#.*.*.  ########
#***** $ $ $ $ #
#.*.*.@#.#.#.#.#
#***** $ $ $ $ #
######    $  $ #
     #####     #
         #######
Solution: u3l5d2u2r2d2l1r1u1l1r1u1r2d2l2r2u1l2,8-3l4,9-6r1,10-3l5,12-3l6,14-3l7,6-4u1r1u1l3,8-5l1d1l1u3,7-2l2,10-5l3d1l1u3r1u1l1,12-4d1r1l4d1l1u1r2d2r2u1l1d1l1u2d2r4u1l1d1l1u2d1r2u1

;65
                 ######
                 #    #
##################$ $$#######
#                    .#...*.#
# *$####$ $ $ $ $####.##....#
#   $  #  ####   $ ##......##
# *    # $#  ### $ ####* .$.#
# $$####  #$ $ $   $ $ .....#
# *    $$ # $   #$     ##$###
# *#     $     ##  $###..  .#
########.    ######  @     .#
       #######    ###########
Solution: 25-9u3,27-3l3,26-7u3,25-3r1,25-6u2,26-3l1,20-7r6,19-10u1,17-7r7,25-6d2,24-9r2,19-9u1,18-7r6,25-6d3,24-10r2,1-8r3,14-7r10,25-6d2,26-9l2,17-9u1,16-7r8,25-6d2,26-9l1,16-3d3,15-7r9,25-8u1,24-6r2,18-5l1d1,16-7r8,25-8u4,16-4d2,15-7r9,25-8u3,24-4r2,11-8r1,12-7r12,25-8u3,24-4r1,26-5u1,23-7u1,24-5l1,13-9u1,12-7r12,25-8u3,26-4l1,11-6d2,10-9r1,12-10u2,11-7r13,25-8u3,13-4r2,16-3d3,15-7r9,25-8u2,24-5r1,26-6u1,18-1d1,21-5r2,17-3r2,21-1d3,19-3r1,21-2d1,19-2r1,21-1d1,25-5l2,8-9r3,12-10u2,11-7r13,25-8u1,26-6l2,11-4r4,16-3d3,15-7r9,25-8u2,26-5l2,9-4r6,16-3d3,15-7r9,25-8u2,26-5l1,9-5d3,8-9r3,12-10u2,11-7r13,25-8u1,24-6r1,26-7u1,8-7d1,7-9r4,12-10u2,11-7r13,25-8u2,6-8r2,9-7d1,8-9r3,12-10u2,11-7r13,25-8u1,4-8r4,9-7d1,8-9r3,12-10u2,11-7r14,3-6d1,2-8r6,9-7d1,8-9r3,12-10u2,11-7r13,3-3d4,2-8r6,9-7d1,8-9r3,12-10u2,11-7r12,5-5l1,3-3d4,2-8r6,9-7d1,8-9r3,12-10u2,11-7r11,1-6r1d1,4-6l1,8-3d6

;66
       #####
########   ##
#  $.# $  $#####
# $  $  # .....#
# #$    #$######
#   $###.. #.###
####  @    $.$ #
   ########    #
          ######
Solution: 10-6r1,12-7u1,14-6l1,4-6u1,2-2r1,4-3r2,6-2r2,10-1d1,8-2r1,9-3r4,9-3d1,10-5l1,7-4u1,6-2r2,9-1d3,10-1d1,9-3r3,4-5u1,3-3r3,7-4u1,6-2r3,10-1d1,9-3r2,1-3r5,7-4u1,6-2r3,10-1d1,9-3r1,3-5u1,2-3r4,7-4u1,6-2r3,10-1d1

;67
###############
#       *     #
# $*# #...# $ #
### $.....# ######
  #. #$# $#$ $ $ #
  #     .       .#
  ##$##### $ #@###
  #    $   ####
  #   #######
  #####
Solution: 3-3r2,5-3r2,8-4u1,9-2l1,3-1d2,8-7l3,3-7r1u3,3-3r1,11-3d1,12-5l4,14-4l2,16-4l3,11-3d1,10-5r5,13-4l1,11-3d1,10-5r2,6-3l1,7-1r2,9-5u2,3-3r4,8-2d1,6-7l1,4-8u3,3-5u2,8-5u2,4-5u1,3-3r5,8-5l3,4-6u2,3-3r4,12-6l1,10-7u1,11-5l6,4-6u2,3-3r3,14-5l9,4-6u1,4-3d3,13-2l1,11-1d3,12-5l7,3-7r1,4-6u1,9-1r2,4-3d1,3-5r4,6-7l1,4-8u4,3-3r1,6-5u1,3-1d2,1-2r1,13-1l4

;68
###########################
# @                     #.#
# $###################### #
#  #                      #
#  #  ##################  #
#  #  #                ####
# $   #
##.#  #
#######
Solution: l1d5r1l1u5r1d5r2d1r1u3l1u1r20d1r1u2

;69
################
#.         .   #
# $$###*$$$#####
#   #@..$ $ . ##
# $$# $    .$ ##
#   ####$*$#####
# $ ...*    ...#
#** $..  $ #####
########$  #
       #  $#######
       # $ ......#
       ##  *######
       ###  $ #
       ####   #
       ########
Solution: 8-4d2l1,8-10r7,11-12u1l1u1r4,13-12l1d1l1u1,10-8d1l1d1r4,10-4d5l1d1r3,9-6d3l1d1r3,7-7r2u1r1d3l1d1r1,9-4d1l1d1r5,9-1d4l1d1r4,11-3l1u1l1u1r1l1d4l1d1r3,13-4l1,7-3r4,5-4r3u1r1d1,8-1d1r1d1l2,8-9u5r1u1l1,5-6r2,3-7r1,8-5d1,9-7l2,1-6r5,3-3d2l1d1r3,3-1d4l1d1r2,2-3u1r1u1l1d4l1d1r2

;70
####
#. #
#.$#
#. #
#.$##
#   ########
# $$   $ **#
#.   #   ###
##@#######
 ###
Solution: 3-5d1,4-7l2,1-6r1,2-3d1,2-1d2,4-6l1,3-5l1,2-7u1,1-6u4,3-5l1,1-6u3,2-3d1,3-5l1,1-6u2,8-6l5,2-7u1,3-5l1,1-6u1

;71
 #######
##  #  ##
#  $@$  #
# #$#$# #
# #...# #
# $.*.# #
# #.*.# #
#   $   #
## #$# ##
 #    $.#
 ########
Solution: r1d2l2d3l1d2r4u2l1u1d1r1d2l4u2r1u1r1u1l1d2r1l2d2r2u3d3r2u2l1r1d2l2u2l1r4u5l1u1l1d2u1r2d5l6u5r2d3u3l2d3r1l1d2r6u5l3,3-1d2

;72
##########
#  ..#   ###
# #... $$  #
# #..#  ## ###
# ## # $## $.#
#  $$# $ # ###
#### $   # #
   # @ #   #
   #########
Solution: l1u4,5-2l1u1l1,2-5r1,4-6u3l1u1,5-2l1u1l1d1,1-1r1,8-5l1,7-3d1,7-1d1,10-4r1,9-2l5,7-4u1,8-2l2,6-6l1d1l1u5,7-4d1r1d1l3d1l1u4,6-4d1r1d1l2d1l1u3

;73
    #######
    #     #
    # ## $####
  ### #   $  #
###.# $ $$   #
#  .#$$$  #  #
#... @ #  # ##
#...#$###   #
#...  $  $###
####### $  .#
      #######
Solution: 5-8r2,7-9r3,9-9u3,8-5u1r2,9-3r1,7-3r1,5-4r1,6-6u1,5-4d1,6-6l2,3-7u2,5-8u1,6-6l2,3-7u1,8-5l2,5-4d1,6-6l2,4-6l1,2-5d1,1-7r1,7-3d1l1,5-3d2,6-6l3,2-5d1,8-5l2,5-4d1,6-6l4,1-5d1,9-8l7,12-4l6,5-3d4,6-8l3,9-6u1,10-4l4,5-3d4,6-8l2,10-3l1,8-2d2,9-5l3,5-4d1,6-6l4,9-1d2,10-4l4,5-3d2,6-6l3,12-3l3,8-2d2,9-5l3,5-4d1,6-6l2

;74
        #####
#########@  ##
#      $   $ #
# $###$ .##$ #
# ...#....#  #
# # ### ###$ #
# # $   $    #
#    ##   ####
###########
Solution: 5-6l1d1l1u2,2-4r1,2-2d1,9-6l5d1l1u2,6-2d1,11-4d1r1d1l4d1l1u3,8-2l2d1r1u1r1d1l1d1r1,12-2l1d3r1d1l4d1l1u3,6-3r1u1r1d1u1r2u1r1d4r1d1l4d1l1u3,6-3r1,4-2r6u1r1d4r1d1l4d1l1u2

;75
###############
#...#         #
#...# $ $#### #
#.$ .#$  #@ # #
# $$ #  $   # #
###  #####    #
# ...$.#.#$ ############
#*#   $  $  $ $ $   $  #
#####  $          $   *#
#...#  #################
#...#  $  $  $   *#
##..##   #   #   ##
##..## ############
# $$ $ $ #
#        #
## .######
 ####
Solution: 7-7l1,6-6l3u4,1-4r1u2,3-5u1,4-3l2,1-4u2,5-8u1,6-6l2,3-7u3,4-3l2,1-4u1,10-7l4,5-8u1,6-6l2,3-7u3,4-3l1,2-4u1,8-8l2,5-9u2,6-6l2,3-7u3,4-3l2,10-5d1,11-7l5,5-8u1,6-6l2,3-7u4,7-4r2,10-3d3,11-7l5,5-8u1,6-6l1,4-7u3,8-1d2,7-4r2,10-3d3,11-7l5,5-8u1,6-6l2,5-2r2,8-1d2,7-4r2,10-3d3,11-7l5,5-8u1,6-6l1,6-4u1,5-2r2,8-1d2,7-4r2,10-3d3,11-7l4,6-8u1,13-7l4,8-8u1,2-14u3,3-10l1,4-13l1,2-14u4,3-9l1,6-13l2,3-14u4,8-13l5,2-14u4,15-7l4,10-6d1,11-8l4,6-7d6,7-14l3,3-15u4,17-7l6,10-6d1,11-8l4,6-7d6,7-14l4,2-15u4,21-7l10,10-6d1,11-8l4,6-7d6,7-14l3,3-15u3,19-8l12,6-7d6,7-14l4,2-15u3,8-10l1,6-11u1,6-7d6,7-14l3,3-15u2,9-10r1,12-10l5,6-11u1,6-8d5,7-14l4,2-15u2,12-10r2,16-10l9,6-11u1,6-8d5,7-14l3,3-13d1

;76
#########################
#. .##  ##....#         #
#.....*... $### $$#$$$ $#
#..$.# ..#  ### $  $@$$ ##
#..$.# $.# $###          #
#....#$#$#  ### $$###$$$ #
#..# $ $ $ $$ $ $ $ $  $ #
#.##$$ $ $           #  ##
#...     ..#########.  ###
############       #######
Solution: 11-3u1l1u1r2,11-5u3l1u1r1,11-7u5,13-6l2d1l1u5,7-2l4u1l1d4,4-3l1d1r1d1l1,2-2d1,8-6u3,9-2l1d1l2u2r1d1,6-4r1,8-5u1,10-7l1d1l1u3,6-6u3,7-2l3d1l2u2r1d3,4-8u5,5-2l1,3-1d1,8-6r1d1r1u4,11-2l9u1l1d5,6-6l1,4-7u4,5-2l3u1l1d4,5-6d1r1d1l4,8-6l1d1r1d1l5,7-6l2d1l1u4,5-2l2u1d1l1u1l1d3,15-6l4d1l1u4r1u1l9u1l1d2,17-6l6d1l1r1u1l1,19-6l8d1l1u4r1u1l9u1l1d1r3d2l1u1r1u1l1d1l1u1r1u1l1,21-6l10d1l1u4r1u1l7d1u1l1u1l1d1,24-6l13d1l1u4r1u1l9,21-4r2d1r1d1l13d1l1u4r1u1l8,21-4r1d1r1d1l12d1l1u4r1u1l7d1l1u1,21-4d1r1d1l11d1l1u4r1u1l7,17-4d2r1d1l13u1l1d1r1d1l1,22-2d3r1d1l12d1l1u4r1u1l6,23-1d4r1d1l13d1l1u4r1u1l5,20-3r2u1r1d3r1d1l13d1l1u4r1u1l4,16-4d2r1d1l12d1l1u4,17-1d5r1d1l13d1l1u3,17-2l1d4r1d1l12d1l1u2,15-1d4r1d1l5d1l1u4r1u1l3,20-3l4u1l1d3r1d1l5d1l1u4r1u1l2r1d5l2u1r1d1r1u4r1u1l1,21-1d4r1d1l11u1l1d1r1d1l1u1l1d1,19-1d1r1l1d1r1d1l4u1l1d3r1d1l5u1l1d1,21-1d2r1d1l4u1l1d3l1d1r3u1r1d1

