;1
###############
#       # @#  #
# $ #$$$$$$$$ #
# ..$........ #
######### #  ##
        #    #
        ######
Solution: l1d2r4u2l1d2l3u2r1d1r1d1r2u2,5-3l2,9-5u2r1u1r1d1,13-2l1,12-5u2,5-1r1d1,5-3r5,9-1d1r1d1l5,7-1d1r1,3-3r2,5-1d1,1-2r1u1r1d1,9-1d1r1d1l1,12-3l1,11-5u1,12-1d1l2u1l1d1

;2
 ####
 #  ######
## $$ ##.#
#   $ # .#
#  $...*.#
# $$ .#$$#
#     #@.#
##########
Solution: r1u3d1l3u1l1d1l1r1u1l1r1d1r4d2l1u1r1u1l3u1l2d1r4u1r1d2u1l3d2l4u2r6d1r1u1l3d2l3u1l1u1r6l6u1r2l1u2r1d2l1d1r4l1d2l2u1l1u1r3l2d1r1u1r1u2l1d1l1d1r1l2u3r1d2l1d1r1

;3
             ######
           ###    #
           #    # #
   ####### # # ...####
   #     ###   ####  #
   # $ $$ ###  #     ##
   ###   $ ## ##  #.. #
     # #$   # ### #.. #
######  $ $## #@# ....#
#      # $ $      #####
# #$          ##  #
# # $##############
#    #
######
Solution: d1l2d1l3u1r2d1r1u5r1u3l2d2r1d1r1u2d1l2u2r2u1r1d1l1d1r2,8-9r4d1r1u5r1u3l2d2r1d1r1u2d1l2u2r2u1r1d1l1d1r1,10-7d1l1d1r3d1r1u5r1u3l2d2r1d1r1u2d1l2u2r2u1r1d1,3-11u1d2l2u3r3,7-8r2u1r1d1l1d1r7d1r1u4l1u1r3u1r1d2r1d1l1d1l1u1,8-6d1,7-8r2u1r1d1l1d1r7d1r1u4l1u1r3u1r1d2r1d1u1l1r1d2l2u2d2r2u2l2d2l2u3r2d1r1d1r1d1l2u4r1d1,17-8r2,21-6l1,21-8l2,8-4d1r1d3l1d1r8d1r1u4l1u1r3u1r1d2r1d2u2l1r1d2l2u1,17-8r1,17-8r3,19-5d2,21-7l1d1l1u1,19-5d2,7-6r1u1r1d3l1d1r8d1r1u4l1u1r3u1r1d1,21-6l1,7-4d1l1d1r2u1r1d3l1d1r8d1r1u4l1u1r3u1r1d2r1d1l1,4-5r3u1r1d1l1d1r1u1r1d3l1d1r8d1r1u4l1u1r3u1r1d3,4-9r1,6-10u4,5-5r2u1r1d1l1d1r1u1r1d3l1d1r8d1r1u4l1u1r3u1r1d2,4-12u2l1u1r2d1r1u4r1u2l2d1r1u1r1d1l1d1r2u1r1d3l1d1r8d1r1u4l1u1r3u1r1d1

;4
  ##########
###        #
#   ## ##$ #
# ##....#  #
#   ....#$ #
## #.  ##  #
 # ###### ##
 #$#      @#
 # # $$$$$ #
 #    $    #
 #  ########
 ####
Solution: 2-8u3,1-4r3d1r1u1l1u1r2,7-9l4d1l1u5,1-4r3d1r1u1r1u1l1,9-7d1r1d1l7d1l1u5,1-4r4d1r1u2,8-7d1r1d1l6d1l1u5,1-4r3d1r2u2l1d1r1d1l1,6-1d2l1d1r1,7-7d1r1d1l5d1l1u5,1-4r3,5-5u1,6-7d1r1d1l4d1l1u5,1-4r4d1r1u1,5-7d1r1d1l3d1l1u5,1-4r4,9-3d5r1d1l7d1l1u5,1-4r3,9-1d7r1d1l7d1l1u5,1-4r2

;5
###########
#         #
# *..#.*#.#
## ..#..$.#
 # *$$$ #@####
 # # #  #  $ #
 #   # $$$ $ #
 #####  #    #
     #########
Solution: 4-5u2,1-2r1u1r1d1,4-4l1,2-5u2r1,1-2r1u1r1d1,6-5u1l2,6-2d1,5-4r1,4-4l1,2-5u2,1-2r1,9-3l2,7-5u1l1u1r1,6-1d2r1d1l4,2-5u2,7-7u1,9-7u1l2d1l1u2,9-6u3l2d1l3,6-4u1,7-6u2,12-5l2d1l1u2,12-6l5d1l1u3

;6
          ####
########### @#
#    $ $   $$##
#.**.*.*$**...#
#  $         ##
###########  #
          ####
Solution: d2l1d2r1u1l1u1r1d1l8u2l3d2r10l8u1r1u1l1d2r3u1l1r1u1l1d2r6u1r1u2l1d1l4r1d1l1r1u1r2d1l1u1r3d1l1d2r1u2l1u1l2d2r1u1r2d2l1u1r1u1l1d1l2u1d1r2u3r1d2l1d1l2u2d1r1d1r1u1l2u1l2d1r2l2r2d1r2u1l2u1l2d2r2u1r3u2l1d1l2r3d1l1d2r1u2l1u1l2d2r1l1u2r2d1r1d2l1u1l2u2r2u1r1d2u1l3d2r2l1u1d1r1u1r1u2l1d1r1d1l1d1l2u2r1l1d2l2u2r2d2l4u2r2d2l4u2r2d2l4u2r2d1l1d1r3u1l2d1r4u1l2d1r4u1l2d1r4u1l2d1r1u1r2u2l1d1r1d1l1d1l2u2r1l1d2l2u2r2d2l4u2r2d2l4u2r2d1l1d1r3u1l2d1r4u1l2d1r4u1l2d1r1u1r2u2l1d1r1d1l1d1l2u2r1l1d2l2u2r2d2l4u2r2d1l1d1r3u1l2d1r4u1l2r3u2l1d1r1d1l1d1l2u2r1l1d2l2u2r2d1l1d1r3u1l1r2u2l1d1r1d1l1d2r1l1u1l3u2r2l2d2r3u1r1u2l1d1l3d2r3d1r1u1

;7
       ######
      ##   @#
 ###### $$ ##
 # $ $ $   #
## #..$  ###
#...*.# ##
##$#.*# #
 #      #
 ########
Solution: l1d2l2d1l1d3l2u2l1d1u1l2r2d2r3l3u4r1d1l1d3r3u3l2u1d1r3u1r2u2l2d1l1d2r1u1d1l3u1r1l1d2l3u2r3l1d1r1d1l1d2l2u1d1r2u3r4u1r2u2l2d1l1d1u1d1r1d1l3d1l1d2r3u3r1u2l1d1r1d1l1d3l3u2r1u2r1l2r1d2l1d2r3u3l1u1l1d1u1l1d2u1r4u2l1d1r1d1l3u1l1d1r4u3r2d2l2u1l1d1r1d1l3r3u1r2u2l1d1r1d1l2u1l1d1r1d1l2

;8
###########
#         #
# $#.##$# #
#  #.$+.# #
# $#.#... #
#  # # ## #
# $  $$ $ #
####   ####
   #####
Solution: 7-1d2l1d1r1,4-3r2,7-2d1,6-7u3,5-3r1,9-6l2,6-7u3,4-6r1d1r1u2,1-6r3d1r2u1l1d1l1u4d3l3u3r1d2l1d1r3d1r2u1l1d1l1u3d2l3u5r1d4l1d1r3d1r2u1l1d1l1u2

;9
 #############
 #@          #
 #$#$$#$$$#$ #
## #  # # #  #
# ..$...# #* #
#  ##. .# #  #
## #.    $   #
 # #  #.# ####
 #        #
 ##########
Solution: d2,10-6l5,2-5u1r2u1r1l1d1r1,2-2d1,4-1d2r1d1l1,7-1d5,7-8u4l1,5-3d1,5-1d2,4-4r1d1,5-7u2,9-1d4,10-6l4,5-7u1,11-3d2r1d1l4,7-5d1,11-1d2,7-2d2,9-2l1u1l1d2

;10
    #####
#####   #
#  ..$  #
# **.  ##
##$. $ #
 #@*$  #
 #    ##
 ######
Solution: 3-2d1,1-3r1,2-5u1,4-6u2,6-2l2,5-5u2r1u1l1

;11
########
#  ..$ #
#  **. #
##$.#$ #
 #@*$  #
 #    ##
 ######
Solution: u2l1u1r1,3-5u1,5-4l1,5-4u1,6-1l1

;12
       ######
       #    #
######## #.##
# $ $@$ $$. #
# #.*.#...* #
# $ $ .$$#. #
#           #
#############
Solution: d3r6u3l1d1u3l2d2l1d1r2,10-3l1,8-2d1l1d1,9-4l1,5-3r3,3-3r2,1-3r2,5-5l1d1l1u1,8-6u1l3,7-3d1,8-5l1,10-3l1d1l1,8-2d1l1d1,5-3r3,3-3r2,3-5r1d1r1u1,8-3d1,10-3l1,8-2d1,5-3r4,7-6u1l2,7-3d1,9-4l1,8-6u1l1,8-3d1,11-4l1u1,8-4r1,8-6u2,7-3r2,5-5r2d1r1u1,7-3d1r1,7-6u1,3-5r4d1r1u1,1-5r4

;13
    ##########
    #.... .#@#
    ####.$ . #
 ########$ $ ##
## $     . $  #
#    $ $  $ * #
# #$ ##..## $ #
# # ..#### $###
# #$***.# $ #
#           #
#############
Solution: d1l3r1d2l1u2r1u1l4,12-3l2d1l1u2r1u1l3,12-4l1d1l1u1r1u1l1d1l1u2r1u1l2,2-4r8d1r1u2r1u1l2d1l1u1r1u1l1,11-8u5r1u1l1d1l1u1,13-6l1,11-7u4,8-5r2,11-6u1,12-4l2,6-5r1u1r1d1,4-5r2u1r1d1,5-9u1r1,3-7u1,3-9u1r2,3-8u1,2-5r1u1r1d3l1d1r1l1u2r1u2l2d1r1u1r1d3,13-5l8u1l1d2,9-8r1d1r1u3r1u2l2d1r1

;14
     ####
     #  ####
     #     #
######*.$ $#
#    #..#  #
# $$ +..# $#
#  $ #..#  #
#   #####  ##
##### # $ $ #
      #     #
      #######
Solution: 10-4d2,10-2d2,7-3d2l3u1l2d1u1r2d1l1r4u3r2d7r2u1l1d1l1u5d2r1d1l1u3r1d2u4l1d2u2l2d1r1u1r2d2l1r1u1d3l1u1r1u2l1d1,7-3r1,6-4u1,1-5r5d1r1u2l1u1r1u2l1d2r1d2l6d2r1u1l1u1r5d1r1u3d2l4r4u2l1d2l4d2r1u1l1u1r4u1r1d1l1u4r1d2u1r3d2l1u1r1u1l3d1r1l2d2r1u1l1u1r1u2l1d3r1d1l1u3r4d2l1u1r1u1l3u1l1d3u2r3d1l1u1l1d2u1r3d3l1u2r1u1l2u1l1d1r2d6r2u1l1d1l1u5r1u1l3u1l1d1r4d4l1d2r2u1l1d1l1u5r1u1l3r2d6l2u1r1d1r1u5r1u1l2

;15
#########
#.     .#
# $.$ *.#
#@$$$ ###
# #.#$#
#   . #
#######
Solution: 5-5u3r1,4-1r2,3-2r2,3-4u2,1-3r1,2-1r1d3,2-5r1,5-3l1u1l1d1,1-2r1,5-1l3

;16
 ######
 #    ####
 #..*    #
 #.##... #
 # $   # #
######$# #
# $ $  @ #
#    $$# #
###      #
  ########
Solution: 6-6u2,7-3l1,2-4r3,5-2l2u1l1d1,6-5u1l1u1r1u1l3,8-3l2d1l1u1r1u1l1,6-8u4l1u1r1,3-2r1u1r1d1,4-7r1d1r1u5,7-2l3,3-6r2,6-7u4,7-2l2,1-6r4d1r1u3

;17
##############
#  #   #  #  #
#@$#.* #   $.#
# $ . $#  #$.#
# $#.$ .$ # .#
#  #   #  #$.#
# $#####.$# .#
#  #   #  #  #
##$#   # .#  #
#  #   #  ####
#  #   #  #
#  #   #. #
####   ####
Solution: d1r3d2r2u1r2u2r3u1r1d5,11-4u1r1u1l3u1l1d9,11-6u2,9-5u2l1u1r3u1r1d3l1d4r1u1,11-4u1r1u1l3u1l1d6r1u4l1u1r3u1r1d2,8-9u2,4-4r4d1r1u2l1u1r3u1r1d1,6-2d1u2l2d3r4u1r1d4,4-3r1,6-2d1l1d1r3d1r1u2l1u1r3,4-2r1u1r1d2l1d1r1l1u1l4u2r1d1l1d1r3d1r2u2l1r1d2l1u1,2-5u1l1u1r3d1r2u1l1r1u2l2d2,2-7u3l1u1r3u2r2d1l1r1d2l1u1l3d6l1d2r1u7l1u1r2

;18
##########
#   ##   #
#..  # $ #
#..# #$$ #
#    @ $ #
##   #   #
 #########
Solution: 8-4l5d1l1u2d1r2u2l2u1l1d1,6-2d1,8-3l1d1l4d1l1u2d1r2u2l2,7-1d2r1d1l5d1l1u2,6-2d1r1d1l4d1l1u1

;19
    #####
   ##   #
####  $ ##
#@ $  #..#
# $$  #..#
#  $  #$.#
###  ##  #
  ####  .#
     #   #
     #####
Solution: r3,7-4d2,6-7r1d1r1u4l1u3l2d1r1u1r1d5r1d2l2u1r1d1r1u3,5-4u1l1u1r2u1r1d5r1d2l2u1r1d1r1u2,2-5u1l1u1r3d1r1u1l1u1r2u1r1d5r1d2l2u1r1,2-5r1u1l1u1r2d1r1u1l1u1r2u1r1d2,4-6u1l1u1r1d1r1u2l1u1r2u1r1d1

;20
      ###
     ##.#
######..#
#@$   ..#
###$$  .#
##   #  #
# $#  ###
#       #
## #$ # #
 #$     #
 #  #   #
 ########
Solution: r4d1r1u1l2d2l2d1l1d1r4l3u2r2d1r1d1l1,2-10u3r2u1r1d2u1l3d2r3u2l1u3d1l2d2r2u4l1d1r1d3r1d2l1u5l1u1r3d1r1u2,2-5r1,4-6u2l1u1r3d1r1u1,7-7l2d1l1u4l1u1r3,7-9l1d1l1u2d1r2u2l2d1l1u4,2-9u1,1-7r2,4-8u3l1u1r3l3u1r2

;21
#########
#+*..   #
#####$  #
  #   $ #
  # $  ##
  #  ###
  #  #
  ####
Solution: r4d2l1d1u1r1u1r2u1l5r5d2l1d1l1u2r1u1l3r2d2l2d1r1l1d2r1u2l1u1r2u1r2d1l1d1l1u2r1u1l2r1d2l2d2r1u1l1u1r1d1r1u2r1u1l1

;22
  ####
  #..####
###..#  #
# ..    #
#     $ #
#   $$ ##
# $  $$#
#####@ #
    ####
Solution: r1u1l1u1l2u2r2d1u1r2d1l3d1l1u3d1r3d2l1d2r1u3r1u1l2d1l1u2d1l1d3r1u3l3d3r1u2r4d3l1u3r1u1l2d1l1u1d2l1d1r2u1r2d2l1u3r1u1l2

;23
 ######
##.   #
#..** #
##  # #
#@$   #
###$$ #
  #   #
  #####
Solution: r1u3r1d1u1r2d1l3d2r1u1l1u2r2d1l1u1l1d1r3d4l2u3,2-2r1,2-4u1,5-5l1d1l1u4,4-1l1,5-4l1d1l1u2

;24
 ########
 #      #
 # #### #
 #      #
 #  ##  #
##$$ # $##
# $ .# $.#
# #..# $ #
# $..# $ #
#  ..# @ #
##########
Solution: 3-4d2,1-8r1,4-8l1,3-6d1,1-6r2,3-7d1,4-9l1,1-8r2u1r1d1,4-5d2,2-4d1,1-6r1u1d1r1u1r1d1,8-8l1d1l1u5r1u1l4,2-2d3,1-6r2,8-7l1d1l1u4r1u1l4,2-2d3,1-6r1,3-7u2,8-6l1d1l1u3r1d1l1d1r1,7-3l4,2-2d3,1-6r1u1r1d2,1-9r1,3-3d3

;25
#####
#   #
#@# #
# # #
# # ###
# $$  ####
# # $$$. #
# # $... #
# # $.#* #
# # $.#. #
#   $.*. #
####   ###
   #####
Solution: 3-6u1,3-10r1d1r1u1r1,3-8r1,5-5d1r1,7-7d1u1l1u1l1u1,4-8d1l1d1r1,5-6l1u1l1d3,8-6l3u1l2d1,1-5r2d1r1d1r2u1r1d1l3u1r2l2,4-9u1l1u1r3,6-10l1d1l1u3l1u1r2,3-8d1,2-10r2d1r2u1l1d1l1u3l1u1r1,3-3d6,2-10r3,5-5l1,3-4d5,2-10r2

;26
##########
#@   #   #
# ## $ # #
# $  ##  #
# # $..*.#
# $ ##.. #
# # ####.#
# $      #
# #$######
#   #
#####
Solution: 7-3d1r1d1l1,3-4r3,7-3d1,1-3r2,4-2d1l1d1r4u1r1d2,6-2l1,4-1d2l1d1r4,3-9u5,2-3r1,4-2d1l1d1r3,1-7r1,3-8u4,1-3r2,4-2d1l1d1r2,1-5r1,3-6u2,2-3r1,4-2d1l1d1r1

;27
    ####
#####  ##
#    @  #
# $##.# #
#  #..*.#
# $.$.# #
## #.$$ #
# $##   #
#  #. ###
# $ $.##
#      #
#### $ #
   ##  #
    ####
Solution: 5-7u3d2l1u1,4-10u1,1-9r1,1-5r1d2,5-6r1d1r1u2,5-12u7,2-9r2d1r1u4,2-7d1l1d1r3d1r1u3r1u1l1,2-2d6l1d1r3

;28
    #########
    #       #
    #$#.#.# #
#####  @#.# #
# $   $   # ##
# $ $ #.# .  #
# #$# #.. .  #
# $ $ #.# # ##
#     $ # # #
#######     #
      #######
Solution: 5-4r3,9-3d2,8-6r2,11-7u1r1u1l1,1-4r7,9-3d2,8-6r2,11-7u1,3-7u2,2-4r6,9-3d2,10-6l1,5-8r1,7-9u1,1-5r1,3-6u1l1u1r4u1r1l1d1r2,9-5u2,5-1d2,4-4r4,9-5u1,7-8u5,11-4d1r1d1l1,1-7r1d1r1u3l1u1r4u1r1d3,5-7l1d1l1u3l1u1r4u1r1d2,3-5r1,5-6u1l1u1r2u1r1d1

;29
   #######
  ##     ##
 ##  $ $  ##
 #  $#.#$  #
##   #.#  $#
#  ###.### ##
#    ..     #
##$###.###  #
 # $ #.# $$##
 #   #.#   #
 ##   +   ##
  ###   ###
    #####
Solution: 10-9u2r1u1l5,4-6r1,6-5d4,8-8r1d1r1u2r1u1l5,4-6r1,6-5d3,2-8u1,1-6r4,6-5d2,4-8l1d1l1u3,2-4d1l1d1r4,6-5d1,10-3d2,11-6l5,4-2r1u1r1d4u4r2d1l1u1l1d3u2r3d2l1u1r1u1l2u1l1d2u2d1l3d2r1u1l1u1r2u1r1d1

;30
###########
#         #
#$******* #
#.*     *.#
# *$$$@$* #
#..     * #
#.******* #
#         #
###########
Solution: 1-1d4,3-3l1,7-3r1,7-5u1l1u1r1d2l5u1d1r4u2l2d1l1u1r3d2l4r2u2r1d1r1d1l3

;31
    ####
##### @#############
# *   $            #
# *********.**.***.#
#        $         #
##$  ###############
 #   #
 #####
Solution: l1d1r6d2r3u2r2d1r1u1l3d1r1l1d1l3u2l7d2u2r8d1r1l1u1r1l9d2r5u1r2l1u1l1,7-2d1r2l2u1l2d1u1r2d1l1r3u1l1d1l2d1r1l1u2l2d2r1l1u2r2l2d2r1u1l1d1l1d2r1u2r1u1r1u2l1d1l2d2r2l2r2u1r1u1l1r1d1r2u1l1d1l2d1l2u1r4l2u2r1d1r1d1l2d1l2u2r2u1r1d1l1d2l1d2l1u2r2u2l1r1l2d2,15-2l9u1l1d1,17-4l2,15-3r1,13-3r2,11-3r2,9-3r2,7-3r2,5-4u1r2,6-2l1,3-3r2,7-3l2,3-2r2u1r1d1,3-6u2,4-2d2,7-3l2,1-2r4u1r1d1,7-4l2,9-4l2,11-4l2,13-4l2,15-4l2u1r1,11-3r2,9-3r2,7-3r2,5-3r2,3-4u1r2u1l2,1-3r2,2-6u2,5-4l1,3-3d1,7-4l2,9-4l2,11-4l2,13-4l2,11-3r1,9-3r2,7-3r2,5-3r2,3-3r2,1-3r2,5-3l2,7-3l2,1-2r4u1r1d1,5-3l1,3-4u1r1u1l1,1-3r2,5-3l2,7-3l2,1-2r4u1r1d1,3-6u2,5-4l2,3-2d2,1-3r1,3-4u1l1u1r1,5-3l2,1-4r1,4-6u2r1u1l1r1u1l2,7-4l1,9-4l1,11-4l1,9-3r1,7-3r1,5-3r1,1-2r3,5-1d1,2-4u1,4-4l1,2-5u1,6-4l2,8-4l2,10-4l2u1r1,6-3r2,4-3r2,1-2r3,5-1d1,2-4u1,4-4l1,2-5u1,6-4l2,8-4l2r1l1u1r1,4-3r2,1-2r3,5-1d1,2-4u1,4-4l1,2-5u1,6-4l2,4-3r1,2-4r1,4-5u1,3-2d1r1,2-5r1u1,4-6u2

;32
       ######
      ##    #
      #  .$ #
     ##.* ###
    ## *  #
##### *  ##
# @# .  ##
# $ *  ##
#  *  ##
# *$ ##
#   ##
#####
Solution: 2-8r1u1r1,2-10r1u1r1u1r1u1,7-5u1,8-2d1r1d1l1,11-2l1,2-8r1u1r1u1r1u1r1u1r1l1d1l1d1l1d1l1d2r1u1r1u1r1u1r1u1r1u1d1l1d1l1d1l1d1l4u2r1d1l1d1r1

;33
#########
#       #
#       #
##@#.#. #
#  #..  #
# $# #. #
#  $$## #
#       #
# $.$#$ #
#  #    #
#########
Solution: 4-7u4,3-2r2u1r1d3,4-9u6,3-2r2u1r1d2r1d1l1,6-9u1,7-7l2,4-8u5,3-2r2u1r1d1,1-8r1l1u2r2d1r1u3d2l3u2r1d1l1d1r2d1r1u2

;34
     ######
     #    #
     #@$ $#
     ###  ###
       #$ $ ##
    ####     #
    #..   #  #
#####$#$ ##$##
#  .# $  ....#
# . . $ ######
#  ######
####
Solution: 7-9l4u1l2d2r1u1l1u1r1d1r5u1r1u3d1l3d2u2r3d2l2d1l3r4u1r1u2l3d2r1d1l1r2u2r1u1l1r2u3d2r2d2u2l3d3r3u3l2u2l1d4u2r3d3l5d1l1u2d1r3u7l2d1r1u1r1d6l1d1r3l2u2r1u1r2u1l2u1l1d4l1d1r2l1u7r1d3r1d1l1u1l1d3l1d1r1

;35
########
#   #  ######
#   $   ##  #
## ##..$##$ #
 #@##...##  #
 # . ##$##$ #
 #$ .## ##  #
 #   $   $  #
 ##. #     ##
  ##########
Solution: 4-7r2d1r2u1l4d1l1r1u3l2u3r3d2r2d2u2l2u3r1d1r1d2u1l1u1l1,4-8l1u1l1u4,8-7l4,7-6u2,1-2r4u1r1d2u1r1d2l1,4-6l1,3-8u1l1u4,7-6u2,1-2r4u1r1d2u1r1d4,8-7l4u1l1r1d2l1u1l1u4,1-2r4u1r1d1,10-7l6u2l2d2r1u1d2r1u1,10-4d2r1d1l7,3-6d1,10-2d4r1d1l3d1l1u3

;36
 ####
##@ #########
# $$$   $ $ #
# # # # # # #
# .....     #
#####   #####
   ######
Solution: r1d1r2d2l4u2r2d1u1l2d2r4u2l1,3-1d1,7-2l2,9-2l2,11-2l2,5-4r4,3-2d1,2-4r3,5-2l1,3-1d1,7-2l2,9-2l2,5-4r2,3-2d1,2-4r3,5-2l1,3-1d1,3-2d1,2-4r1,7-2l4,1-2r1u1r1d1,5-4l2,3-2d1,7-4l2,9-4l3,11-4l4

;37
#########
#       #
# $**$* #
# * $ * #####
# $ # * ##  ##
# * * *   .. #
# *     ##..@#
# *****#######
#       #
#########
Solution: 5-5r5u1r1d1r1d1l1,3-5r7u1r1d1,1-5r9,3-1d3,2-5r7,1-3r1,3-2d2,4-5l1,5-1d3,4-5r1,1-5r2,2-3d1l1u2r1u1r3d2l2

;38
  ##########
  #        #
###.***$** #
#   *  # $ #
# # *$ . * #
#   *  #@* #
###.***$**.#
  #        #
  ##########
Solution: undefined

;39
##############
#@      $ ...##
#  $ $ $ $ ...#
## #$# ####...#
 #   $ ####...#
 #$#$# $ ###..##
 #       # #...#
 ##$#$# ## ##..#
  # $ # ## # . #
  #      # # # #
  ##  $$ # #   #
   ####  # #####
      #$ #
      #  #######
      #$ $ $   #
      #   $    #
      #  #######
      ####
Solution: r7d1r3u1r1d2l1d1r1u1r1d4r1d3l2u2r1l1d2r2u3l1u3l1u2l4u1l2d1r5u1r1d2l1d1r1u1r1d4r1d3l2u2r1l1d2r2u2l1u6l2u1l2d1l2u1l3d1r7u1r1d2l1d1r1u1r1d4,2-2r9u1r1d2l1d1r1u1r1d3,2-6u3,4-4u1,3-2r8u1r1d2l1d1r1u1r1d2,1-2r11,4-6u3,8-5l1d1l1u3,5-2r6u1r1d4,3-2r8u1r1d3,4-4r1,6-5u2,5-2r6u1r1d2l1d1r1u1r1d1,5-8u1,4-6r2,7-7u1r1u1l1d1l1u3,5-2r6u1r1d2l1d1r1,3-8u1,2-6r4,7-7u1r1u1l1d1l1u3,5-2r6u1r1d2,7-11u5r1u1l1d1l1u3,5-2r6u1r1l1r1d1l1d1r1,7-13u7r1u1l1d1l1u3,5-2r1,5-2r6u1r1d1,5-10r1,7-11u5r1u1l1d1l1u3,5-2r6,7-15u9r1u1l1d1l1u3,3-8r1,5-7d2l1d1r2,5-2r5u1r1d2,7-11u5r1u1l1d1l1u3,5-2r5u1r1d1,9-15r1u1l2d1l1u9r1u1l1d1l1u3,5-2r5,6-1r5,10-15r2u1l4d1l1u9r1u1l1d1l1u4l1u1r5,14-15l6d1l1u10r1u1l1d1l1u4l1u1r4

;40
  ####
  # @####
  #   $ #
  #$..# #
  # .   #
###$.$###
#  $. #
#     #
#######
Solution: d6l2u1r1d1r1u3l1d1u1r2u2l2d2r1d2r1u2d3l3u1r1d1r1u1r1u2l2d1u1r2d2l1u1d2l2u1r1d1r1u1r1u2r2u2l3u1l1d4,2-6r1

;41
####
#  #########
#  $       #
# $##### $ #
#  #...# ###
# $$...  @ #
#  #...# # #
# $## $# $ #
#      $ ###
#  ### # #
#### #   #
     #####
Solution: 6-8u2,7-5l2u1l1d1,8-8l1,6-9u3,7-5l1d1l1u1r1u1l1,2-6d1l1r1l1d1r4,6-9u3,7-5l1u1l1d2,2-4d3l1d1r5,8-8l1,6-9u3,7-5l1d1l1u1,5-8u1,2-5r1,2-2d5l1d1r4,6-9u4,3-5r1,4-2l1,2-1d2,10-3l1,8-4u1r1u1l6,2-3d4l1d1r4,6-9u2,4-5r1,2-1d3l1d1r3,10-7l1,8-8u5r1u1l6,2-1d3l1d1r2

;42
        ####
#########  #
#       $$ #
# ###$##$  #
# ....@.  ##
# #$#.#.$ #
#    *#$ ##
####     #
   #######
Solution: 8-6u1r1u1l6,3-6u1,5-2d2,9-1d1l1d1,10-3l1d1l4,8-2d1r1d1l3,6-2r2,9-1d1r1d1l1u1l1d1r1d1l1,7-7u1

;43
###########
#@ #  #   ###
# $#$.. $   #
# .$ .# $ # #
#  .$ #$*$$ #
#. # .# .   #
#. ##########
####
Solution: d3r3l1r1l3u3r1d3r2u1l2d1l1u1d3r1u1l1u1r1u3l1d4u2r4u2l1d1r1d1l3u1l1d2,5-5u2,2-4r1,4-5u1r1u1l2d1l1u1,5-1d3,9-2l4u1l1d1r1l1d1r1d1l2,7-5u2,8-2l3u1l1d1r1d2l2u1r1d1r1u1l4d1r2l2u3r1d1l1d2r2u1r2d1l1u3r1d1,9-3l1,7-4u1r1u1l2,8-3d1,9-5u2,11-4l2,10-2l3

;44
    #####
#####   #
# $   $ #
# #$# ####
# ..* #..#
#   $  +.#
# $### *.#
#  # #$ ##
# $# #  #
#  # #  #
#### #  #
     ####
Solution: l1r1d3u3l4u1l2d1r5d1r1d2l1u2r2u2l1d2u1l4u1l2d1r5d1r1u1,3-2d2l1d1r5d1r1u1l2d3r1u1l1u1r1l1d4r1u3,7-2l1u1l1d3l1d1r3,1-2r4u1r2d1l1u1l1d3,4-5r2,2-4r1l1d1l1d2r1u2l1u1r1l1d5r1u4

;45
   ######
 ###    ###
 #***$$   #
##* . *$* #
# * . # * #
#@* # # . #
# #***#*# #
#         #
###########
Solution: 7-2u1l3d2u2r3d2l2r2u2l1d1u1l2d1r1,7-2l2,7-5u2,8-2l1,9-4l1d1l1,8-2d1,5-2r2,9-2l2,7-5u1,7-2d1,5-2r2,5-7u4r2,9-3l2,7-5u2,8-3d1,5-3r2,7-1d1,9-2l1d1,6-3r1,8-2l1u1l1d1u1l1d4

;46
###############
#             #
#@ *$** *   . #
## $    * *.# #
 # * ** # #   #
 # * * $*. .# #
 # * ** * # * #
 # * $  . * # #
 # * * ***#$ ##
 #            #
 ##############
Solution: 11-9u6,10-2r1,7-6u1r3,4-7r3,6-5d2,7-3d1,6-5r1,7-3r1,9-2d2u1r1,2-3r7,6-9u2,4-1d1,3-3r4

;47
#####
#   ########
# $*$ $  ..#
#  $@$ $$..#
#    $  ...#
##  #####..#
 #$ #   ####
 #  #
 ####
Solution: r1u1r2d1u1l2d1r1d1r2l2u2r3l1r1d2l3u1l2d1r5u1r1d1l1u2l2d1r2l3d1r3l7u1r6l7u2r2d2l1d1r6l5d3l1u2r1u2l2d1r6l4u2r5d1l7u1r1

;48
################
#              #
# *****$**$*** ##
# *  * *  *  *  #
# $  * $ #$  *  #
# * ##@#     ** #
# . #   . ##    #
# #  . . #### . #
###  #   ##### ##
  ##############
Solution: 14-4d2,12-4r1,14-3d1,12-1d2l1d1r1,9-3r2d1r1u1,10-3d1,11-5l2,8-4d1,6-1d5r1d1l2,8-4l1,6-3d3l1d1r1,3-7r1,8-3l1d1l1u1,10-1d1,7-1d1,4-4r2,9-3r1,6-3r1,1-4r3,2-4d1,3-1d2r1d1l1r1,1-3r1,3-4u1l1d1,6-3l3,8-4l1u1d1r1d2l2u2r1u1l1,8-8u1,9-3l1,12-3l1

;49
############
#          ##
# $ $.*.*.  #######
####*######     $ #
  # $ $ $ $   #   #
  #.@. . .  #######
  ############
Solution: 9-4r2,7-4r2,5-4r2,3-4r2,7-2r1,5-2r2,3-2r3l2d2l1d1r2,7-4l2d1l1u2,3-2r2,9-4l4d1l1u2,3-2r1,11-4l6d1r3,4-3d1l1d1r3,8-5r1,6-5r1,13-4l8,4-3d1l1d1r2,17-3l5,11-2d1r1d1l7,4-3d1,1-2r2u1r1d1,5-5l1,7-5l1,9-5l1,11-5l1

;50
     ###
######@########
#             #
# $  #.$$..## #
#  #####.#### #
# $  $.$ $... #
#  ##..#. .#$ #
# $$ $ #$ $.  #
##        #####
 ##########
Solution: 8-2d1l1,8-5u1,7-3r2,6-5r1,8-6u2,7-3r1,2-6u1,2-8u1,8-8u2,11-7l1,9-8u1l1u1r1,12-5d1r1d1l1,8-4d1r3,4-5r6,2-7u1l1u1r8l1d1,4-7r1d1r1u1,2-7r2d1r1u1,1-3r1d1l1d1r6,8-6u1,8-8u1,4-3l1u1l1d1l1d1u1r1d1l1d1r4

