;1
  #####  ####
  #   #  # .#
  # # #### .##
###    $   . #
#   $#####$ @#
#    #   #  ##
######   ####
Solution: 8-3l3,10-5u2,3-3r7,4-5u1,5-3l1,3-2d1,4-4l1,12-3l8,3-2d1,10-1d1,11-3l6,3-3r7,11-4u2,3-5u2,1-4r2,4-5u1,3-3r7,11-4u1,3-1d2,2-4r1,4-5u1,3-3r7

;2
       ######
       #    #
       #  @ #
    #### .###
    #  #$.#
    #  # .#
##### $ $.#
#   #  # .#
#    $$####
#####  #
    #  #
    #  #
    ####
Solution: 8-5u1,8-7u1,7-6l1,5-7u1,6-7d2,6-8l3,5-4d3,6-11u5,5-7d2,6-4d3,8-4d1,9-6l3,5-7u1,8-2d2,6-9u2,5-6r3,9-7u4,8-2r1,1-8r4,6-9u2,5-6r3,9-7u4,5-4d3,6-8l3,8-4d1,9-6l3,5-7u1,1-8r4,6-9u2,5-6r3,9-7u2,5-11u2,6-8l3,1-8r4,6-9u2,5-6r3,9-5d1,5-4d3,6-8l3,1-8r4,6-9u2,5-6r3,9-3d1,9-1d2,11-2l1,9-1d1

;3
  #######
  #  #  #
###$.#$.###
# .  $  $ #
# $  .  . #
###$.@.$###
# .  .  $ #
# $  $  . #
###.$#.$###
  #  #  #
  #######
Solution: 9-6l3,4-7r3,1-7r3,3-4d1,4-6l1,4-9u3,1-4r1,3-3d4,3-1d1,4-3l1,6-3l1,4-4u1,6-1d2,9-3l1,7-4u1,7-4l1,7-6u1,8-4l1,4-7r1,7-7l1,7-9u2,4-7r1,6-6d1,7-7u2,6-3d1r1

;4
    ######
    # #  ##
##### $   ##
##  #  $ $##
# .    #   #
#  # #     #
## ###### ##
#  ##  #######
# .   . #    #
##  ##  # $$@#
###### ### ###
    #  # #  #
    # .   . #
    ##  #  ##
    #########
Solution: 10-8d3r1d1l4d1l1u4r1u1l4d1l1u4l1u1r4u1r2u1r2d1l1d2l2u1l1u2r1d1r2d2l2u1,6-2r1,12-9l1u1l1d3r1d1l4d1l1u4r1u1l4d1l1u4l1u1r4,7-3l1,6-5u1,5-2d1,6-4l3u1l1d4l1d1r4u1r1d4l1d1r4,7-3l1u1l1d1r1d1l3u1l1d4l1d1r4u1r1d4,10-4l1,8-1d1r1d1l2,9-5l1u2d2r1u1l1u1l2u1l1d1r1d1l3u1l1d4l1d1r4,8-1d1r1d1l3u1l1d1r1d1l3u1l1d4,10-4l1d1l1u1r1u1l3u1l1d1r1d1l3

;5
#########
#  ## @ #
#  ## # #
# ..  ..##
#    #.. #
#### #.. ###    ####
   # ####  ### ##  #
   #  ###    ###   #
   # $$ $$  $$ $$  #
   #      #       ##
   #  ##########  #
   ####        ####
Solution: 9-9u1,12-7d1l1d1r5d1r1u2,7-8r3,5-7d1r1d1l1d1l1u6l1u1r2,7-3l4d1l1u1,8-8l3d1l1u5,3-3r2,7-3l4,9-6d1r1d1l5d1l1u5l1u1r3,7-2d1,8-4l1u1,12-8l7d1l1u5l1u1r3l1u2r2d3r1d1l1,14-8l9d1l1u5l1u1r3,7-2d2,17-6d1l1d1l11d1l1u5l1u1r3,7-2d1,18-8l13d1l1u5l1u1r3,16-10u1r1u1l12d1l1u5l1u1r2,1-3r1,2-1d1

;6
 ####
 #  ####
 #   $ #
 # ##$ #
 # ##  #
 # ##$ #
 # @#  #
 # ##$ #
## ##  ##
## ###  #
#  .... #
#   #  ##
#########
Solution: 6-2l3,2-1d8,1-10r1,5-4u1,6-2l3,2-1d7,5-6u2,5-8u2,4-10l1,1-10r4,6-11u3,2-8d1,1-10r1,5-4u1,6-2l3,2-1d7,5-6u2,6-8u2,4-10l1,1-10r4,6-11u3,2-8d1,1-10r1,5-4u1,6-2l3,2-1d7,6-6u2,6-8u2,4-10l1,1-10r4,6-11u3,2-8d1,1-10r1,6-6d3,7-10l2,6-4d5,7-10l1,6-2d7

;7
  #####
###  ########
###   $ $ @ #
# $$#.......#
#   $$ #### #
### #  $    #
###   #######
  #####
Solution: d1l4d2u2r1u1r2d1l4u1r2d1l1d2l1u1r1d1r2l3u1r1u2l3d2r2u1d1l2u2r2l2d2l2u1r1d1r3u2l2d1u1r2d2l2r2u1d3l2u3d1r2u1r6d2l5u1l1u1r4l4d1l2d2r2u1r1u2l1u1l1u1l1d3r2u1r2u1l3r3d1r2u1l2r1d1l3d2r6u3l2d1r1l5d2r1u1l1u1r4l4d1l2u1l2d1r4d2l2u1d1r2u2l2r2u2l1u1l1d3r2u1r2u1l3r3d1r2u1l2d1l2d2r1u1l1u1r3l3d1l2u1l2d1r4d1r1u1l1u1r2l2u1l1u1l1d2u1r2d2l2r3u1r1u1l3r1d2l2u1l2d1r4d1r1u1l1u1r1d2l1d1l2u1d1r2u2l2u1l2d1r3l1d2r2u2r1u2l2u1l1d2l1d1r3d1r1u1

;8
   ######
  ####  ##
 ##  #   #
###   $  #
# .**. ###
# $ @*  ##
###  *  ##
#  #$.###
## #  ##
 ######
Solution: undefined

;9
  #######
 ##  #  ##
##  *$*  ##
#  **.**  #
#  * * *  #
#    @    #
###########
Solution: undefined

;10
#############
#     #     #
# **  @  ** #
# * * * * * #
#   **.**   #
###  *$*  ###
  ##  #  ##
   #######
Solution: undefined

;11
#####
#   #######
#  $      #
## ###### #
 # #    # ####
 # # ## @ $  ##
 # #.   ## $  ##
## #.#   ## $  #
#  #.#   ###   #
#   .##  # #####
##########
Solution: 9-5r1d1r1d1r1d1r2u1l1u1l1u1l4,4-2l1,1-2r1,7-4d2,8-7l1,6-8u1,7-6l1,12-8u1l1u1d1r2u1l1u1l4,4-2l1,1-2r1,7-4d2,8-7l1,11-7u1,12-5l4,4-2l1,1-2r1,7-4d3,6-6l1,4-5d2,7-9u1,6-8u1,8-7l1,7-6l2,4-5d1,6-8u1,7-6l2,4-2l1,2-1d7,1-9r2

;12
   ####
####  ###
#  .    #
# $.$ # ##
### ###  #
  #  ### ###
  ## # $.$ #
   # @  .  #
   ###  ####
     ####
Solution: r1d1u1l2u2l1u3l2d1r1u1r5d2r1d3l4u2l1u2d2r1d2r4u3l1u2l4d3r1d2r6u1l1d1l5u2l1u3r4d2r1d2r1d1l3u1d1r2u3l1u2l4d3r1d2r2u1r1l1d1l2u2l1u3r4d2r1d2u2l1u2l4d1l2u1r2d3r1d2r2u1d1u1r2u2l1u2l2d1l1r1u1r2l3r3d2r1d2l2d2r1u1l1u1r1

;13
######
#  @ ##
#  #  #
#.$#$.#
#  *  #
#.$#$.#
#  #  #
##    #
 ######
Solution: undefined

;14
######
#  @ ##
#  #  #
#.$#$.#
#  #  #
#.$*$.#
#  #  #
#.$#$.#
#  #  #
##    #
 ######
Solution: 4-6d1,4-4d1,2-4u1d1l1d2r1u1r2u1r1d3l1u1r1u1l2,4-9u2,1-5r3u1r1d1,4-7u1,5-5l3,2-8u2l1u1r1,1-3d3,4-5l2,2-3d1,1-6u1r1u2l1d1r1d2l1u2,2-1d3,2-6u3,1-2d2,5-7u3,4-2d3,1-6u3,2-1d2,2-5r2u1r1d1,2-3d1l1d1r2,5-5l3,4-7u1,5-5l1,1-1d1,5-7u1,5-9u1

;15
########
#  ##  ##
#  .$.  #
#  #$#  #
##  *  @#
## #$# ##
#  .$. #
#   #  #
########
Solution: 5-6l2d1l1u4,3-4r2,6-5u1,2-1d1r3l3d3,2-7u4d1r2d1,5-6l2,2-1d1r2d2,2-4u1l1u1r1,2-7u4,4-4d1,3-6r1,2-1d4,1-6r1,7-2l1d1r1d1l2

;16
    ####
#####  #
#  ..  #
#  *.$@##
#  $#$  #
##  #   #
 ########
Solution: 4-3l1,6-3l1,3-5u2,2-2r3,5-3l1,5-5u1r1u1l1,6-1d2,3-2d1r1,3-5u2r1u1l1,6-3l1,1-2r4,2-4u1r1u1r2d1l1u1l1d1,7-4l1d1l1u1r1u1l1,6-1d2,3-3r1u1r2d1l1,1-2r4d1l2,3-5l1u2,3-5u1l1u1r1,5-3l2,1-2r2,2-4u1l1u1r1,7-4l1d1l1u1r1u1l2,6-1d2,7-4l1d1l1u1r1u1l1

;17
   ####
  ##  #
###  @##
# $*$. ##
#  . .  #
## .$*$ #
 ##  #  #
  #######
Solution: 4-6u1l1u1r1u1,4-1d1l1d2r1u1l1u1r1,1-3r1,6-4l2u3r1d1,6-6u1r1u1l1

;18
#########
#      ##
#  *.*  #
# #$*$#@#
#  *.*  #
###   ###
  #   #
  #####
Solution: 4-2l1,4-2d2r1,2-4r1,6-2l1,5-4u1,3-4r1u1r1d1,4-1d1,1-2r2,3-4u1,7-4l4d2r2,1-4r2,5-6u1l1d1l1u1

;19
 #########
###  @  ###
#   ***   #
# $ $.$ $ #
####...####
  ##   ##
   #   #
   #####
Solution: d3,7-3l1,5-2d1,3-3r2,6-5l1u1r1l1u1,5-1d3,7-3l1d1l1u1,5-1d1,1-3r2,5-2l2,4-4u1d1r1,4-6u1d1r1u1,9-3l2,5-2r1d1,8-2l1,3-2r1,1-2r2

;20
  ####
  #  #
  #$ #
  #  #
### ###
#  .. ##
# $*.  #
#  #$ @#
####   #
   #####
Solution: u1l2u1l1u2d2l2d2r1l1u2r4d3l1u1r1u2l4d2r1u1l1u1r2u2r1u2l1d3

;21
 ####
##  #####
#      ##
#  # $$##
## ### ##
##@ . $ #
#  . *# #
# . *   #
###  ####
  ####
Solution: undefined

;22
    #####       ####
    #   ####    #  ##
    #      #    #   ######
    ## $$  #    #        #
   ####  $##    ## .... .#
   #   $$ ##     ##  #. .#
#### ## #  #      #  #.  #
#   $## ## ############ ##
# #    $      @         #
#   #####  ###########$ #
#####   ####         #  #
                     ####
Solution: undefined

;23
########
## @ * #
# * . *#
#  * * #
# * *  #
#* * * #
# *$   #
###  ###
########
Solution: undefined

;24
 #####
##   ####
##$# ####
#  * .  #
# # * . #
#  * * ##
# # * *##
#  * * ##
# $#  @##
##   ####
 #####
Solution: undefined

;25
      #
     # #
    # . #
   #  *  #
  #  $.$  #
 #  $.$.$  #
# .*.$@$.*. #
 #  $.$.$  #
  #  $.$  #
   #  *  #
    # . #
     # #
      #
Solution: undefined

;26
#######
#  .   #
# .$.$# #
#.$ $.$ #
# .$@$. #
# $.$ $.#
# #$.$. #
 #   .  #
  #######
Solution: undefined

;27
##########
#        #
# .$.$.$ #
# $.$.$. #
# .$##.$ #
# $.##$. #
# .$.$.$ #
# $.$.$. #
#@       #
##########
Solution: undefined

;28
   ######
 ### .  ##
##  $ $  #
#  ##.## ##
# $#   #$ #
#. . @ . .#
# $#   #$ #
## ##.##  #
 #  $ $  ##
 ##  . ###
  ######
Solution: undefined

;29
    ######
#####@   #
# .$ .$$.#
# $. $..$#
# $. #   ##
# .$###$. #
##   # .$ #
 #$..$ .$ #
 #.$$. $. #
 #    #####
 ######
Solution: undefined

;30
###########
#   ###   #
# # ### # #
#  $ $ $  #
### ... ###
###$.#.$###
### ... ###
#  $ $ $  #
# # ## ##@#
#   ##    #
###########
Solution: undefined

;31
 #### ####
#    #    #
# #  #  # #
#  **$**  #
#  *. .*  #
 ##$ @ $##
#  *. .*  #
#  **$**  #
# #  #  # #
#    #    #
 #### ####
Solution: undefined

;32
##########
# $.   . #
#.$$. .$$#
# .$$.$$.#
#  .  $. #
# .$@ .  #
#.$$.$$. #
#$$. .$$.#
# .   .$ #
##########
Solution: undefined

;33
    ###
  ##   ##
 # $$$   #
 # .*...$#
#  .# #*$ #
# $. @ .$ #
# $*# #.  #
 #$...*. #
 #   $$$ #
  ##   ##
    ###
Solution: undefined

;34
    #####
    #   #
  ###.$.###
  #  $.$  #
### * * * ###
# .$ * * $. #
# $.* @ *.$ #
# .$ * * $. #
### * * * ###
  #  $.$  #
  ###.$.###
    #   #
    #####
Solution: undefined

;35
#############
#.    .    .#
# ##  #  ## #
# ### $ ### #
#  ##$$$##  #
#   $...$   #
#.#$$.@.$$#.#
#   $...$   #
#  ##$$$##  #
# ### $ ### #
# ##  #  ## #
#.    .    .#
#############
Solution: undefined

;36
        ####
      ###  #
    ### $ $#
##### $ #  #
# $ $.....$##
#   . ##  . #
##$#. $ $#.$##
 #  .# @ #.  #
 ##$.#$ $ .#$##
  # .  ## .   #
  ##$.....$ $ #
   #  # $ #####
   #$ $ ###
   #  ###
   ####
Solution: undefined

;37
##############
#            #
# #####.#### #
# # $ $ $  # #
# #  *.*. $# #
# #$..$ .* # #
# . *   $.$# #
# #$.$   * . #
# # *. $..$# #
# #$ .*.*  # #
# #  $ $ $ # #
# ####.##### #
#           @#
##############
Solution: undefined

;38
 ####   #####
##  #####   #
#     .     #
#  #@#.#   ##
#     .  # #
###   .#   # ######
  ####.#######    #
     #.     #  $$ #
     #.# # $###$  ##
     #.  # $ $ $$  #
     #####         #
         #######   #
               #####
Solution: d2r2d2r4d3r6l6u3d3r7u2l1d1r1u3l1d1u1l2d1r1u1r2d4u4l2d1r1u1r1d3l1u1r1u1l1d2r2d2l2u1d1r1u3l1u2r1d3r1d2l2u3d3r1l1r1u1l2r2l1u2r1d1l1d1l2u1r2l1d1l3u1r2d1l4u1r2l2u2r1d1l1d2r2u1l1d1l1u2r1u1l4r1d2l2u5d1u2d1r2u2l5u1l1d2u1r4d5r5d3r3u1l3d1l1u2r1u1l4r1d2l2u6d1l2u2r5u1r1d2l2d1l2d4u1r5d3r5u1l5d1l1u2r1u1l4r1d2l2u6d1l2u2r5u1r2d1l1u1l1d1l1d3r2u2d2l2u3r1u1r1d2u1l2d2l3d1r1d2r4d2r6d2r2u2l7d1l1u2r1u1l4r1d2l2u6d1r2u2l5u1l1d1r2d1u1l3d2r3l3u2r1d1l1d1r2d1r1u1d1r2d2r4d3r6d1r1u1r1u1l7d1l1u2r1u1l4r1d2l2u6d1r2u2l5u1l1d1r6d3r2u2d2l2u1l5r3d3r5d2r6u3l1d2r1d1l6d1l1u2r1u1l4r1d2l2u5r2u2l2d1u1r2d2l2d1u1l1r3u1r1l1d1l2d1l3u1r1d1r2u1r2u2r1u1r2d1l2d1l1d2r2u2l1u2r2d1l1u1l1d1r1d3l2u1l2u2r3l1r1u1d1l1d2l2d1l2u1r3l1u2r3u1r2d1l1d3l2u1l2u1d4r5d2r7l1u3l3d1r1d1r1d1l5d1l1u1r1u2l5u5l5d2r2l2u2r5d2r2d1r2u3l7r3d2r2u1d1l2u2r3l3d5r5d2l1u1r1u1l4r1d2l2u5r2u2r1u1r1d1l2d2l2d1l3u1l2u2r8l2r1d2l5r5u2l2d1u1r2d2l2d3r5d2r7l1u3l1d2r1d1l6d1l1u1d1u1d1u2r1u1l4r1d2l2u5r2u2l2d6u3l2u1r1d1r1u1d1u1r2u2l2d5u5l5d2r4d1r1u1r2u2l2d4u4l4d1l1d1r4d1r1u1d1u1r2u2l2d3u3r3u1r2d1l8u1l1d2l1d1r4d1r1u1d1u1r2d1r2u2d2l2u3r1u1r2d1l8u1l1d2l1d1r4l3u2r2d2l1d1r2l1u3r4d1r1l1d2r2u2l1u2r2d1l4

;39
       ########
     ###      #
######   $$   #
#         #####
# $$ $$$$ #
#  $$   ###
### ## ##
  #    #
  # #####
  # $ $ #
  #.#.  #
  #.#.###
  #.#.#
  #.#.#
 ##.#.#
 # .#.#
 #  @ #
 ###  #
   ####
Solution: 5-5u1,2-3d1,4-3r2,2-4r1,3-6u2,4-3l1,8-3l3,7-5u1,9-4l1,9-1d1r2,9-4u1,8-2r1,6-3r2,9-4u1,6-5u1r1,5-3r1,7-2d1,3-3r3,3-5r2,6-6u1,1-3r2,5-3l2,3-4r1,5-9l1,3-10u5,7-9l3,3-10u3,3-5d10,2-16r2,5-17u6,3-3d12,2-16r2,5-17u5,1-5r1,3-4d11,2-16r2,5-17u4,8-3l2d2,6-4l2,3-3d12,2-16r2,5-17u3,7-5u1,9-4l5,3-3d12,2-16r2,5-17u2,6-7u1,7-5l3,3-4d11,2-16r2,5-17u1,7-2d1,8-4l4,3-3d11,4-3r1,6-2d2,7-5l3,3-4d9,1-3r4,6-2d2,7-5l3,3-4d8,9-1d1,11-2l2,8-1d1,9-4u1l2,6-2d2,7-5l3,3-4d7,10-2l1,8-1d2,9-4l5,3-3d7,13-2l4,8-1d2,9-4l5,3-3d6

;40
###############################
#      #   #   #   #   #      #
# $@$$ # $     # $     # .....#
## ## ### ### ### ### ### ### ####
 # #       #       #       #     #
 # #   #   #   #   #   #   #   # #
 # ############################# #
 #                               #
 #################################
Solution: undefined

;41
                ####
    #####      ##  #####
    #   ##### ##  .  . #
##### # ##  ###  . # # #
# $ $ $ $ $ ##  . ## $ #
# # ##.. ...#  . ## $$ ###
#      ## * # . ###  $$  #
##########+$$.  # #      #
         # $.$# # ########
         #  #   #
         ########
Solution: undefined

;42
  ####
  #  #
  #$ #
###  #####
#   $$ $ #
# ..... @#
## $.$#  #
###$. ####
  # .$#
  #   #
  #####
Solution: undefined

;43
  ####
  #  #
  #$ #
###  ###
#   $$ #
# .... #####
## $* $$ $ #
###$....  @#
  # .$.$#  #
  ###$. ####
    # .$#
    #   #
    #####
Solution: undefined

;44
 #####
 #   #
 #$# #
 #   #
##$# ####
#  * .  #
# # * . #
#  * * ##
###   @##
  ######
Solution: undefined

;45
 #####
 #   #
 #$# #
 #   #
##$# ####
#  * .  #
# # * . #
#  * * ##
### * @#
  ## * #
   ##  #
    ####
Solution: undefined

;46
 #####
 #   #
 #$# #
 #   #
##$# #####
#  * .   #
# # * .  #
#  * *  ##
### * * #
  ## * @#
   ## * #
    ##  #
     ####
Solution: undefined

;47
#################
###           ###
###.$.$.$.$.$.###
# .$.$.$.$.$.$. #
# $.$.$.$.$.$.$ #
# .$.$.$.$.$.$. #
# $.$.$ $ $.$.$ #
# .$.$ . . $.$. #
# $.$.$ @ $.$.$ #
# .$.$ . . $.$. #
# $.$.$ $ $.$.$ #
# .$.$.$.$.$.$. #
# $.$.$.$.$.$.$ #
# .$.$.$.$.$.$. #
###.$.$.$.$.$.###
###           ###
#################
Solution: undefined

;48
 ###############
###     #     ###
### $.$.#.$.$ ###
#  *.$.$#$.$.*  #
# $.$.$.#.$.$.$ #
# .$. .$ $. .$. #
# $.$.$.$.$.$.$ #
# .$.$.$ $.$.$. #
##### $ @ $ #####
# .$.$.$ $.$.$. #
# $.$.$.$.$.$.$ #
# .$. .$ $. .$. #
# $.$.$.#.$.$.$ #
#  *.$.$#$.$.*  #
### $.$.#.$.$ ###
###     #     ###
 ###############
Solution: undefined

;49
            ####
            #  #
          ### $###
          # $ *  #
        ###  *  $###
        # $*   **  #
      ###  ** **  $###
      # $*  * *  **  #
    ###  **  *  **  $###
    # $*  **...**  **  #
  ###  **  **.**. **  $###
  # $*  **. .$ . **  **  #
###  **  **.#  #.*. **  $###
# $*  ** .*   @ $..*   *   #
#   *   *..$     *. **  *$ #
###$  ** .*.#  #.**  **  ###
  #  **  ** . $. .**  *$ #
  ###$  ** .**.**  **  ###
    #  **  **...**  *$ #
    ###$  **  *  **  ###
      #  **  * *  *$ #
      ###$  ** **  ###
        #  **   *$ #
        ###$  *  ###
          #  * $ #
          ###$ ###
            #  #
            ####
Solution: undefined

;50
                ####
                #  #
              ### $###
              # $ *  #
            ###  *  $###
            # $*   **  #
          ###  ** **  $###
          # $*  * *  **  #
        ###  **  *  **  $###
        # $*  **   **  **  #
      ###  **  ** **  **  $###
      # $*  **  * *  **  **  #
    ###  **  **  *  **  **  $###
    # $*  **  **...**  **  **  #
  ###  **  ** .**.**..**  **  $###
  # $*  **  **...$ ..**  **  **  #
###  **  **  **.#  #.*. **  **  $###
# $*  **  ** .*   @ $..*   *   *   #
#   *   *   *..$     *. **  **  *$ #
###$  **  ** .*.#  #.**  **  **  ###
  #  **  **  **.. $...**  **  *$ #
  ###$  **  **..**.**. **  **  ###
    #  **  **  **...**  **  *$ #
    ###$  **  **  *  **  **  ###
      #  **  **  * *  **  *$ #
      ###$  **  ** **  **  ###
        #  **  **   **  *$ #
        ###$  **  *  **  ###
          #  **  * *  *$ #
          ###$  ** **  ###
            #  **   *$ #
            ###$  *  ###
              #  * $ #
              ###$ ###
                #  #
                ####
Solution: undefined

