;1
 ####
 #  #
 #@ #
 #  ####
### ## #
#    * #
#  $   #
#####. #
 # ## ###
 # *    #
 #   $  #
 # .#####
### ## #
#    * #
#  $   #
#####. #
 # ## ###
 # *    #
 #   $  #
 # .#####
 ####
Solution: r1d3r1d1l1r3u1l2d1l1u1r2d4l1d1r1l3u1r2d1r1u3d2r2d1l2u1l2d4r1d1l1r3u1l2d1l1u1d1r2d3l1d1r1l3u1r2d1r1u3d2r2d1l3r1u3r1u2l1d4r1d1l1u1l3d2r1u1l1u1r3d1l1u1l1d1r4u1l3r1u3l1u1l3d1r3l1u3l1u2r1d4l1d1r1u1r3d2l1u1r1u1l3d1r1u1r1d1l4u1r3l1u4r2d1l1r1u3r1u2l1d4r1d1l1u1l3d2r1u1l1u1r3d1l1u1l1d1r4u1l3r1u4l4d1r3l1u3l1u2r1d4l1d1r1u1r3d2l1u1r1u1l3d1r1u1r1d1l4u1r3

;2
       #######
####   #     #
#  ##### # # #
#     . . . .#
#  #  .#.#.#.#
##  # ## # # #
### #    # # #
#   #   ## # #
#   ###    # #
## $$ #   ##$#
 #    ###    #
 ##  $$ #   ##
  ##    ###@#
 # ##  $$   #
  # ##    $ #
   # #  #####
     ####
Solution: d2l2,12-10u7,7-12d1r3d1r1u3,12-10l2d1l1u2,10-8l2d1l1u2,8-5d1l2d1l1u2,4-4r1,7-15u1l1u1r4d1r1u3,12-10l2d1l1u2,10-8l2d1l1u2,8-6l2d1l1u3,4-3r1,9-14l1,7-15u1l1u1r4d1r1u3,12-10l2d1l1u2,10-8l2d1l1u2,5-3r4,10-4u1,8-6l2d1l1u3,6-3l1,5-10d1l1d1r1,7-11l1d1l1d1r5d1r1u3,12-10l2d1l1u2,10-8l2d1l1u2,8-6l1,5-10d1l1d1r2u1r1d1l1d1r4d1r1u3,12-10l2d1l1u2,10-8l1,3-8d1l1d1r1,5-9l1d1l1d1r1u1r1d1l1d1r2u1r1d1l1d1r4d1r1u3,12-10l1,5-3l1,7-6l1,4-3l1,5-7u3,6-3l1,9-8l1d1l1u2,11-10l1d1l1u2,8-6l1,10-8l1,3-7d2l1d1r2u1r1d2l1d1r2u1r1d1l1d1r4d1r1u3,12-10l1,12-1d2,2-2d1r9,7-6l1d1l1u3,6-3l1,9-8l1d1l1u2,8-6l1,11-10l1d1l1u2,10-8l1,10-1d2,2-5u1l1u2r1d1r6,10-3l1,8-2d1,7-6l1d1l1u3,8-5u2l3,9-8l1d1l1u2,8-6l1,8-1d2,2-5u1l1u2r1d1r7,7-6l1d1l1u3l1u1r3,2-5u1l1u1r4

;3
#############
#@  #   #   #
# # # # # # #
#   #  *$*  #
# #####. .###
#   #  *$.  #
# #$# # #$# #
#  .$*      #
###. .##### #
#  *$*  #   #
# # # # # # #
#       #   #
#############
Solution: d6r2d1r2d1u1l2d1u1r2d1l2r2u1d1r2d2l2u1d1r2u2l2u2r6u2l2u1l2d1l2d4u2d1l2u1r3l5,8-7l3,7-5r2u2,7-4u1,11-5l4,9-7u1,10-5l1,9-1d4,7-3r2,7-1d1,6-3r1,9-3l1,7-7u2r2,11-3l1,9-2d1l1d2r1u1,9-7u2,5-5r2,3-7r1,3-7r2,3-5d1,2-7r1,5-7l1,3-11u2r2,7-7l1,5-6d1,9-5l1,11-5l1,5-9u1,5-11u2,7-9l1,1-9r1

;4
########
###  ###
#  $   #
# $ $  #
#  $ $ #
# $$$$ #  ######
## # ######    ###
##@......... #   ###
###########    #   #
          # #    # #
          #   #    #
          ##    # ##
           # #    #
           #   # ##
           ###   #
             #####
Solution: undefined

;5
        #
       # #
      # . #
     #  $  #
    #  *.*  #
   #  *.$.*  #
  #  *.$ $.*  #
 #  *.$ $ $.*  #
# .$.$ $@$ $.$. #
 #  *.$ $ $.*  #
  #  *.$ $.*  #
   #  *.$.*  #
    #  *.*  #
     #  $  #
      # . #
       # #
        #
Solution: r1u2l1u1d1r1d2l1u1l1u1d1r2d3l1d1u2l1u1l1u1r1d2r1d2l1u1l1u1l1u1l2d2r1d1r1d1r1d1r1d1r2u1l1u2,6-13r1,8-14u1,7-11r1d2,4-10u1,6-10l1d1l1u1,6-12r1u1l1d1l1u1,13-7d1l1d1l1d1l1d1l3u1l1u1r1d2r3u1r1u1r1u2l1u1,5-11r1u1r1d1,9-10l2,6-7d1r1d1l1,8-13u1,9-11l2,14-9l1d1l1d1l4u1r1u1d1r2u1r1l1d2r1u1r1u1r1u2l2d1r1l1d1r1d1l1u1l1d1r1d1l2,9-9r2d1r1u1,11-7d3,11-4d5,12-5d1,7-6r3,7-3r1u1d3,7-6r2,10-3l1,8-4u1,9-8l1u3,10-13u3r1,9-7r1,8-8d3,9-9r2,10-7d1l1d1r1,6-8r3u1r1d1,13-10l1d1l1r1u1l2u1l2d1r2l1u3r1d2

;6
#####  #####
#   #  #   #
# # #### # #
#  $ $ $$  #
###$.... ###
  # .##.$#
  #$.##. #
### ....$###
#  $$ $ $  #
# # ### ##@#
#   # #    #
##### ######
Solution: d1l3u3l4d1u1r1u4l1r1d1r4u1d1l1d6r3u2l2r2d2l3u4r1d1l1d3r3u2,8-4d2l1u1r1u1l2,9-8l1,7-9u3r1d1,8-1d5,6-3r2,4-3r2,6-4l1u1l1d2,1-3r3,3-5u2,3-7u2,3-10u3,5-8l2,7-8l2,9-8l2,8-6d1,10-3l1,8-2d4,6-3r2,7-6u1,9-8l1,7-9u3r1d1,10-3l1,8-2d4,4-3r4d1l2,7-6u1r1u1,9-8l1,7-9u3,8-6d1,10-3l1,8-2d4,3-1d1,2-3r6,3-5u2,3-7u2,4-5d1,6-4l1u1l1d2,8-4l2,7-6u1,9-8l1,7-9u3,8-6d1,10-3l1,8-2d4,3-1d1,2-3r6,3-5u2,1-8r1,3-9u4,5-8l2,6-4l1u1l1d1,8-4l3,7-6u1r1u1l2,9-8l1,7-9u4r1u1l1,8-6d1,9-8l1,7-9u4,5-8r1,7-9u1r1u1l2,1-8r5,7-9u1r1u1l1,10-3l1,8-2d5,9-8l1,7-9u3,3-1d1,2-3r6,10-3l1,8-2d5,9-8l1,7-9u2,3-3d5,3-10u1,2-8r5,9-8l1,7-9u1

;7
     ####
######  #
##  * * #
#  .$.$ #
#   * *@#
#  .$.$ #
##  * * #
 ##  #  #
  #######
Solution: undefined

;8
 #########
 ##    ###
 ## #$.$ #
## .$. #@#
#   * .$ #
#  .$.#$##
## #     #
 #   #   #
 #########
Solution: undefined

;9
  ####
  #  #
### $####
#  .$. ##
# $ . $##
## #$.$ #
#  $. #@#
#  * .  #
# .$.# ##
####   ##
   #####
Solution: undefined

;10
              ####
###############  #
###    $ $ $     #
##    #  @   # # #
# $# ####.#### #$#
#   $ #.....# $  #
##$#  #. . .#  #$#
 #  $  . # .  $  #
 #$#  #. . .#  #$##
 #  $ #.....# $   #
 #$# ####.#### #$ #
 # # #      #    ##
 #     $ $ $    ###
 #  ###############
 ####
Solution: undefined

;11
 #######
 #  *  #
 #  @  #
 ##$#.##
 #  #  #
 # $#. #
 #  #  #
 # $#.##
 #  # #
## ## ##
#  * * #
#   *  #
###   ##
  #####
Solution: undefined

;12
      #
  #########
 ###  .   ##
 # $ *@.$$##
 # $. #$.  #
 # .$ #  * #
##. ## ## .##
 # *  # $. #
 #  .$# .$ #
 ##$$. * $ #
 ##   .  ###
  #########
      #
Solution: undefined

;13
      #####
 ######   #
 #  $ $ # #
 # ..+..# #
###.###.* # ####
#  $### .####  ##
# $  $  $      ###
##   ###.$  # $  #
 ##### #  ###  $ #
       #### #  # #
            ##   #
             #####
Solution: undefined

;14
#####     ######
#   #     #    #
# # ####### ##@#
#  $$ $ $ $ $  #
### . .... .$###
  #$ ######  #
  # .#    #.$#
  #$.# ## #. #
  # .# ## #.$#
  #$.#    #. #
  #  ###### $#
###$. .... . ###
#  $ $ $ $ $$  #
# # ######## # #
#   #      #   #
#####      #####
Solution: undefined

;15
################
#              #
# .$.$.$.$.$.$ #
# $.$.$.$.$.$. #
# .$.$.$.$.$.$ #
# $.$# ## #.$. #
# .$. #  # $.$ #
# $.$# ## #.$. #
# .$.# ## #$.$ #
# $.$ #  # .$. #
# .$.# ## #$.$ #
# $.$.$.$.$.$. #
# .$.$.$.$.$.$ #
# $.$.$.$.$.$. #
#@             #
################
Solution: undefined

;16
 ####
 #@ #####
 #  $ $ #
## #*.. ##
#  .   ###
# $$..$$ #
###   .  #
###$..$###
#  .   ###
# $$..$$ #
###   .  #
## ..*# ##
 # $ $  #
 #####  #
     ####
Solution: undefined

;17
   #####
   #   #
 ### . ###
 ## * * ##
 # * . * #
 #  *$*  #
 # *   * #
 ## * * ##
  ## * ##
####. .####
# $ $.$ $ #
#   ***   #
###  @  ###
 #########
Solution: undefined

;18
 #########
###  @  ###
#   ***   #
# $ $.$ $ #
####. .####
  ## * ##
 ## * * ##
 # *   * #
 #  *$*  #
 # * . * #
 # *   * #
 #  *$*  #
 # * . * #
 ## * * ##
 ### . ###
   #   #
   #####
Solution: undefined

;19
          ####
          #  #
          #  #
          #  #
############ #
##   $ $ $ $$#
# @  $..*.*. #
#   # * .* .$#
#####$.*  .* #
    # *.  *.$#
    #$. *. * #####
    # .*.*..$#   #
    #$$ $ $ $    #
    # ############
    #  #
    #  #
    #  #
    ####
Solution: undefined

;20
    ####
    #  #
    #  #
    #  #
    # ##############
    #$$ $ $ $ $    #
    # .*.* *..$#   #
    #$. *.*. * #####
    # *. *  *.$#
    #$ *   *.* #
    # *.*   * $#
#####$.*  * .* #
#   # * .*.* .$#
# @  $..* *.*. #
##   $ $ $ $ $$#
############## #
            #  #
            #  #
            #  #
            ####
Solution: undefined

;21
###### ######
#    ####   #
#  #   #    #
#  $.* *.$# #
## .$ . $.  #
###*#$*$#*###
#  .$ . $. ##
# #$.* *.$  #
#    #   #  #
#   ####   @#
###### ######
Solution: undefined

;22
 ####
 #  ###
 # $* ###
 #  . $ ###
### # ..$ #######
#   .*# . $ #   #
# # $ .$#$. $ # #
#   # $ . #*.   #
####### $.. #@###
      ### $ .  #
        ### *$ #
          ###  #
            ####
Solution: undefined

;23
################
#  . * . .$    #
#@ $.$. * *.*. #
## $ $  $ $ # ###
 ##### #### #  #
     #   ## ## ##
     ### # * $. #
      #  #      #
     ## ## ######
     # * $. #
     #      #
     ########
Solution: undefined

;24
   #### ####
  ##  ###  #####
###    #   #   #
# $*$.$*$.$*$  #
#  . . . . .  ##
## .$*$.$*$. ##
 ##  # @#   ##
  ####  #####
     ####
Solution: undefined

;25
  ####
  #  #
  #$ #
###  ###
#   $$ #
#  ... ###
## $* $$ #
###$.... ###
  # .$* $$ #
  ###$.... #####
    # .$* $$ $ #
    ###$....  @#
      # .$.$#  #
      ###$. ####
        #  $#
        #   #
        #####
Solution: undefined

;26
  ########
 ## .   @#
## .$.$. #
#  $.$* ##
# $.$* ##
####   #
   #   #
   #####
Solution: undefined

;27
    #####
    #   #
    #   ####
   ## *$.$ #
  ## *$.$  #
  # .$.$. ##
 ## .  .@##
## .$.$. #
#  $.$* ##
# $.$* ##
####   #
   #   #
   #####
Solution: undefined

;28
       #####
       #  ##
      ##$  ##
  ##### .$. #
### . . $.$.#
## .$.$.$$. #
#  $.$*  *$.##
# $.$$ ## .  ###
###  . ## $$.$ #
  ##.$*  *$.$  #
   # .$$.$.$. ##
   #.$.$@. . ###
   # .$. #####
   ##  $##
    ##  #
    #####
Solution: undefined

;29
       ######
       ###  #
       # .. #
       # $$ #
       ### ##
         # #
      #### ####
      ###    ## #####
##### #    * ## #  ##
#   ### ****  ###$.##
# .$     *@*     $. #
##.$###  **** ###   #
##  # ## *    # #####
##### ##    ###
      #### ####
         # #
        ## ###
        # $$ #
        # .. #
        #  ###
        ######
Solution: undefined

;30
        ######
        #  ###
        #    #
        # $$ #
        ##.###
        ## #
##### ### .###
##  # #  .$. ########
## $### .$ $.  ##   #
#  $. .* $@$ *. .$  #
#   ##  .$ $. ###$ ##
######## .$.  # #  ##
       ###. ### #####
         # ##
       ###.##
       # $$ #
       #    #
       ###  #
       ######
Solution: undefined

;31
 ####### ####
 #  #  ###  ###
##.$#  . # .. #
# .$   $ # $$ #
#   ## #### ###
###### . ##   #
 #  # *$*     #
##.$#.$@$.#$.##
#     *$* #  #
#   ## . ######
### #### ##   #
# $$ # $   $. #
# .. # .  #$.##
###  ###  #  #
  #### #######
Solution: undefined

;32
#############
#  .  #  .  #
# $ * # * $ #
####$.#.$####
 ###     ###
 #   ***   #
 # $ $.$ $ #
 ####...####
    # @ #
 ####...####
 # $ $.$ $ #
 #   ***   #
 ###     ###
####$.#.$####
# $ * # * $ #
#  .  #  .  #
#############
Solution: undefined

;33
       #######
       # #  ##
       ###$ ##
       #   $ #
       # #   #
       # # . #########
########  #.###    # #
# ###  ##  .#   ## ###
###   $# ##* # #   $ #
#  $   ...*@ *..  $  #
# $ $  ## # *###   ###
### ###   ##.  #######
##      #  #.# ###
##   ## ####.#   #
##########    # ##
         #    # ##
         ##  $#  #
         ## $    #
         ### $#  #
         # #  ####
         #########
Solution: undefined

;34
  #############
  #     #     #
### ###.#.### ###
# $ $ #.#.# $ $ #
#  $  #.#.#  $  #
# $ $ #.#.# $ $ #
####  #.#.###  ##
   #    #      #
   ###     #####
     ###@###
 #####     ####
 #      #     #
##  ###.#.##  ###
# $ $ #.#.# $ $ #
#  $  #.#.#  $  #
# $ $ #.#.# $ $ #
### ###.#.### ###
  #     #     #
  #############
Solution: undefined

;35
       ###
     ##   ##
   ##   $   ##
  #  $.#*#.$  #
  # #.$ . $.# #
 # $.  # #  .$ #
 # .$ $.*.$ $. #
#  # #.$ $.# #  #
# $*. * @ * .*$ #
#  # #.$ $.# #  #
 # .$ $.*.$ $. #
 # $.  # #  .$ #
  # #.$ . $.# #
  #  $.#*#.$  #
   ##   $   ##
     ##   ##
       ###
Solution: undefined

;36
#############
#.    *    .#
# ##  #  ## #
#  ## $ ### #
#  ##$$$##  #
#   $...$   #
#.#$$.#.$$#.#
#   $...$   #
#.###$@$###.#
#   $...$   #
#.#$$.#.$$#.#
#   $...$   #
#  ##$$$##  #
# ### $ ##  #
# ##  #  ## #
#.    *    .#
#############
Solution: undefined

;37
#################
#    #     #    #
# #  #  #  #  # #
#  $.$.$.$.$.$  #
#  .$.$.$.$.$.  #
###$.$.$.$.$.$###
#  .$.$.$.$.$.  #
#  $.$.$.$.$.$  #
# #.$.$.@.$.$.# #
#  $.$.$.$.$.$  #
#  .$.$.$.$.$.  #
###$.$.$.$.$.$###
#  .$.$.$.$.$.  #
#  $.$.$.$.$.$  #
# #  #  #  #  # #
#    #     #    #
#################
Solution: undefined

;38
# ############# #
  #  #     #  #
###  #  #  #  ###
#  $ *.$ $.* $  #
#   *.$.$.$.*   #
###*.$.$.$.$.*###
#  .$.$.$.$.$.  #
#  $.$.$.$.$.$  #
# # $.$.@.$.$ # #
#  $.$.$.$.$.$  #
#  .$.$.$.$.$.  #
###*.$.$.$.$.*###
#   *.$.$.$.*   #
#  $ *.$ $.* $  #
###  #  #  #  ###
  #  #     #  #
# ############# #
Solution: undefined

;39
##################
#@ . * *. * * .  #
# .$  $ $  $ $ . #
#. **$. **$. **$.#
# $** .$** .$**  #
#*  $ *  $ .  $ *#
# $...$...*$*..$ #
#* $  * $  . $  *#
#  **$. **$. **$.#
#.$** .$** .$**  #
#*  $ .  $ *  $ *#
# $..*$*...$...$ #
#* $  . $  * $  *#
#  **$. **$. **$ #
#.$** .$** .$** .#
# . $ $  $ $  $. #
#  . * * .* * .  #
##################
Solution: undefined

;40
        #####
     #### . ####
     # ##$.$## #
   ####   .   ####
   # ## $$.$$ ## #
 ####  ## . ##  ####
 # ## # #$.$# # ## #
 ##  # #  .  # #  ##
### $## #$.$# ##$ ###
# $ $ $ $...$ $ $ $ #
#.........@.........#
# $ $ $ $...$ $ $ $ #
### $## #$.$# ##$ ###
 ##  # #  .  # #  ##
 # ## # #$.$# # ## #
 ####  ## . ##  ####
   # ## $$.$$ ## #
   ####   .   ####
     # ##$.$## #
     #### . ####
        #####
Solution: undefined

;41
####################
#   . $  ..   $.   #
#  . * $ ..  $.$.  #
# . * * $ $ $.$.$. #
#. * * * *.$.$.$.$.#
# * * * *.*.$.$.$.$#
#$ * * * $ $.$.$.$ #
# $ * $.$.$ * $.$  #
#  $.$ * $.$.$ * $ #
# $.$.$.$ $ * * * $#
#$.$.$.$.*.* * * * #
#.$.$.$.$.* * * * .#
# .$.$.$ $ $ * * . #
#  .$.$  .. $ * .  #
#   .$   ..  $ .  @#
####################
Solution: undefined

;42
#######
#  .  ##
# @ $$ ###
###$...  ##
###. $ $$ #
######$.. #
# ####. $ #
###########
Solution: undefined

;43
       #######
      ##  .  #
    ### $$ @ #
   ##  ...$###
 ### $$ $ .###
##  ...$######
# $$ $ .#### #
# ..$#########
# $ .### # # #
##############
Solution: undefined

;44
########### ###########
# $ .##         ##. $ #
# ..$###### ######$.. #
# $$ $ .#     #. $ $$ #
##  ...$#######$...  ##
#### $$ $ .#. $ $$ ####
# ###  ...$#$...  ### #
# # ### $$   $$ ### # #
# # # ##  . .  ## # # #
       ####@####
# # # ##  . .  ## # # #
# # ### $$   $$ ### # #
# ###  ...$#$...  ### #
#### $$ $ .#. $ $$ ####
##  ...$#######$...  ##
# $$ $ .#     #. $ $$ #
# ..$###### ######$.. #
# $ .##         ##. $ #
########### ###########
Solution: undefined

;45
#############################
#.      .   .   .   .      .#
# ##  # # # # # # # # #  ## #
# ##  $ # $ # $ # $ # $  ## #
#  ##$$$#$$$#$$$#$$$#$$$##  #
#   $...$...$...$...$...$   #
# #$$.#.$.#.$.#.$.#.$.#.$$# #
#   $...$...$...$...$...$   #
#.###$$$#$$$#$@$#$$$#$$$###.#
#   $...$...$...$...$...$   #
# #$$.#.$.#.$.#.$.#.$.#.$$# #
#   $...$...$...$...$...$   #
#  ##$$$#$$$#$$$#$$$#$$$##  #
# ##  $ # $ # $ # $ # $  ## #
# ##  # # # # # # # # #  ## #
#.      .   .   .   .      .#
#############################
Solution: undefined

;46
         ##### # #####
        ## # ##### # ##
        #  #   #   #  #
       ## $* $   $ *$ ##
       #   ..*# #*..   #
       ###*..  #  ..*###
        # $ *$ # $* $ #
  ##### #   # .$. #   #
 ## # #### ###$ $### ###
 #  #   #   # .$. #   #
## $* $   $ *$ # $* $ #
#   ..*# #*..  #  ..*###
###*..  #  ..*# #*..  @#
 # $ *$ # $* $   $ *$ ##
 #   # .$. #   #   #  #
### ###$ $### #### # ##
 #   # .$. #   # #####
 # $ *$ # $* $ #
###*..  #  ..*###
#   ..*# #*..   #
## $* $   $ *$ ##
 #  #   #   #  #
 ## # ##### # ##
  ##### # #####
Solution: undefined

;47
#############################
#.      .   .   .   .      .#
# ##  # # # # # # # # #  ## #
# ##  $ # $ # $ # $ # $  ## #
#  ##$$$#$$$#$$$#$$$#$$$##  #
#   $...$...$...$...$...$   #
# #$$.#.$.#.$.#.$.#.$.#.$$# #
#   $...$...$. .$...$...$   #
#.###$$$#$$$#$$$#$$$#$$$###.#
#   $...$. .$. .$. .$...$   #
# #$$.#.$.#.$.#.$.#.$.#.$$# #
#   $...$. .$. .$. .$...$   #
#.###$$$#$$$#$@$#$$$#$$$###.#
#   $...$. .$. .$. .$...$   #
# #$$.#.$.#.$.#.$.#.$.#.$$# #
#   $...$. .$. .$. .$...$   #
#.###$$$#$$$#$$$#$$$#$$$###.#
#   $...$...$. .$...$...$   #
# #$$.#.$.#.$.#.$.#.$.#.$$# #
#   $...$...$...$...$...$   #
#  ##$$$#$$$#$$$#$$$#$$$##  #
# ##  $ # $ # $ # $ # $  ## #
# ##  # # # # # # # # #  ## #
#.      .   .   .   .      .#
#############################
Solution: undefined

;48
#################################
###                           ###
###.$.$.$.$.$.$.$.$.$.$.$.$.$.###
# . .$.$.$.$.$.$.$.$.$.$.$.$. . #
# $.$.$.$.$.$.$.$.$.$.$.$.$.$.$ #
# .$.$.$.$.$.$.$.$.$.$.$.$.$.$. #
# $.$.$.$.$.$.$.$.$.$.$.$.$.$.$ #
# .$.$.$.$.$.$.$.$.$.$.$.$.$.$. #
# $.$.$.$.$.$.$.$.$.$.$.$.$.$.$ #
# .$.$.$.$.$.$.$.$.$.$.$.$.$.$. #
# $.$.$.$.$.$.$.$.$.$.$.$.$.$.$ #
# .$.$.$.$.$.$.$.$.$.$.$.$.$.$. #
# $.$.$.$.$.$.$.$.$.$.$.$.$.$.$ #
# .$.$.$.$.$.$.$.$.$.$.$.$.$.$. #
# $.$.$.$.$.$.$ $ $.$.$.$.$.$.$ #
# .$.$.$.$.$.$     $.$.$.$.$.$. #
# $.$.$.$.$.$.$ @ $.$.$.$.$.$.$ #
# .$.$.$.$.$.$     $.$.$.$.$.$. #
# $.$.$.$.$.$.$ $ $.$.$.$.$.$.$ #
# .$.$.$.$.$.$.$.$.$.$.$.$.$.$. #
# $.$.$.$.$.$.$.$.$.$.$.$.$.$.$ #
# .$.$.$.$.$.$.$.$.$.$.$.$.$.$. #
# $.$.$.$.$.$.$.$.$.$.$.$.$.$.$ #
# .$.$.$.$.$.$.$.$.$.$.$.$.$.$. #
# $.$.$.$.$.$.$.$.$.$.$.$.$.$.$ #
# .$.$.$.$.$.$.$.$.$.$.$.$.$.$. #
# $.$.$.$.$.$.$.$.$.$.$.$.$.$.$ #
# .$.$.$.$.$.$.$.$.$.$.$.$.$.$. #
# $.$.$.$.$.$.$.$.$.$.$.$.$.$.$ #
# . .$.$.$.$.$.$.$.$.$.$.$.$. . #
###.$.$.$.$.$.$.$.$.$.$.$.$.$.###
###                           ###
#################################
Solution: undefined

;49
###################################
##  #######   #########       #####
##  $ $ ### # ########  ###    #  #
## #*.. ### $.*  # $.$ *### #$.*  #
#  .   #### .$ * #  . . ###  .$ * #
# $$..$$ ###*#$. ###*. $$ ###*#$. #
###   .  #  .$ * ## . .   ## .$ * #
## ..*# ## #$.*  ##$. $.#### $.*  #
#  $ $  ##    #  # $ #$ #### # ## #
# ####  ##   ### #      ####   ## #
# #####    ##### @ ############## #
# ##################      ###     #
# ##  #  #####  #  # # $$ $ $ $$ ##
#    **$ $ #   $*$   ### .# #. ####
## # .$.   # # .$. # ### ..  . ####
## ##.. ## # #$...$# ####.#*#.#####
##   .$. # # # .$. # ### .  .. ####
## $ **$   #   *$*   ### .# #. ####
####  #  #####  #  ### $$ $ $ $$ ##
########       #######    ###    ##
###################################
Solution: undefined

;50
#############################
##  #################  ######
##  $ $ ####  #  #     $ $ ##
## #*.. ##   $*$   ## #*.. ##
#  .   ### # .$. # #  .   ###
# $$..$$ # #$...$# # $$..$$ #
###   .  # # .$. # ###   .  #
## ..*# ##   *$*   ## ..*# ##
## $ $     #  #  ###  $ $  ##
######  ############ ####  ##
####################  #######
###   ##    ##  ##### #######
### # #  ##  #  #####  #  ###
### $.*  ##$.#$.###   $*$   #
### .$ * # $.$ .  # # .$. # #
####*#$. #  .#$.$ # #$...$# #
##  .$.$ ##$.  .$## # .$. # #
## #$.$. ## $*.  ##   *$*   #
##    #  ###   ###  #  #  ###
#######   ##       ##########
######### ###################
#######   ############   ####
####  #  #######    ##   ####
#### $$$ ##   #  ##  $$$$$ ##
####.....##  $*$ ##   . .  ##
##  #$.$##   .$. #####.#.####
##   $. ## ##.  ######*..  ##
## $  .    # . .  ####.#.# ##
#####$.$  ## $*$  ##  . .   #
#####  ####   #   ## $$$$$  #
########### ##########   ####
########@   ##########   ####
#############################
Solution: undefined

