;1
####
#  ########
# $   $ $ #
# $#..... #
#  #..*** #
# $#..... #
#     #   #
##$#.$### #
 # .  #   #
 #$#.$# $ #
 # .  # $ #
 #$#.$# $ #
 # .  #$$ #
 #$#.$ @$ #
 #    #####
 ######
Solution: l2u1l1u7r2u1d1r3u2l1r1d2l4u2r2l1r1d1l1d1r1l3d3r1u4l1u1r1d1r2u2l1r1d4r2u1d2u1l2u2l2u1r1d2r1d1r2u4l1r1d4l2u1l3d5r1u3d3l1d2r1u3l1u4r3d1r2d7u7l2u1l3d7r1l1u6d1r1u2l1u1r2l2d2l3u2r1d1l1d1r3d2l2u2d2r2d4r1d2u4l3u2d2r3d4u2l3u2d2r3d2l3u2d2r2u1r1u1l1r1l1u5r1u2l1u1r1l1d5r1u2l1r1u2d1l4u2r1d1l1d1r3d2l2u2d2r2d2l2u2d2r2d4l2u4d4r3u7l1u2r3d1r2d7l4d1l1u3r1u1l1r1d3r4u5l2d4u4r2d5l4d1l1u4r1u4l1u1r2l2d1l3u2r1d1l1d1r3d2l2u2l1u4r1l1d4r3u1r1d6u5l4u2r1d1l1d1r3u1r1l1d3r1d2l1u1r1u1l1u3r1d4u3l4u4r1d1l1d3r3u4l1r1d12r1u1r4u7d7l5u10r2u1l2r1l1d11r5u11l3d1l2d2r2u1d1l2u1r1l1d2l3u3r1d2l1d1r3d1r1u1l1u1r1d3l1d6l2u8l1u2r1d1l1d1r3d1r1u3d2l3u3l1u2r1d4l1d1r1d8r2u12l1r1d12l2u11l1u2r1d2l1d3r1d8r2u7d6r5u11l6r6d11l5d1l2u8r1l1d8r2u10d2l3u3r1d2l1d1r2l1d8r2u9d1l3u5r1d4l1d1r2l1d8r2u8d5r1u6d6l1d2r1u7d8u1r4u1l1r1u4l2d4r1d1l3d1l1u6d5r5u6d2l1u1l1d4r1d1l3d1l1u4d3r5u3l1u1l1d3r1d1l3d1l1u2d1r5u2l1u1l1d2r1d1l3

;2
  #####
  #   #
###$$ #
# $. .#
# . $ #
###$ .#
 ##.$ #
 # $..#
 #.$ ###
 # .*$@#
 ##    #
  ######
Solution: d1l3u1l1u2r2d1u1l2d2r1l1u2r2u1r1l2r1d2l1d2r1u1d1r2u1l2u1l1u2r1d2u2r1u3l2d1r1d2u2l1d1r1u2r1u2l1d2r1d1u1l2d1l2u1d1r2u1r1u2l1r1d2l1d2r1u2d1l3u1r2d1r2u3l2d2u2r2d3l2r2u2l1r1d2l2u1r1u2l1d1

;3
#####
#   #
#.$.######
#        #
#.$.#$$$ #
#   #    #
#. .####+#
#   #    #
#.$.#$$$ #
# #      #
#.$ #    #
#   #    #
##########
Solution: undefined

;4
     ########
     #      #
 ##### *.$. #
## $   # .$ #
# $  $ #.$. #
#  $ # . .###
# $ $# $. #
#  $ # . ##
# $ $#  $#
#  $ # # ####
# $ $  #. . ##
###  $ . . . ##
  #### #. . .@#
     ### . ####
       #####
Solution: undefined

;5
            ####
  ##### #####  #
  #   ### $ $.$#
###$ $    #.. .#
# $    $# . $. ##
#   $$  #  .## .##
### @$ $$ # .$.  #
  ####  # #. . . #
     ##$# . . .$ #
      # # $.$. ###
     ## # ####  #
     #  $ .$.$. #
     #         ##
     ###########
Solution: undefined

;6
      ######
 ######    ##
 # $  $ .$. #
 #   ###$.$ #
 # $$#  . . #
 #   # . .  #
 # $$# #######
 #   # . . . #
## $$# $.$.$.#
#    # .$.$. ##
# $$$# $. . .##
#      ##.#.###
#  $$$ $.$.$. #
##   # . . .$ #
 ##### $.$.$.@#
     ##    ####
      ######
Solution: undefined

;7
          ######
###########    #
#           ** #
# ********** * #
# *@         * #
# ********** * #
#           ** #
###########    #
          ######
Solution: undefined

;8
#######
# . . ##
#.$.$..#
# .$.$.#
#. . ..#
# .#.$##
#.$.$.######
# $ $  $ $ #
# # #      #
# $ # $$ $ #
##  #  $####
 ## $ $@#
  ##   ##
   #####
Solution: undefined

;9
      ######
    ####   #
    #    . #
 #### $#.#.##
##  $$ # . .#
# $   $#. . #
#  $ $@# .#.#
# $   $#. .##
## $ $ . . #
 #$  #######
 #   #
 # $##
 #  #
 ####
Solution: undefined

;10
    #####
 ####   ###
 # $ $ $  ###
 #  $@$ $   #
 # $ $ $ $ ##
 #  $ $ $  #
 # $      ##
 ### ####$#
   #. . . #
  ##$.$.$.#
 ## . . . ##
## .$.$.$. #
# . . . .  #
#. .$.$.####
####. . #
   ######
Solution: undefined

;11
         #
        # # ###
    ####   #   #
    #   $   $  #
   # $ $ $ $ $  #
  # $ $ $ $ $ $  #
 # $ $ $ $ $ $  # #
#@$ $ $   #    #  #
#  $ $   # .#   . #
 ## $   # . .# . .#
   #   # . . . ###
    # # . . . .#
     # . . . . #
     #. . . . .#
     # . . # . #
      ### # # #
         #   #
Solution: undefined

;12
#################
#     . . .#    ##
#  ##.#. .   $ $ #
# $@# . .#.# $ $ #
# $ #.#. .$# $ $ #
# $ #$. .#.# $ $ #
# $ #.#. . # $ $ #
# $ # . .#.# $ $ #
# $ #.#. .$# $ $ #
# $ #$. .#.# $ $ #
# $ #.#. . # $ $ #
# $   . .#.# $ $ #
#   #            #
##################
Solution: undefined

;13
#########
#   #  .###
# $.#.$$$@#
#.$ #  * .###
# $.$.$#.$*.#
###         #
  ###########
Solution: undefined

;14
######### ####
#. ..  .###  #
# ##@##  $ $ #
#  .  #$  $  #
# .# .#  $ $ #
#  #. #$  $  #
#        $ $ #
# .## #.##   #
#     #    ###
############
Solution: undefined

;15
  ########
###. . * ###
# *$*#.$ $ #
#.$. *$$  @#
# .$.   ####
#########
Solution: undefined

;16
        ####
        #@ #
#########. #
#. . . * $ #
# $ $ $ $. #
# .#####$* #
####   #   #
       #####
Solution: undefined

;17
     #######
    #   #  #####
   # $ $.. .$.*#
  # $ $ # .$. #
 # $ $  #.$. #
#@      # . #
############
Solution: undefined

;18
   ######
   #     #
   # * .  #
   # $.#. #
#####. .# #
#   # . .# #
# $ #$$.$.$ #
# $ # . . .  #
# $ #$### $. #
#@$ $   $ # #
##  #      #
 ##########
Solution: undefined

;19
        #####
     ####   #
     #  #   #
 #####      #
##  ##  # ###
# .     # $ #
#. .### # $ #
# . # $ # $ #
#. .# $ # $ #
# . # $ # $ #
#. .# $ # $ #
# . # $ # $ #
#. .# $ # $ #
# . # $ # $ #
#. .# $ #   #
# . # $ #####
#.@.#   #
#########
Solution: undefined

;20
      ######
   ####.   #
#### .$.$.$#
#   $ .#.#.#
# $  .$.$. #
# $ $#.$.$.#
# $  # .####
# $ $####
### @#
  ####
Solution: undefined

;21
###############
#...       ...#
#.*$$$$$$$$$*.#
#.#         #*#
##*####@####*##
#*#         #.#
#.*$$$$$$$$$*.#
#...       ...#
###############
Solution: undefined

;22
  #######
  #     #
  # *$* #
  # $.$ #
###.   .###
# .  .  . #
# *$$ $$* #
# $..*..$@#
# *$$ $$* #
# .  .  . #
###.   .###
  # $.$ #
  # *$* #
  #     #
  #######
Solution: d2l4u3d4l2d3r2u3l1u1r1d4l2u2r1l1d2r2u2d2r2u3l3r3d1l1u1l1u3r2d2l1r1u2l1d1u1l3d1r1d1l1u2r2u2l4d2r3l3u2d2r3u1r1u1l2r1l1d2r1d3r2u2l1r1d2l2u3d1r3d1r2u4l2d3l1d1r1u4r2d2l1r1u2d2l1u1l1u1l2d1r2l2u1l2d1r1d3l1u1r1u3r2d1l1u1l1d1u2r1l2u3r2d3u1l1r1u2l2d2r2u2r2d2l1r1d3l3u2r2

;23
####
# @#
# $####
#  #  #
# $ $ ###
#  $ $  ###
# $ $ $ $.####
#  $ $ $.$. .#
# $ $ $.$.#. #
#  $ $.$. .$.#
# $ $.$. .#.###
####### . .$. #
      #. . . .#
      # .#. . #
      ## ######
       ###
Solution: undefined

;24
    ####
#####  #######
#      $@$ $ #
#. . .#$$$ $ #
# . . #  $ $ #
#. . .# $$ $ #
# . . #  $ $ #
#. . .#$ $ $ #
# . . #  $ $ #
#. .#. $ $ $ #
# . . #  $ $ #
#. . .## $ $ #
# . .  # $ $ #
#. . . #     #
##############
Solution: undefined

;25
             #####
##############   #
#        #. .# $ #
# $.$.$. # .$# $ #
# .$.$.$ #.$.# $ #
# $.$.$. # .$# $ #
# .$.$.$ #.$.# $ #
# $.$.$. # . # $ #
#   $    .   . $ #
######.####.######
    # @$  $ # . #
    # $$ $  #.$.#
    #  $ #### . #
    # $$ . .$.$.#
    #    #  . . #
    #############
Solution: undefined

;26
#############
#       . . #
# $$$$$  . .#
#      #.$. #
# $$$$$# . .#
#     @#. . #
######## ####
  #    #. .#
  # $$$# . #
  #    #. .#
  # $$$# . #
  #    #. .#
  # $$$# . #
  #    #.$.#
  # $$$  . #
  #     . .#
  ##########
Solution: undefined

;27
        ###
       #   #
      #     #
     # $ # $ #
    ##  $ $  ##
   # .#  $  #. #
  # .$.#   #.$. #
 # .$.$.# #.$.$. #
# .$.$.$# #$.$.$. #
#.$.$.$.  #.$.$.$.#
#$.$.$.     .$.$.$#
#.$.$.  # #  .$.$.#
 #.$.  #   #  .$.#
  #.  #  $  #  .#
   # #   $   # #
    #  $ $ $  #
     # $ $ $ #
      #  $  #
       #   #
        #@#
         #
Solution: undefined

;28
 ####################################
 #                                  #
 # ########################## ##### #
 # #                        .  $  # #
 # #  $ $ $ $ $ $ $ $ $ $ $ #*##  # #
## # ########################. # ## #
#  # # ..........*#*.......... # #  #
# ## # .######################## # ##
# #  ##*# $ $ $ $ $ $ $ $ $ $ $  # #
# #  $  .                        # #
# ##### ########################## #
#                                 @#
####################################
Solution: 7-9u2,6-6r9l7,29-3d2,30-6l9,32-3l2,29-2d3,30-6l8,3-9r3,7-10u3,6-6r8,29-8r2,32-9u5,33-3l3,29-2d3,30-6l7,27-8r4,32-9u1d1u5,33-3l3,29-2d3,30-6l6,25-8r6,32-9u5,33-3l3,29-2d3,30-6l5,23-8r8,32-9u5,33-3l3,29-2d3,30-6l4,21-8r10,32-9u5,33-3l3,29-2d3,30-6l3,19-8r12,32-9u5,33-3l3,29-2d3,30-6l2,17-8r14,32-9u5,33-3l3,29-2d3,30-6l1r1,15-8r16,32-9u5,33-3l3,29-2d3,13-8r18,32-9u5,33-3l3,29-2d2,11-8r20,32-9u5,33-3l3,29-2d1,7-4l2,4-3d5,3-9r3,7-10u3,6-6r7,9-4l4,4-3d5,3-9r3,7-10u3d1,6-6r6,11-4l6,4-3d5,3-9r3,7-10u3,6-6r5,13-4l8,15-4l8,17-4l8,19-4l8,21-4l8,23-4l8,25-4l8,27-4l8,9-8r22,32-9u5,33-3l6,4-3d5,3-9r3,7-10u3,6-6r4,7-4l2,4-3d5,3-9r3,7-10u3,6-6r3l1,9-4l4,4-3d5,3-9r3,7-10u3,6-6r2,11-4l6,4-3d5,3-9r3,7-10u3d1,13-4l8,4-3d5,3-9r2,6-6r1,5-9r1,7-10u3,15-4l10,4-3d5,3-9r3,7-10u2,17-4l12,4-3d5,3-9r4,19-4l14,4-3d5,3-9r3,7-10u1,25-3r2

;29
                 ##########
                 #        #
                 # ****** #
                 # *    * #
                 # * ## * #
                 # * ## * #
                 # * ## * ######################
                 # . ## . #                    #
                 ##.####.## $$$$$$$$$$$$$$$$$$ #
                 # . ## . # $ $ $            $ #
###########      # * ## * #@     ########**# $ #
#.........######## * ## * ########.........# $ #
# $ $ $ $ #        * ## *        #         # $ #
#********...******** ## ********...********# $ #
#         #          ##          #         #   #
################################################
Solution: undefined

;30
#########
 #       #               ####
 #$ $ $ $#################  # ####
 # $ $                   .  ###  ##
 #$ $ $ $#################     .  #
##       #            #  #######  #
# $ $ $$$#            #  .     .  #
# $ $    #           ##.###########
# $$$$$ $#           #  #   . . . #
#        #           #  .  . . . .#
##########           ###### . . . #
                          #. . . .#
                          # . . .@#
                          #########
Solution: undefined

;31
          ###
         ## ########
        ##         #
      ##  ******$  #
     ##  *      ** #
    #  ****   *  * #
   #  **  *****  * # #####
 ##  *   **  **  * ###   ##
 #  **  .*    *  * #   $  ##
 # **  **   * *.**   ***** ##
 #**   *  **   ***  *    ** #
 #* *  *  ***   **@*      * ###
 #* * **  *.**  * **  ***  *  #
##* * *  ** ** ****  ** ** *  #
# * $ *  **   *  **  **.** ** #
# *  **  **  ** ****    **  * #
# *  *     ***    ***   *   * #
# *  *    ***  $  * *$* *  ** #
# *  * ****    ****   ***  *  #
# ** **     ****          **  #
#  *  *******  ***     ****  ##
## **               ****    ##
 ## **.**************    ####
  ########################
Solution: undefined

;32
##############
#           ##
# $ $ *****  #
##### *   *  ####
# + # * # *     #
# * # * # ***** #
# * # * #     * #
# * # * ##### * #
# * # *     # * #
# * # ***** # * #
# * #     * # * #
# * ##### * # * #
# *       * # * #
# ********* # * #
#           # . #
#################
Solution: undefined

;33
###################
#   #..*.*.*#     #
# *.*........ $ $ #
# * *.******# $ $ #
# * #       # $ $ #
# * #########*#####
# * #      # . #
# * # $ $  * * #
# * # $ $ $# * #
# * # $ $  # * #
# * # $ $ $# * #
# * #      # * #
# **######## * #
# *@       . * #
# ************ #
#              #
################
Solution: undefined

;34
         ###
    ###### ####
   ## . . . . ##       ###
  ## . . . . . ####   ##@##
  # . . . . . .#  ### #   ##
 ##. . . . . .#     ###$ $ ##
##. . . . . .#  $ $ $ $ $ $ #
#. . . . . .#  $ $ $ $ $ $  ##
# . . . . .#  $ $ $ $ $ $ $  #
## . . . .#  $ $ $ $ $ $ $ $ #
 #. . . .#  $ $ $ $ $ $ $ $ ##
 ##. . .#  $ $ $ $ $ $ $ $  #
  ### .   $ $ $ $  $        #
    ###            ###### ###
      ##############    ###
Solution: undefined

;35
##########
#        #
# ###### #
# #@     #
# # $.$. #
# .#  .$ #
# $#$.$. #
# .#  .$ #
# $#$.$. #
# .#  .$ #
# $#$.$. #
# .#  .$ #
# $#$.$. #
# .#  .$ #
# $#$.$. #
#  #     #
##########
Solution: undefined

;36
  #####
  #  #######################
  #$ $ $ $ $ $ $ $ $ $ $ $ #
  #  . . . . . . . . . ..  #
### ####################*###
#    $ $ $ $ $ $ $ $ $ $  ##
# #. . . . . . . . . . .   #
# ######################## #
#@                         #
############################
Solution: undefined

;37
  #####
  #  #######################
  #$ $ $ $ $ $ $ $ $ $ $ $ #
  #  . . . . . . . . . ..  #
###.####################*###
#    $ $ $ $ $ $ $ $ $ $   #
# #. . . . . . . . . . . $ #
# ######################## #
#@                         #
############################
Solution: undefined

;38
  ####
  #  ###############
  #$ $ $ $ $ $ $ $ #
  #  . . . . . ..  #
###.############*###
#    $ $ $ $ $ $ $ #
# #  . . . . . ..  #
# #*############*###
#    $ $ $ $ $ $   #
# #. . . . . . . $ #
# ################ #
#@                 #
####################
Solution: undefined

;39
####
#@ #############
#              #
#  #$$$$$$$$$$ #
## #           #
#. #$$$$$$$$$$ #
#.$#           #
#. ########### #
#.$#           #
#. #.......... #
#.$$$$$$$$$$$$ #
#............. #
#  . . . . .$. #
#              #
################
Solution: r1d4l1d5u1r1d1l1d3r2u2l1d1l1u5r1d3l1d3r2u2l1d1l1u3,2-5d5u2,1-7u1,1-9u2,3-11l1,1-12u4,4-11u1,6-11u1,8-11u1,10-11u1,12-11u1,13-11u1,11-11u1,9-11u1,7-11u1,5-11u1,4-10l1,2-9d1,11-12r1,1-11r11,4-4u1,5-2l2,2-1d9,1-11r10,6-4u1l1,7-2l4,2-1d9,1-11r9u1,8-4u1,9-2l6,2-1d9l1,3-11l1u1,1-12u3,10-4u1l1,11-2l8,2-1d8l1,3-10l1,1-11u1,12-4u1l1,13-2l10,2-1d9,1-11r8,13-4u1l3,14-2l11,2-1d9,1-11r7,8-4u1,9-2l6,2-1d10,3-12l1u1,1-13u2,4-4u1,5-2l2,2-1d10,2-13u1,2-10d1u1,4-6u3,5-2l2,2-1d9,1-11r6,8-10d1,7-12r3,5-6u3l1,6-2l3,2-1d9r1,1-11r6,8-10d1,7-12r1,8-3l3,4-4u1,5-2l2,2-1d9r1,1-11r5,7-10d1,6-6u3l1,7-2l4,2-1d8,2-9d1,1-11r6,10-3l5,4-4u1,5-2l2,2-1d9,1-11r5u1,7-6u3,8-2l5,2-1d9,1-11r3,5-10d1,9-6u3,10-2l7,2-1d9,1-11r4,11-6u3,12-2l9,2-1d9,1-11r3,12-6u3,13-2l10,2-1d9,1-11r2,4-10d1,8-6u3,9-2l6,2-1d9r1,1-11r1,3-12l1,1-13u1,11-5l6,4-6u3,5-2l2,2-1d10,4-13u1,1-12r1,13-6u3l1,14-2l11,2-1d9

;40
###########
#         #
# #@##### #
# $ $ $ $ #
#.#  .  # #
# $ .$.$# #
#.#  .  # #
# $ .$.$# #
#.#  .  # #
# $ .$.$# #
#.#  *  # #
#         #
###########
Solution: undefined

;41
#################
#               #
# #$....#$$$$$# #
# $     #    @$ #
# $#$#. #$.#*#$ #
# $. . .#  .  $ #
# # . . #$.$. # #
# $. . .# $.$ $ #
# # . . #$.$. # #
# $. . .# $.$ $ #
#   .$. $       #
###     #########
  #######
Solution: undefined

;42
##############
##          .###
#@#  $ $ $ $.#.#
#  #  $ $ $ .. #
# $ #  $ $ #.$.#
#  $    $ #. . #
# $  #   #. .$.#
#  $  # #. . . #
# $ $  #. . . .#
#  $ $  #. . . #
# $ $ $  #. . .#
#  $ $ $  #. . #
# $ $ $ $  #. .#
#  $ $ $ $  #. #
# $ $ $ $  #. .#
#  $ $ $  #. . #
# $ $ $  #. . .#
#  $ $  #. . . #
# $ $  #. . . .#
#     #. . . . #
################
Solution: undefined

;43
#################
#               #
# $ $$# #$#.#.# #
# # # # # $ ... #
#@#$# # $ .*.*. #
# # $ $ $ #.#.# #
#               #
#################
Solution: undefined

;44
########################################
#@  . . . . . . . . . . . . . . . . . .#
# $ $ $ $ $ $ $ $ $ $ $ $ $ $ $ $ $ $  #
##.$#################################$.#
##  #             ####              #  #
##.$#             ####              #$.#
##  #             ####              #  #
##.$#             ####              #$.#
##  #            *####*             #  #
##.$#  **       **####**        **  #$.#
##  #  *#########################*  #  #
##.$#  *#########################*  #$.#
##  #  *#########################*  #  #
##.$#  *#########################*  #$.#
##  #  *#########################*  #  #
##.$#  **       **####**        **  #$.#
##  #            *####*             #  #
##.$#             ####              #$.#
##  #             ####              #  #
##.$#             ####              #$.#
##  #             ####              #  #
##.$#             ####              #$.#
##  #             ####              #  #
##.$#################################$.#
# $ $ $ $ $ $ $ $ $ $ $ $ $ $ $ $ $ $  #
#   . . . . . . . . . . . . . . . . . .#
########################################
Solution: undefined

;45
#################
#. . . . . . . .#
#  $ $ $ $ $ $  #
#.$#..########$.#
#  #         #  #
#.$# $   $   #$.#
#  #         #  #
#.$#         #$.#
#  # $   $   #  #
#.$#         #$.#
#  # $   $   #  #
#.$#         #$.#
#  #        @#  #
#.$###########$.#
#  $ $ $ $ $ $  #
#. . . . . . . .#
#################
Solution: undefined

;46
      #########
      #       #
      # **.** #
      # *   * #
      # * # * #
      # * # * #
      # * # * #
      # * # * #
      # * # * #
      # * # * #######
      # * # * $@    #
      # * # *   $ $ #
####### * # * #######
#       * # *       #
#.******* # *******.#
#         #         #
#####################
Solution: undefined

;47
   #######     #######
   #     #     #     #
#### $.$ ####### $.$ ##########
#    *$*  $ . $  *$*    # . . #
# * * * * * # * * * * * #.$.$.#
#  * * * *  #  * * * *  #$. .$#
# * * * * * # * * * * * #.$.$.#
#  * *$* *  #  * *$* *  # . . #
# * * * * * # * * * * * #.$.$.#
#  * * * *  #  * * * *  #$. .$#
# * * * * * # * * * * * #.$.$.#
#           #           # . . #
###########.#############. * .#
#           #           # $@$ #
# * * * * * # * * * * * # . . #
#  * * * *  #  * * * *  ###.###
# * * * * * # * * * * * . $ #
#  * *$* *  #  * *$* *  #   #
# * * * * * # * * * * * #####
#  * * * *  #  * * * *  #
# * * * * * # * * * * * #
#    *$*  $ . $  *$*    #
#### $.$ ####### $.$ ####
   #     #     #     #
   #######     #######
Solution: undefined

;48
#################
#       #       #
# * * * . * * * #
# * . * #  * *  #
#       # * * * #
#########  ***  #
#.  .  .# * . * #
# $.$.$ #   $ $ #
#.#$#$#.####.####
#$*   . #.  .  .#
#.$$$$$ . $$$$$ #
# .   . # .   *$#
#########.#$#$#.#
#@$ $ $ . $.$.$ #
#       # .   . #
#################
Solution: undefined

;49
#######################
#      #       #      #
#.$.$.$#.$.$.$ #.$.$.$#
# .$.$ # .$.$.$# .$.$ #
#.$.$.$#.$.$.$ #.$.$.$#
# .$.$ # .$.$.$# .$.$ #
#.$.$.$#.$.$.$ #.$.$.$#
# .$.$ # .$.$.$# .$.$ #
#.$.$.$#.$.$.$ #.$.$.$##
# .$.$ . .$.$.$. .$.$  #
#      #       #    $  #
#####################.##
# $ $ $ $ $ $ $ $ $ $  #
# . . . . . . . . .$.$ #
#@                     #
########################
Solution: undefined

;50
        ###########
#########         #
#       # . $ . . #
# #$#$# # #$#$#$# #
# .   . * . . . . #
# #$#$# # #$#$#$# #
# . . .   . . . . #
# #$#$# # #$#$#$# #
#       #         #
############### ###
#@      #         #
# #$#$# # #$#$#$# #
# . . .   . . . . #
# #$#$# # #$#$#$# #
# .   . * . . . . #
# #$#$# # #$#$#$# #
#       # . $ . . #
#########         #
        ###########
Solution: undefined

