;1
###################
#                 #
# # $ $$###$$ $ # #
# # #   $ $   # # #
# $ .#  $ $  #. $ #
# $ ..#     #.. $ #
# # ...#   #... # #
# # ....#.#.... # #
# # ...#   #... # #
# # ..#  $  #.. # #
# # .#  $ $  #. # #
# # #  $ $ $  # # #
# ##  $ $ $ $  ## #
# #  $ $ $ $ $  # #
#  #  $ $ $ $  #  #
#   #. $ @ $ .#   #
###################
Solution: r3l6r1u1r1u1r1u1r1u1l1u5r1u1r1u1r1u1r1u2r4d4l2u1l1d5,17-4l1,15-3d1r1d1l1u1l1d4r1d1l1,13-2r1u1r1d3r1d1l1u1l1d4,11-1d1r3u1r1d3r1d1l1u1l1d3r1d1l2,11-4u1,8-6u1r1u2r2d1r1u1r1u2l2d1r3u1r1d3r1d1l1u1l1d3r1d1l1,10-3r1d1r1u1l1u1r3u1r1d3r1d1l1u1l1d3,11-5l1u1l1u1r2d1r1u1l1u1r3u1r1d3r1d1l1u1l1d2r1d1l3,7-3r4d1r1u1l1u1r3u1r1d3r1d1l1u1l1d2r1d1l2,8-5u1l1u1r4d1r1u1l1u1r3u1r1d3r1d1l1u1l1d2r1d1l1,9-6u2l1u1r3d1r1u1l1u1r3u1r1d3r1d1l1u1l1d2,9-15u11l1u1r3d1r1u1l1u1r3u1r1d3r1d1l1u1l1d1r1d1l2,11-14l1d1l1u11l1u1r3d1r1u1l1u1r3u1r1d3r1d1l1u1l1d1r1d1l1,13-14l3d1l1u11l1u1r3d1r1u1l1u1r3u1r1d3r1d1l2,10-12d1l1d2r2u1l1d1l1u11l1u1r3d1r1u1l1u1r3u1r1d3r1d1l1u1l1d1,12-13l2d1l1u10l1u1r3d1r1u1l1u1r3u1r1d3r1d1l1,14-13l4d1l1u10l1u1r3d1r1u1l1u1r3u1r1d2u2r2d3l2u3l14d4r2u1r1d5u4l3u1r1l1u3r2d3l1d1r1u1r1d4l1d1r1l1u8r2d1l1u1l1d3l1d1r1u1r1d4l1u7r4d1l3u1l1d3l1d1r1u1r1d3l1d1r2l2u7r2d2r1d1r2u1l1d1l1u1r1u1l3u1l1d3l1d1r1u1r1d3l1d1r1,12-11d1l2d1l1u9r1u1l3d1l1u1r1u1l3u1l1d3l1d1r1u1r1d3,13-13l3d1l1u10r1u1l3d1l1u1r1u1l3u1l1d3l1d1r1u1r1d2l1d1r3,12-11l2d1l1u8r1u1l3d1l1u1r1u1l3u1l1d3l1d1r1u1r1d2l1d1r2,11-10l1d1l1u7r1u1l3d1l1u1r1u1l3u1l1d3l1d1r1u1r1d2l1d1r1,5-14r3d1r1u11r1u1l3d1l1u1r1u1l3u1l1d3l1d1r1u1r1d2,6-13r2d1r1u10r1u1l3d1l1u1r1u1l3u1l1d3l1d1r1u1r1d1l1d1r2,7-12r1d1r1u9r1u1l3d1l1u1r1u1l3u1l1d3l1d1r1u1r1d1l1d1r1,4-13r4d1r1u10r1u1l3d1l1u1r1u1l3u1l1d3l1d1r1u1r1d1,5-12r3d1r1u9r1u1l3d1l1u1r1u1l3u1l1d3l1d1r2,7-10d1r1d1r1u8r1u1l3d1l1u1r1u1l3u1l1d3l1d1r1,6-12r2d1r1u9r1u1l3d1l1u1r1u1l3u1l1d2u2l2d3r2,7-10r1d1r1u3

;2
###################
#                 #
# $$$$$$$$$$$$$$$ #
# $.............$ #
# $   #######   $ #
#  $$$.......$$$  #
#  $. .$   $. .$  #
#  $. .$. .$. .$  #
#  $. .$.@.$. .$  #
#  $. .$...$. .$  #
#  $.  $$ $$  .$  #
#  $...........$  #
#  $$$$$$ $$$$$$  #
# ............... #
# .$$$$$$ $$$$$$. #
##               ##
 #################
Solution: 8-11u5,6-7r1u1,6-9r2,9-10u4,6-8r1,7-11u1,6-9r1,12-7l1u1,10-8u2,10-11u3,12-8l1,12-9l2,11-11u1,12-9l1,16-6l3,17-4l2,13-4r1d1l1,16-7l3,16-8l3,16-9l3,16-10l1,14-11u3,14-4r1d3,16-8l1,14-13u3,16-12l1,14-13u2,16-11l1,13-13u1,12-13u1,11-13u1,10-13u1,8-13u1,2-6r3,6-7u1,5-4d1,4-6r1,2-7r3,2-8r3,2-9r3,7-13u1,6-13u1,5-13u1,4-13u4,4-4d2,2-5r1,4-4d1,2-11r1,2-10r1,3-13u3,2-9r1,3-1d10,2-12r6,9-13u1,15-15u1,16-13l6,10-15u1,11-15u1,12-15u1,13-15u1,14-15u1,15-1d11,17-3l1d10,16-1d11,8-15u1,7-15u1,6-15u1,5-15u1,4-15u1,3-15u1,1-3r1d10,2-1d11,4-1d1u1r1d1u1r1d1u1r1d1u1r1d1u1r1d1u1r1d1u1r1d1u1r1d1u1r1d1u1r1d1

;3
      #####
  ### #   #
 ##.### $ #
 #...##$$ ##
 # .  #    #
 # .    #$ #
##.#.    $ #
#.###.  $$ #
#.###.  $  ##
#.....  $$$ #
#.###.   $  #
#.....$  $  #
# ##  ## $  #
#         $ #
# $$$$$$$$###
##       @#
 ##########
Solution: l4u9r1u1l1d1l1u1r1u1l1d1l1u2,2-15u1,3-13l1d1l1u6,4-15u3r1u1l3,1-13u4,2-14r2d1r1u9r1u1l1d1l1u1r1u1l2u1l1d2,7-1d8,8-10l2,5-11u5r1u1l1d1l1u1r1u1l2d1l1u1,9-8l3r1d1l2u3r1u1l1d1l1u1r1u1l1d1l1u1,10-6l4d1l1u1r1u1l1d1l1u2,7-11l1,5-12u6r1u1l1d1l1u1r1u1l1,10-8d3l4,5-12u6r1u1l2,11-13l9d1l1u4,8-15u3,9-11l7,1-12u1,7-15u1l1d1l1u3,6-11l4,8-13l2d1l1u2,6-11l3,11-10l5u1l1d1r1d1l2,10-13u2r1u1l5u1l1d1r1d1l1,9-13u1r1u1l4,9-15u4r1u1l4,9-8d1l6,9-6d2r1d1l6,9-11u1r1u1l5,8-6d2r1d1l3,9-4d1r1d1l5,9-3l1,7-2d4r1d1l2,9-2l1u1l1d6r1d1l2

;4
#####
#.#.#
#.#.########
#. ....... #
#$ .  $ $. #
# $$$$$$#. #
# $   $  . #
# $$$ $$#. #
#   $    . #
#$$ $# ##. #
#@$    $...#
############
Solution: r2,1-5u3,1-10u7,6-10r3,3-10r4,5-6r3,9-5d4,3-8r5,9-7d1,7-8u1,6-6r2,9-5d1,7-4r1,9-3d1,5-4r3,3-6u4,3-8u5,7-6u2,6-3r2,5-7r1,7-8u4,6-3r1,1-5r1,3-7r3,7-8u4,6-6u2,5-6u2,4-6u2,3-6u2,1-6r1,3-7u2,3-7l1,1-8u4,4-10u3,3-6r5,2-10u1,1-8r7

;5
  ########
  #  #.  ##
### $.. $ ##
# $ ..#... ##
# $ .### $..#
# $ . # ....#
# $ $... $.##
# $#$$$$$..#
# $        #
# $$$$$$$$$#
#@      ...#
############
Solution: 1-3r3,8-8d1u1r1d1u1r1d1,9-7u1l1u1r2,8-4r2,3-2r1,9-2l1d1l1u1r1u1l1,8-8u5r1u1l2,3-6r4,8-7u3r1u1l1,1-6r7d1r1u3,5-8l1u1,3-6r4,8-7u3,1-8r8d1r1u4,1-5r2d1r1u2,1-4r2,2-8u2l1u1r2,6-8u1r3d1r1u2,5-6r4,4-7r5,7-10u3l1u1r2d1r1u1,6-10u2l1u1r2d1r1u2,2-10u1l1u1r7d1r1u1,5-10u3,3-10u1l1u1r4d1r1u2,3-9r2d1r1u3

;6
   #####
####   ####
#  #$ $#  #
#  . . .  #
#  #$ $#  #
#  . . .  #
#  $$#$$  #
#  . . .  #
#  #$ $#  #
#  . . .  #
#  #$ $#  #
#### @ ####
   #####
Solution: 6-1d1,5-3r1,4-1d1,3-3r1,5-4u1,4-5u1,5-3l1,5-1d1,6-3d1,5-5r2,6-7u1,8-4d1,7-5l1,7-7u1,3-7u1,4-5d1,5-7l2,6-11u1,5-9r1,4-11u1,5-9l1u1,8-9l2u1,5-7r1,8-5d3,9-9l1,3-7r1,1-7r1

;7
###################
#.................#
#.$ $ $#$ $#$ $ $.#
#.#$ # $ # $ # $#.#
#.$ $ $ $ $ $ $ $.#
#.               .#
#.  # # # # # #  .#
#.$ $ $ $ $ $ $ $.#
#.#$ # $ @ $ # $#.#
#.$ $ $ $ $ $ $ $.#
#.  # # # # # #  .#
#.               .#
#.$ $ $ $ $ $ $ $.#
#.#$ # $ # $ # $#.#
#.$ $ $#$ $#$ $ $.#
#.................#
###################
Solution: 3-12d2,4-15l2,3-14l1,3-12l1u1l1d1,4-13d1r1d1l2,5-12l1u1l1d3,7-12l1d2,7-15l2,9-12l1d2r1d1l3,6-12d1r1,8-12d2,9-15l1,4-12r1u1r1d3,15-12d2,14-15r2,15-14r1,14-13d1l1d1r2,14-11d3,11-12r1d2r1d1l3,9-12r1d2,10-13r1,12-12d2r1d1l1,15-15l1,6-12r1u1r1d3,10-12r1u1r1d3,15-12r1u1r1d1,12-12r1u1r1d3,15-7d7,3-7d4r1d1l2,15-2d9l1,15-2r1,17-3u1,15-4r1d1r1u2,13-2r1d1r1u1l1u1r1,13-4r1,11-4r1,9-4r1,3-4l1d1l1u3,3-2l1,5-4l3d1l1u1,7-4l1,7-4r1,4-3u1l1u1r7,8-3u1,7-1r1,10-3u1,12-3u1,12-4r1d1r1u3r1u1l1,6-3u1l1u1r1,3-4u2l1u1r2,6-4l2d1l1u3r1u1l1,10-4l1d1l1u3,10-4r3d1r1u3d3r1u3,12-3l1,10-2d1,11-4l6d1l1u3,8-3l1d1l1u2,5-7l1d1l1u6,3-7l1u1l1d1,5-9l1,3-10u4,4-5l2u1l1d1,7-7l3d1l1u2,4-5l2,9-7l5d1l1u3r1u1l2,11-7l9,1-9r1,3-8d2,4-11l1d1l1u1r1u1l1,7-9l5,7-7d3,8-11l6,15-7r1,17-8u4,13-7r3,17-8u3,11-7r5,17-8u2,11-9u1l1u1r6,17-8u1,15-9r1d1r1u1,13-9r1,15-10u2l1u1r2,15-13u1l1u1r2d1r1u1,11-9r5,9-9r1u1r1d2,10-11r6,7-9r3u1r1d3l1d1r6

;8
###   #######   ###
# #   #.....#   # #
# ######...###### #
# $     ...     $ #
#  $  #  $  #  $  #
# # $ # $@$ # $ # #
# ###$ $ # $ $### #
#     $     $     #
#### $#$###$#$ ####
 ## $   $ $   $ ##
 # $     $     $ #
 #   ##.....##   #
 ###.....#.....###
   #############
Solution: u3,10-1l2,7-5r1,7-7d4,8-12l2,11-7d4,10-12r2,11-5d6,10-12r1,7-5d6,8-12l1,10-10l1,9-9r1,11-8d3,7-10r1,9-9l1,7-8d3,9-9d1,2-10r5,8-9d2,16-10l5,10-9d2,3-9r3,7-8d2,5-7d2,6-10l1,4-9d2,15-9l3,11-8d2,13-7d2,12-10r1,14-9d2,17-3l6,10-4u2,9-1r1,1-3r6,8-4u2,10-6u4,8-5r1,10-6u2,11-3l1,9-4u2,5-7u3,4-3r3,8-4u1,13-5d4,14-10l3,10-9d1,16-4l2,13-5u1,14-3l3,10-4u1,2-4r1,3-5r1u1,3-3r5,9-4u1,5-6u2,4-3r4,15-5l1,13-6u2,14-3l3,13-7l1,11-6d3,12-10l3,8-9d1,5-7r1,7-8u4,6-3r1

;9
###########
#         #
# ###$### #
#   $@$   #
##   $   ##
 ## $$$ ##
  #  .  #
 ## ### ##
 #  ...  #
 #  ...  #
 #########
Solution: r1d1l1d1r1u1r1,5-4l1,3-3d4,2-8r2,5-5l1u1l1d3,2-8r1,7-4d3,8-8l1,5-1d3l1d1r2u1r1d4r1d1l1,3-3r1,5-2d2r1d1l2u1l1d4l1d1r2,8-3l2,5-2d1r1d1l2u1l1d5l1d1r1

;10
 ####
 #  ####
 #     #
 #  #$ ###
 #  #    ###
##  #$#$   #
#  #  #    #
#     #$#$ #
##   ## #  #
 ## ...@#$ #
  # ...##  #
  ##########
Solution: 5-4u1,6-2l3,2-1d5,1-7r1,5-6u3,6-2l3,2-7r1,4-6d3,3-10r2,2-1d5,1-7r2,4-6d3,3-10r1,7-6u1,8-4l2,5-5u2,6-2l3,2-1d5,1-7r2,4-6d3,7-8u3,8-4l2,5-5u2,6-2l3,2-1d5,1-7r2,4-6d2,3-9r2,9-8u2,10-5l2,7-6u1,8-4l2,5-5u2,6-2l3,2-1d5,1-7r2,4-6d2,3-9r1,9-10u4,10-5l2,7-6u1,8-4l2,5-5u2,6-2l3,2-1d5,1-7r2,4-6d2

;11
 ###########
 #  #  #...#
 #  $  #...#
 # $#$  #  #
 #  #    $ #
##  #$$  $$#
#  #  #    #
#  $  #$#$ #
##   ## #  #
 ## ...@#$ #
  # ...##  #
  ##########
Solution: 7-8u2,10-6u1l1u3,10-1l1,10-5u3,9-8u6,9-10u7,10-2l1,5-2l2d1,5-4u1,6-2l1,5-6u2,2-7r1,4-6d3,3-10r2,2-1d5,1-7r2,4-6d3,3-10r1,5-2l2,2-1d5,1-7r2,4-6d3,5-4u1,6-2l3,2-1d5,1-7r2,4-6d2,3-9r2,3-5u2,4-2l1,2-1d1,2-2d4,1-7r2,4-6d2,3-9r1,7-6u1r2,10-6u3,7-5l1,5-6u3,6-2l3,2-1d5,1-7r2,4-6d2,6-4r2,9-5u2

;12
         ####
    ######  #
 #### $     #
 #  $ $  #..#
 #    ####.##
 # ##......#
##$##. $ $ #
#      # # #
# $##   $ ##
#  ## $  ##
# $####  #
# @#  ####
####
Solution: 5-2r5u1r1d1,8-6l1,10-6l2,8-9u3,7-5r2d1r1u2,6-7u1l1u1r4d1r1u1,2-9u1l1u1r4,2-5d2,6-8u2l1u1r4,6-6r1,8-7u1l1u1r1,2-9u1l1u1r4d1r1u2,5-5r1,5-9r2d1r1u4,2-11u3l1u1r4d1r1u2,7-3l1u1l1d3,3-3r2u1r2d1l1u1l1d2

;13
###########
# # . . # #
#  #...#  #
#   . .   #
# $  .  $ #
# #$# #$# #
#   $ $   #
# #  $  # #
# $$$$$$$ #
# $.....$ #
####.+.####
   #####
Solution: r1u2d1l2u1r1u5l1u1r1d1r1u1,3-7r1d1r1u5r1u1l1d1l1u1,7-7l1,5-8u5l1u1r1,7-6l1d1l1u3r1u1l1d1l1u1,9-9l3,5-8d1u2r1d2,7-7d1,9-8l2u1l1d1,1-9r2,4-8d1,3-7d1,1-8r2u1r1d1,3-6r1d1r1u4,7-6u2,3-6u2,1-4r3u1r1d5,2-3r1,9-4l3,8-3l1

;14
##################
#  $..##.#.#.  $@#
# $ .#.#.#.#. $  #
#  $.#.#...#.# $ #
# $#.#.#. .#. $  #
#  $.#.#. .#.# $ #
# $ .. #. .#... ##
#  # # #   # #  #
# $$$$$$$$$$$## #
##              #
 #$$$$$$$$$$$ ###
 #            #
 ##############
Solution: 15-4l2,12-5u1,15-2l2,16-1l3,16-5l1u1l1d1r1d1l1,16-3l1u1l1d3,12-9u4,10-9u7,10-8r1d1r1u3,6-9u6,2-9u1,2-1r2,2-3u1l1u1r2,2-5r1d1r1u1,2-3r1,2-5u2l1u1r2,4-9u3,1-6r4,6-7u3,2-8u1l1u1r4,6-7u2,2-11u4,10-11u8,8-9u7,8-11u8,12-11u1l1d1l1u7,12-10u3,9-9u5,6-8r3d1r1u4,8-10r1d1r1u5,4-8r5d1r1u2,6-11u5,6-10r1d1r1u7,4-11u1r3d1r1u6,2-10r5d1r1u5,2-8r5d1r1u2,1-6r3,4-10u3

;15
###########
#         #
# ###$#####
#   $@$  #
##  .$.  #
 ## #.# ##
  # . . #
  #     #
  # $#  #
  ##   ##
   #####
Solution: d2,4-6r1,4-9u2,5-1d3,7-3l1,5-2d1,4-4r2,3-3r1,5-2d1,6-4l1,8-4l1

;16
###################
# ......          #
# $ $......$$$$$$ #
# $$$$$$$$$$ .... #
# $  ..$ .  $.$$. #
# $$$......$$.$ . #
# ..$$..$ ..$.$$. #
# ......$$$.$$ $. #
# . ..  $@$ $ .$. #
# $$$$$ $$$ . .$. #
# $   ..   .$ ... #
# $$.....$$.$$$$$ #
# $  .$ ....    $ #
# $$$$$ $$$$....$ #
# $ $...$..$.$$$$ #
#      ......     #
###################
Solution: l2,9-12d2,10-12d2,12-14l1,11-12d2,7-13r1,9-12d1,8-13d1,3-14r3,7-13d1,1-14r5,5-12r1d1,5-12d1,17-13l4,12-12d2,13-10d2,14-13l1,12-12d1,13-15u1,14-15u1,11-10r1d2,10-10d1,9-10d1,6-12r1,17-12l5,1-12r3,3-4u2,5-4u2,3-3r1u1,5-4u1,6-4u2,8-4l1u2,6-5u2,1-3r1u1,2-3r4,7-4u1,8-4u1,9-4u1,10-4u1,1-4r4,5-7u1,2-4d1,3-6r2,6-7u1,5-6u1,3-4d1r1,9-6l1,7-7u1,8-8u2,9-8u2,13-4l3,14-9r1,14-8r1,14-7r1,16-12u1,15-12u1,14-12u1,15-15u1,16-15u3,17-11l5,3-10u2,4-10u2,5-10u2,7-9l1u2,4-9r1,6-10u2,11-7l3,7-8u1,9-10u2,10-7l2,1-10r1u2,2-12u3,2-11r5,2-10r1,4-11u2,2-14u2,1-11r5,3-14u2,2-11r2,4-14u2,8-10u1,8-7d2,9-10l2,6-9d1,11-8l5,11-9l4,6-8d1,13-8l3,9-7d2,10-10l2,13-11u1,14-9l2,11-8d1,13-5r2,14-5d3,14-6r1,14-3d4,14-4r1,13-6l2,11-4d1,13-5l2,13-8u1l1,14-6l1,12-5d3,13-1d4,10-3r2,13-2d2,11-1d1,10-3r2,13-2d1,14-1d1,15-1d1,16-1d1,11-2r1,13-1d1

;17
       #########
       #       ##
  ###### #$$##  #
  #           $ ##
  # ..... #####  #
  # .....$       #
  # .....#  $ # ##
  #    ###$#### #
###### ##@ #  # #
#    # ##  #  # #
# $$$# ## $#  # #
#    #$    #  # #
# $$    ####### ##
#   ##       $ $ #
############     #
           #######
Solution: 15-14u9,10-5l1u1l1d1,6-12u6r1u1l2,15-3d1r1d1l9,10-8u2,6-6u1l1u1r2,11-5l5d1l1u1d1l2u2r1d1r2u1l1,2-13u1r4d1r1u1,8-11l1d1l1u6r1u1l2,4-9d2l1d1r3,7-13u1,8-11l1d1l1u5l1u1r1,9-4l3u1l1d2,15-3l6,8-2d1r1d1l3,10-11u5r1u1l5,13-6l2,10-7u1r1u1l3,1-11r1l1u2r1d2l1d1r5,7-13u1,8-11l1d1l1u7,2-10r1l1d1u1r1d1l1d1r4d1r1u1,8-11l1d1l1u6,4-9d2l1d1r3d1r1u1,8-11l1d1l1u5,12-13r2d1r1u9,15-3d1r1d1l7,10-1d1,11-3l2,8-2d1r1d1l1,11-1d1,12-3l3,8-2d1

;18
####           ####
#  #############  #
# $              .#
# $##############.#
# $           $ #.#
#    ######## $ #.#
######      # $ #.#
            # $ #.#
            # $ #.#
            # $ #.#
            # $ #.#
            # $ #.#
            # $ #.#
            # $ #.#
            # $ #.#
            # @ #.#
            #######
Solution: 1-2r15u1r1d13,1-4r1u1l1u1r15u1r1d12,4-4l1d1l1u2l1u1r15u1r1d11,15-4l12d1l1u2l1u1r15u1r1d10,15-6l1u1r1u1l12d1l1u2l1u1r15u1r1d9,15-8l1u3r1u1l12d1l1u2l1u1r15u1r1d8,15-10l1u5r1u1l12d1l1u2l1u1r15u1r1d7,15-12l1u7r1u1l12d1l1u2l1u1r15u1r1d6,15-14l1u9r1u1l12d1l1u2l1u1r15u1r1d5,13-7u2r1u1l11d1l1u2l1u1r15u1r1d4,13-9u4r1u1l11d1l1u2l1u1r15u1r1d3,13-11u6r1u1l11d1l1u2l1u1r15u1r1d2,13-13u8r1u1l11d1l1u2l1u1r15u1r1d1,13-15u10r1u1l11d1l1u2l1u1r15

;19
#############
#           #
# *.$ #..#$ #
# . $$#.... #
# $ $ . $ $ #
# $#$###$#$ #
#  # @. $ $ #
# ....#$$.$ #
# $#..# ..$ #
#           #
#############
Solution: 5-2l1,5-4u1l2,9-4l1,9-6l1u3,6-4r1,8-5u1,9-3l1,7-4u1,10-1d1,11-3l3,11-4l1,11-6l1u2,11-3l2,8-4r1,10-5u1,11-3l1,8-6r1,11-7l1u3,8-6d1,11-8l1,3-4r2,4-4d2,3-7r1,5-6d1,8-6l3,4-5d1,3-7r1,7-8u1,8-6l1,2-9u1,1-7r1,1-4r2,2-4d2,4-3d4,7-4l2,4-3d3,5-1d2,4-4r1

;20
 ###########
 #         #
 ## #$#$$$ #
##.$  $  $ #
#... . #@$ #
###.$.#.$$ #
 #..$....# #
 #...  $$$ #
 #### $    #
   #  ######
   # $#
   #  #
   ####
Solution: 7-3l1,5-6l2,4-4d2r1d1l2,5-11u5r1,4-3l1,7-8l1u1l1d2,6-3l2,3-2d1r1d1l2,5-1d2r1d1l3,10-3l6,3-2d4,8-6u2,9-3l5,3-2d3,7-1d1,8-3l4,3-2d2,5-11u4,9-1d1r1d1l6,3-2d1,8-8u1l1d1l1u1,10-7l5,8-5d1,9-7l1d1l1u1,8-1d1r1d1l3,5-2d1,10-5l2,10-4l1u1l1d2

;21
            #####
#############   #
#             # ###
#  #########   ...#
## #  #### ##  ...#
 # #  #  ##########
 # #  #           #
 # #  # ##### ### #
 # #  # #   # $   #
 # #  # #   #  $  #
 # #  # #   # ##$##
 # #  # ##  #    #
 # ####  #  # #$$#
 #       #  # #  ##
 #  ######  # $   #
 ####       #  ##@#
            #######
Solution: 15-14l1d1l1u8d2r2,14-6l6u1l1d7r1d1l5d1l1u11l1u1r11,13-1d1l1d1r2,15-2d1l1d1r2,15-8l1d1l1d1u3,14-6l6u1l1d7r1d1l5d1u1d1l1u11l1u1r11,13-1d1l1d1r2,15-2d1l1d1r1,17-9l1,16-11u2r1u1l3d1l1u2,14-6l6u1l1d7r1d1l5d1l1u11l1u1r11,13-1d1l1d1r2,15-2d1,16-13u4r1u1l3d1l1u2,14-6l6u1l1d7r1d1l5d1l1u11l1u1r11,13-1d1l1d1r4,16-9l2,13-10u3,14-6l6u1l1d7r1d1l5d1l1u11l1u1r11,13-1d1l1d1r3,15-13u1r1u1l2,13-12u5,14-6l6u1l1d7r1d1l5d1l1u11l1u1r11,13-1d1l1d1r2

;22
            #####
#############   #
#             # ##
#  #########     #
## #  #### ##    #
 # #  #  ####### #
 # #  #       ## #
 # #  # ###$$ ## #
 # #  # ##  # ## #
 # #  # ##@$#### #
 # #  #   $ #  # #
 # #  # #$  #  # #
 # #### $   #### #
 #       ####..  ##
 #  ######  #..   #
 ####       #..   #
            #######
Solution: d1,9-12l1,7-11d1r1d1l5d1l1u11l1u1r11,13-1d1l1d1r2,15-2d1l1d1r1u1r1d10,17-14l3d1l1u1,10-10d1r1d1l3,7-11d1r1d1l5d1l1u11l1u1r11,13-1d1l1d1r2,15-2d1l1d1r1u1r1d10,17-14l2d1l1u1,9-10d1r1d1l2,7-11d1r1d1l5d1l1u11l1u1r11,13-1d1l1d1r2,15-2d1l1d1r1u1r1d10,17-14l3,11-8d2,11-6d2,13-7l1,11-8u1r1u1l4u1l1d7r1d1l5d1l1u11l1u1r11,13-1d1l1d1r2,15-2d1l1d1r1u1r1d10,17-14l2,11-10u3r1u1l4u1l1d7r1d1l5d1l1u11l1u1r11,13-1d1l1d1r2,15-2d1l1d1r1u1r1d11r1d1l3,11-12u5r1u1l4u1l1d7r1d1l5d1l1u11l1u1r11,13-1d1l1d1r2,15-2d1l1d1r1u1r1d11r1d1l2

;23
   #####
   #...#
####...####
#   ...   #
# ## . ## #
# ###@### #
#   $$$   #
##$     $##
 # $###$ #
 #  $ $  #
 #   $   #
 ##  #  ##
  #######
Solution: 5-7u5,6-1l1,3-6r1,5-7u5,7-6l1,5-7u4,4-2r1,6-3u1,7-7d1,8-8u1,9-6l3,5-7u4,4-2r1,3-7d1,2-8u1,1-6r3,5-7u3,6-3l1,4-4u1,7-10u3,8-6l2,5-7u4,3-10u3,2-6r2,5-7u3,4-3r2,6-10l1,5-9r1,7-10u3,8-6l2,5-7u3,6-3l1,8-3l1,5-9l1,3-10u3,2-6r2,5-7u3,5-10l1,3-11u4,2-6r2,5-7u2

;24
 #########
##       ##
# .$...$. #
#  $$$$$  #
# ...#... #
# .$$$$$. #
# .$ . $. #
# ...$... #
##$$$$$$$##
#        @#
###########
Solution: 8-9u2,6-4u1,4-6l1,4-2l1,3-4u1,2-1d3,4-2l1,4-4u1,3-6u1,4-4l1,6-3l2,3-2d1,4-6u1,8-3l1,7-1d1l1,6-4u1,6-3r1,8-4u1,8-7u2,6-6u1r1,6-6r1,4-5r2,7-6u1,3-9u1,2-9u1,4-7r1,5-9u2,4-9u1,5-7r2,7-9u1,6-9u1

;25
 #########
##       ##
# ..*$*.. #
# $$.$.$$ #
# ...$... #
# .$$$$$. #
# .$ # $. #
# ...$... #
##$$$$$$$##
#        @#
###########
Solution: 8-9u2,2-9u2,8-4u1,7-4u1,4-4r3,6-3l1,5-1d2,4-4r1,3-4u1,2-4u1,7-4l4,6-6u2,4-6u1l1,3-7u2,6-5r1,7-7u2,4-5r1,6-6u1,4-7r3,5-9u1,6-7l3,3-9u1,4-9u1,6-9u1,7-9u1

;26
#####    ####
#...######  #
#.$. $    $ #
#  .$# ..#$@#
##$.  #.   ##
 # .. #.$#$#
##$##$$$.  #
#       .#$#
#####  ..$ #
  ###$$$   #
  #      ###
  ########
Solution: 11-2l3,6-2l2d2,3-1d1l1,1-3u1,2-5u1,3-2d2,1-3r1,3-2d1,7-5d1,2-7u2,6-7r1,8-2l5,2-3u1,10-4u1,11-2l7,3-3u1,2-5u1,1-3r1,10-6u3,11-2l9,8-6u2,5-5d1r1,7-7u3,4-7r2,7-8u3,5-10u2,4-7r2,7-8u2,10-8u5,11-2l7,8-8u1,10-8l1,6-10u2,5-7r2,7-10u1

;27
      #######
      #     #
####### $$$$###
# $ ... $   ..##
# $$#..$ ....  ##
#   .. $..$$$$$ #
# $..$ $.$@$    #
#  .. $$..$$.####
# $#.$  $....#
#  #....$$$$$#
# $###$..    #
#  # #   .####
#### # $###
     #  #
     ####
Solution: u1,8-5l5,6-6l1,6-8l1,4-7d1,6-11u1,7-9l1,9-8l4,7-13u1,6-11r2,13-6u2,12-6u2,12-10u4,9-8d1l2,10-10l2,11-8d1l3,12-10l3,12-4d3,10-6r1d1,10-6d1,12-5d1,9-5d2,15-5l2,12-6u1,11-1d2,8-4l2,12-5l3,9-1d3,11-2l1,9-1d2l3,8-1d1,9-3l2,6-6r1,6-8u1r2,6-5d1,5-7r2,1-3r2,1-5r4,6-6u1,3-3d1,2-5r2,2-3d1,1-5r2,1-6r1,2-9u1,1-7r2,2-11u1,2-10u2,1-7r1

;28
      #####
 ######   #
 #...## $ ##
 #...## $  #
 # .  # $$ #
 # .     $ #
##.#. #  $ #
#.###.##$$ ##
#.###+# $   #
#.....  $$$ #
#.###.#   $ #
#.....####$ #
# ##$$##  $ #
#         $ #
# $$$$$$$$# #
##          #
 ############
Solution: 10-6u1l5d1l1u3,9-3d1r1d1l5d1l1u1r1u1l2d1l1u2,9-3l1d1r1d1l6u1l1d1,7-2d2r1d1l3d1l1u1r1u1l1d1l1u2,8-1d3r1d1l4d1l1u2,10-6l1r1d2l1u2r1u1l5d1l1u1r1u1l2d1l1u1,7-6r1,9-7u1r1u1l5d1l1u1r1u1l1d1l1u1,9-10u4r1u1l6d1,7-8r1,9-9u4l1u2r1d1r1d1l5d1l1u1r1u1l1,8-8u2r1u1l4u1l1d1,9-9l7,1-10u2,11-9l9,1-10u1,11-10l1,11-12l1u2r1u1l9,8-10r1,10-11u1r1u1l8,11-13l3u1r1d1r1u3r1u1l7,5-13u5,4-13u1r1u1l3,1-12u1,5-15u6,9-15u2l1u1r1d1r1u3r1u1l6,4-15u3r1u1l3,2-15u1r2d1r1u5,8-13l2,5-14u3,7-15u1l2d1l1u3r1u1l2,1-13r2d1r1u2r1u1l1,8-13l3d1l1u2,9-14l3d1l1u3

;29
###################
#                 #
# $$$$$$$$$$$$$$  #
#  .$ .......  $$ #
# .....$## $..# $ #
# .##   ####$.. $ #
# . # $ ...#  . $ #
# ..###   .#$.# $ #
# $.  ...@.# . $$ #
# ..#$.#... $. $  #
# $..$..$$$$#. $$ #
# # .$$..$..$. $  #
# # ..$$...... $  #
# #  ..  $    $$# #
# ###$$$$$$$$$$ # #
#   #             #
###################
Solution: 2-9u2,1-10r1,3-11u2,4-8l1,2-7d1,2-5d1,2-1d4,5-3l2,2-2d2,5-6r4,7-3d2,6-6r2,17-4l1,17-5l2,17-6l2,16-2d1l13,2-2d1,3-1d2,16-5u1,17-3l13,4-1d2,5-1d2,6-1d2,12-6u2,13-3l6,10-4r2,13-3d1,12-1d2,13-1d2,7-1d1,8-1d1,9-1d1,10-1d1,11-1d1,14-1d1,15-3l2,6-10l2,3-11u3,5-8d1,6-10l2,3-11u2,7-13u1l3,3-13u3,5-15u2,6-12l2,3-13u2,8-11u4,6-12u3,5-8r1,5-12u1,6-10l1,6-15u6,10-13l4,5-14u2,6-11l1,8-11l1,6-12u2,10-11u3,13-9l2,10-10u1,12-6d2,11-9r1,13-10u2,10-10l1,8-11u2,9-12u2,10-9l1,11-11u1,12-9l2,16-9l5,13-11l6,6-12u1,16-11l8,7-12u1,12-15u2,13-12l8,16-12l10,15-14u1l9,7-15u3,9-15u1,10-13l3,8-15u3,10-15u3,11-15u3,16-12l7,15-9d2,16-12l6,15-7d4,16-12l5,17-8l3,17-10l3,16-6d2,17-9l3,13-15u3,14-15u2,15-12l3,15-3d8,16-12l3,15-1d10,16-12l2

;30
  ###########
  #.........#
  #.$$$$$$$.#
  ##.  $  .##
   ##. $ .##
    ##. .##
     ##.##
    ##. .##
   ##. $ .##
  ##. $ $ .##
###.$$$ $$$.###
#.*   $ $   *.#
#.$$$$$ $$$$$.#
#.    $@$    .#
###############
Solution: r5l10r5u2d2r4u2d1r1l1u1r1d2l5u2r4l1u1d1l1u2d2l2u3l1u1r1d6l4u2l1r1d1l1r1d1r4u2l4r1u1d1r1u2d2r2u1l1u2r1u3l1u1r2u1r2l1r1u1r1u1l7,4-3u1d1r1u1d1r1u1d2r2u1l1u1d1r1u1r1d1r1u1l1u1r1d2l3d1l1u1l1u1r5,9-10l1d1l1u8l1u1r3d1r1u1,9-9l1d1l1u7l1u1r2d1r1u1,9-13u2r1u1l2d1l1u7l1u1r3,9-12l1d1l1u8r1u1l2,11-12l3d1l1u9r1u1l3,5-13u1r1d1r1u10r1u1l4,3-12r3d1r1u8r1u1l1u1l1d1,4-11r2d1r1u8l1u1r1u1r1d2,4-10r2d1r1u4

;31
###########
#         #
# ###$### #
#   $@$   #
## $ $ $ ##
 #  $$$  #
 ## ... ##
 ## ### ##
 #  ...  #
 #  ...  #
 #########
Solution: r2d4,8-8l1,3-3d4,2-8r2,6-4l2,3-3d4,2-8r1,5-4d1r1u1r1d4r1d1l1u4l3u1l1d4l1d1r2l1u4r3d1l2u1l1d3l1d1r1,5-1d4r1d1l1,9-3l3,5-2d3,3-3r1,5-2d2l1d1r1u1r1d1

;32
   #####
   #   #
#### $ ####
#         #
# ###$### #
#   $@$   #
#  $ $ $  #
##$ *** $##
 #  ...  #
 ## ### ##
 #  ...  #
 #  ...  #
 #########
Solution: r2d4,8-10l2,5-5l2d4,2-10r1,4-6r2u1r1d4,8-10l1,5-6d1r1u1r1d4r1d1l2r1u4l3u1l1d4l1d1r1u3r3u1r1d3r1d1l1,5-3d4,5-1d5l1d1r1l1d1r1,9-5l3,5-4d3,8-8u2,9-5l3,5-4d2,1-5r3,5-4d1r1d1l1u1l1d2,2-8u1,1-6r2u1r1d1

;33
 #################
##       #       ##
# $....$$$$$....$ #
# ..$$...$...$$.. #
##.$ #$$. .$$# $.##
 #.$    ...    $.#
 #.$#### . ####$.#
 #.$   # . #   $.#
 #.$   #   #   $.#
 #.$## ## ## ##$.#
##.$           $.##
# ..$$$$$$$$$$$.. #
# $.....$@$.....$ #
# $  # ..$.. #  $ #
# $$$$$$...$$$$$$ #
##               ##
 #################
Solution: d1,1-2r1,4-4u1,8-1d3,7-5r1,9-4d1,6-5u2,4-3r2,6-1d1,8-2l2,6-4r1u1r1u1l1,9-4l1d1l1u1,10-3l1,14-4u1,17-2l1,10-1d2,10-2r2,8-2r3,14-3l3,11-5u1d1r1u1,9-7u1r1u1l1d1l1u1,9-12u5,4-5l1u1,2-6u2,4-7l1u2r1u1l1,2-8u2,4-8l1,2-9u2,4-10l1d1u3r1u1l1,2-11u2,14-5r1u1,16-6u2,14-7r1u2l1u1r1,16-8u2,14-8r1,16-9u2,14-10r1u2l1u1r1,16-11u2,1-13r1u3,2-15u4,17-13l1u3,16-15u4,9-7u1l1u1r1,9-15u8r1u1l1d1l1u1,7-12r1d1r1u7,11-12l1d1l1u6,4-12u1l1u1r5,9-11u3,4-15u2,5-12l2,2-13u1,6-15u2r1u1l3,2-14u1r1u1,4-14u1d2l1u2,5-10d1u1r1d1u1r1d1,7-15u1,8-10d2,14-13r1,16-14u2,13-10d1r1,14-15u2d2r1u2,12-15u1l2,14-14l3,12-12d1,13-14l1d1l1u1r1u1l1,4-14r3,11-10d2,12-10d1u1l3d1r1u1r1d1

;34
            #####
#############   #
#             # ##
#  ########$$    #
## # ####        #
 # # #  $$ ##### #
 # ###        ## #
 # # $$ ###$$ ## #
 #      ###   ## #
 ###### ##@$  ## #
      # ##$    # #
      #  $  ## # #
      # $   ## # #
      #  ####    ##
      #    .......#
      #######.....#
            #######
Solution: r1,8-11d2l1d1r6u1r1d1r1d1l1,11-2d1,10-4r5u1r1d11r1d1l2,12-2d1l1d1r4u1r1d10l1d2r2u1l2,9-4d1,7-5r2,10-6u1l1u1r6u1r1d11,10-6l2,7-7u1l1u1r3d1r1u1l1u1r6u1r1d10l1d1r1l1d1r1,6-8u1,4-7r2d1r1u1,6-5d1,7-7u1l1u1r3d1r1u1l1u1r6u1r1d11,5-7r1d1r1u2l1u1r3d1r1u1l1u1r6u1r1d10,13-14r1u1r1d1,10-9d2r1d1l2,8-11d2l1d1r7,8-11r1d1r2u2l1d1r1d1l2u1l1d2l1d1r6,12-8d1r1d1l2u1l1d2r1d1l2u1l1d2l1d1r5,12-6d3r1d1l2u1l1d2r1d1l2u1l1d2l1d1r4,11-6d3r1d1l1u1l1d2r1d1l2u1l1d2l1d1r3

;35
    ########
    #      #
#####$###$.##
#         $ #
#  #$#...#  #
##$  $  .#$ #
 #  ...@.   #
 ##$.#...#$ #
 # $..$$ $  #
 # $ ..$ $ ##
 #   $.. $ #
 ##  #######
  # $#
  #  #
  ####
Solution: 11-3l2,10-4d1,11-6l3,7-7u1,6-5r1,8-6u1,4-5r2,7-6u1,4-3d1,3-5r4,7-3r2,11-3l1,5-1d1,8-3r1,4-3r1,10-2d3,11-6l4,6-7u2,5-3r4,10-2d3,11-6l5,2-6u2,1-3r8,10-2d3,11-6l4,6-9u1,2-8r1,3-8u1,2-6r1,4-9u1,2-9r1,4-10u1,8-8l2,4-13u3,3-9d1,3-9r1,4-10r1,8-9l1,10-10l2,10-8l2,7-9u1,9-10u1,11-8l2,8-9u1,10-8u1,11-6l2,9-1d1,8-3r1,10-2d1,10-5u2

;36
###################
#                 #
# *..$...$...$..* #
# .$.$.$.$.$.$.$. #
# *$.$.$.$.$.$.$* #
# .$...$...$...$. #
# *$$$$$$$$$$$$$* #
# ...$       $... #
# $$.$$$$@$$$$.$$ #
# ...$       $... #
# *$$$$$$$$$$$$$* #
# .$...$...$...$. #
# *$.$.$.$.$.$.$* #
# .$.$.$.$.$.$.$. #
# *..$...$...$..* #
#                 #
###################
Solution: 6-9l3,4-3l1,4-5l1u2,6-2l1,6-3l1,6-4l1,6-7u4,1-9r6,2-9u1,3-7d1,4-9l1,4-11l1,4-13l1,3-11d2,4-9d1,3-11u1,6-12l1,6-13l1,6-14l1,6-9d4,5-9d1,8-13l1,8-12l1,8-11l1,7-9d4,3-5d1,4-7u1,6-7l1u1,6-7d1l1,7-9l2,8-5l1,7-7d1,7-5d1,8-4l1,8-3l1,7-8u5,10-4l1,10-3l1,10-2l1,8-7u1,9-7u1,10-7u4,12-3l1,12-4l1,12-5l1,11-7u4,12-7u1,14-4l1,14-3l1,14-2l1,14-7u4,16-3l1,16-5l1,16-5u1l1,15-7u4,16-7u2,16-9u3,12-7r3,16-8u1,13-7u1,15-9u1,14-7r1,10-14l1,10-13l1,10-12l1,9-9d1,10-9d4,12-13l1,12-12l1,12-11l1,11-9d4,14-14l1,14-13l1,14-12l1,12-9d1,16-13l1,14-12d1,16-11d1l1,14-11d1,16-9d2,14-11r1,15-9d4,14-9d2,12-9r1d1,14-8d2,7-10r8,9-8l1d2,10-9u1,9-7r5,11-7d1,10-9r5,12-9u1,11-7r2d1,12-9r2,6-9r7,6-8r7

;37
        ####
        #..#
  #######..#
###      ..##
# $  $#  ...#
# $$  ## ####
#  ## ## #  #
# $#   $ $$ #
#  .        #
# $#.###$ $ #
#  #.# #  ###
# $### ####
# @#
####
Solution: 8-10u6,7-3r2,10-4u2,5-5u1,4-3r4,9-4u2,1-4r3,5-5u1,4-3r4,9-4u1,2-6u1,1-4r3,5-5u1,4-3r5,10-4u1,2-5r2,5-6u2,4-3r5,6-7r1,8-8u4,7-3r1,10-6d1l1,8-8u3,7-4r3,11-9l2,8-10u5,7-4r2,11-8l2,8-9u4,7-4r1,2-6d1,1-8r2,4-7d2,2-10u1,1-8r2,4-7d1,2-12u3,1-8r1

;38
###################
#                 #
# ...####$####... #
# #.$$  $@$  $$.# #
# # .  $.$.$  . # #
# #  .$     $.  # #
# #  $ #$ $# $  # #
# # $  $...$  $ # #
#  $. $ .#. $ .$  #
# $  $ #.#.# $  $ #
# #$. $ .#. $ .$# #
# # $  $...$  $ # #
# #  $ #$ $# $  # #
# # # $. $ .$ # # #
# .....$...$..... #
#                 #
###################
Solution: r1d1r4d1r1u2,7-5l1,14-2r1,14-4u1,12-3r2d1r1u1,9-3d1l1d1r1,9-1d2,8-14l5,6-12d1r1d1l2,8-11d1r1d1l1,11-5r1,15-9d4,14-14r1,15-7d6,10-14r3,13-11d2u1d1l1,10-11d2,13-10u1l1d4,8-5d8,3-9d4,5-11d2,5-10u1r1d4,2-8r1,4-2d1,6-3l2,3-4u1r1u1l1,4-5u2,9-3l5d1l1u1,12-3l8,13-7r1d1r1u4,12-6r1d1r1u2,6-7r1,12-7l2,11-5l1d2,8-5r1,10-4d2,8-4r1,6-4r1,5-7d1r2,5-8d1l1d1r3,8-11u1,12-11l1,10-12u2,12-7d3r1d1l2,12-8r1,17-9l4u1l1d1r1d1l2,14-12u1,6-11r2,1-9r4u1r1d1l1d1r2,3-11r4,3-7r1d2,6-6l1d1r1d1l1u1l1u2

;39
   ###
####.########
# $  ..     #
# $$ .... # #
#  ##.### $ #
# $# . # $@ #
#  . $ $..$ #
# $#.   $.$ #
#  #. $#$ ###
# $###    #
#  # ######
####
Solution: 1-2r2,4-3u1,2-4u1,1-2r4,2-3r5,2-6u3,1-2r3,11-6l2,6-9u2,5-7u3,4-3r2,9-7l3,5-8u4,4-3r1,6-5d1,7-7l1,5-8u4,9-4d1,8-5d1l2,5-7u2,9-7l3,5-8u2,11-7l6,4-6d1,9-5d1,10-7l5,8-9u1,7-7r1,11-4l1,9-3d2,2-8u1,1-6r6,2-10u3,1-6r1

;40
   ####
 ###  ###
 #  $.$ #
 #$ ..  ##
##  . #  #
#  .#@#  #
#  .$ $ ##
##   $# #
 ###    #
   ######
Solution: 2-2d2,1-5r1,5-6l1,4-1d2,7-2l2,4-1d1,5-8u5,7-6l1,5-7u3

