;1
  #####
###   ###
# $ #   #
# ..$.. #
# $ #   #
###$#####
  #   #
  # @ #
  #   #
  #####
Solution: 3-6u3r2,1-4r1,3-3d3,3-1d1,4-3l1,1-3r3,6-4u1l1,3-3r2,3-8u5,3-1d1,4-3l1,1-2r1,3-1d5,7-2l1,5-1d1,3-8u4

;2
 #######
 #  #  ###
##$.#  $ #
# $.   . #
#   ######
### ##  @#
# ..  .$ #
# $$ #.$##
###  #  #
  #######
Solution: 8-2l2,1-3r5,2-1d2,3-8u5,1-7r2,8-6l5,7-8u1,8-6l1,6-5d1,4-8u1,3-6r2,1-4r1,3-3d2,5-1d1,6-3l2

