;1
#######
#.... #
# $$$ #
# $@$ #
# $$$ #
# ....#
#######
Solution: u1d2u1l1u1d2l1u2d1r3u1d2u2r1d2

;2
#######
# ..  #
#.$$$ #
#.$@$.#
# $$$.#
#  .. #
#######
Solution: r1u1,3-3l1d1,2-3u1,4-2l2,5-1l1,1-5r2,3-3d1r1

;3
   #
  #.#
 #.$.#
#.$$$.#
 # $ #
 # @ #
 #####
Solution: l1u2d2r2u2l2r1u1d1l1d2r1u1l1u1r2

;4
 #####
##   ##
#  #  #
#.$@$.#
# $$$ #
#. . .#
#######
Solution: l1d1u3r2d1r1d3l3u2r1d1r1l2u3r2d1r1d2l2u1r1

;5
#######
#     #
# * * #
#* $ *#
# *.* #
#  @  #
#######
Solution: l2r4,5-4u1l2u1,3-1l2d2r1l1,1-2u1r2d2r2d2l4u1d1r4u1,5-3l2,3-1r2d1

;6
    ####     #
   #   #    #
  ## # #####
 ###  .... # #
######.$$$ ##
     #.$@$ #
     #.$$$ # #
     #    .##
     #######
         #
       ###
Solution: d1l1d1l1u4r4d3l1r1u3l4d4r3l3,6-4u1,6-4u1r4d3l3r3u3l6u2r2d3u1r4d3l2u2d2r2u3l3r1d1l1r1d2l1,7-6u2d2r3u3d2l1d1l1u2d1r1u1

;7
###############
#      @      #
# ***     *** #
# * $$$$$$$ * #
# * ....... * #
# *********** #
#             #
###############
Solution: undefined

;8
      #####
      #   #
      # $ #
      #   #
      ## ##
       #.#
##### ## ## #####
#   ### . ###   #
# $     @     $ #
#   ### . ###   #
##### ## ## #####
       #.#
######## ########
# * * *   * * * #
#       $       #
##  * *   * *  ##
#################
Solution: u5l1u2r1d6l1d2r1u3d3u1d5l1d1l2d1l1u1r3d1l1r1u2r2l2r2d1l1u6l5u1l2d1r6u1r1d6u5r5u1r2d1l6d1l1u1d5r1d2l1u5d5l2u1r1d1r1u3d3l1u1l3d1r1l1u1l2d1r1

;9
  #####
  #   #
###$.$###
# $   $ #
#...@...#
# $   $ #
###$.$###
  #   #
  #####
Solution: undefined

;10
  #####
  # . #
###$.$###
# $   $ #
#.. @ ..#
# $   $ #
###$.$###
  # . #
  #####
Solution: undefined

;11
  #####
  #   #
###$.$###
# $ . $ #
# ..@.. #
# $ . $ #
###$.$###
  #   #
  #####
Solution: undefined

;12
  ##   ##
 #  # #  #
# $  #  $ #
#  $ . $  #
 #  *.*  #
  #..@..#
 #  *.*  #
#  $ . $  #
# $  #  $ #
 #  # #  #
  ##   ##
Solution: undefined

;13
  #######
  #. $ .#
### $.$ ###
#@ $.$.$ .#
### $.$ ###
  #. $ .#
  #######
Solution: undefined

;14
##### #####
#...###   #
#...    @ #
#. .###   #
### # # ###
  #$# #$#
### # # ###
#   # #   #
# $ # # $ #
# $ # # $ #
# $ # # $ #
#   # #   #
##### #####
Solution: l5d5l2d4r2u8l1u1r5u1r2d1l6d1l1u1r5d5r2d4l2u8r1u1l5d1u2l1r1l1d1r1d1l1r1u1r4d5r2l1r1d1l1r1d3l2u8r1u1l5d1l1u1r3l2d5l2d1r1l1d3r2u9d5l2d2r1l1d2r2u2l1u2,9-9l1r1d2l2u8r1u1l6,9-10l1d1l1u8r1u1l5,3-9u6,1-10r1,3-11u7

;15
#########
# #...# #
# * . * #
# * * * #
# * $ * #
# #$$$# #
#   @   #
#########
Solution: r1u4d4l2u4d4u2r1l1u2r2d2l2r1u2d1l1d3r3l2u3d3r3u2l2r2d2l3u2d2r2l1u1l1u1r1

;16
     #####
     #   #
  #### $ ####
  #  #   #  #
  # ## #### #
#####.*.*.#####
#   #*$ $*    #
# $ #. @ .# $ #
#    *$ $*#   #
#####.*.*.#####
  # #### ## #
  #  #   #  #
  #### $ ####
     #   #
     #####
Solution: u2l1r1d2r2u1d1l2u1r4l3d1l1d2l1r1u2l1d1l3r4u3l1d1r1d1l1d1r1d1r1l1u2d2r1u1l1u1r1u1r3d2r2u2l5d1l1u1r6d2l1u1r1u1l5d1l2u1r2d7l2u1r1d1r1u4l1u2r1d1l5u2l2d2r5u1r1d1l6u2r1d1l1d1r5u1r2d1l2u5r2u1l1u1l1d3

;17
#####
#  .##
#  #.##
##$ *.##
#  $ *.##
# * $ #.#
# $* $  #
#@   #  #
#########
Solution: r3u1r2l2d1l3u3r1u2l1u1r1d3l1d3r3u1r1u2l1u1d1r1d2r1d1r1u1l2u1d1l1u2d3l3u3r4d2l1d1l1u2d2l2u2d1r1l1u2r3

;18
 ##########
##  #  *  #####
#   # * * #   #
# @  * $ *  . #
#   # * * #   #
##  #  *  #####
 ##########
Solution: undefined

;19
 ##########
##  #  *  #####
#   # * * #   #
# +  * $ *    #
#   # * * #   #
##  #  *  #####
 ##########
Solution: undefined

;20
 ##########
##  #. $ .#
#   # $.$ #
# @  $.$.$#
#   # $.$ #
##  #. $ .#
 ###### ###
     #   #
     # . #
     #   #
     #####
Solution: r3u2r2d1l1r1d1l4d1l1u1r3d2u2r1u2l1d1r1d1l3r2l2d1u1r2d2u2r3l1r1l2d1u1r2d1l1d3u6r1d1l1d4u1l1u3r1u1l1d3r2l1d3l1d2r1u6l1u2r2d1r1l1u1l2d3r3d1l1u1l1d3u4l1u2r2d1r1d2l2r2u2l1d1r1d1l1u1l5d1l2u1r6l5r1u2l1d1l1d1r4

;21
    #####
    #   #
    #$.$#
    #. .#
#####$.$#####
# $.$   $.$ #
# . . @ . . #
# $.$   $.$ #
#####$.$#####
    #. .#
    #$.$#
    #   #
    #####
Solution: undefined

;22
#########
#.....  #
#    $# #
#.... # #
#   $$# #
#...  # #
#  $$$# #
#..   #@#
# $$$$###
#.     #
#$$$$$ #
#      #
########
Solution: u6l3d2r1u1l2d3r1u3d3l3d2r2u5d4l2d3r1u7d7r4d2l5u9d9r1u7r1u1l1d8r1u1d1r3u2l3d1u1l1d1l1u4r2l1d4r1u1d2r2u1r1u1l3d1l1u6d3r3d2u2l2u2r2d2u2l1u3r1d3l2d2l1d4r3u1r1u1l3d1l1u4r1d1r1u3d2l1d1l1d2r1u5d7r2u1l1d1l1u5r1d1r1d1l3d1l1u1r1d3r4u2l4r1u2r1u2r1d3l1d2r2u1l3d1l1u2

;23
 ####
 #  ########
 #   $     #
 # #  .#$#$#
 #  .# #   #
 # #  .  #$#
##  .# #   ##
#  # #.  #$ #
#    @ #    #
#####  #  ###
    #######
Solution: r1l1r1u6l3u1l1d6l1d1r4d1r1u3d1r2u2l3r1d3l2u3r4d1r2d1r1d1l2r1u2d2l1d1l1u2,10-4d2u2l2d1l2u3r4d2l2u1d1r2u2l7u1l1d6l1d1r4d1r1u3,4-5u1,7-5l2,4-4d1u1l2u2r2d1r2d4r2u4d1r2u2l7u1l1d6l1d1r4d1r1u5d1r2d1r2d1r1d1l2d1l1u6d1r2u2l7u1l1d6l1d1r4d1r1u3d1r2u3r2d3r1d1l2d1l1u6d1r2u2l7u1l1d6l1d1r4d1r1u1

;24
 ####
 #  ########
 # $ $     #
 # #.#.#$#$#
 # # # #   #
 # #. .  #$#
##   # #   ##
#  #.#.  #$ #
#    @ #    #
#####  #  ###
    #######
Solution: 4-2l1u1l1d6l1d1r4d1r1u3d1r2u2l3r1u3l3u1l1d6l1d1r4l1u3d2u1l2u4r2d4l2d2r3d1r1u3d1r2u2l3,4-6u2,10-6d1r1d1l2d1l1u2,10-4d2,10-2d2,8-4u1d1r2u2l7u1l1d6l1d1r4d1u1d1r1u3,7-5l2,8-7u4d1r2u2l7u1l1d6l1d1r4d1r1u5d2u1r2d1r2d1r1d1l2d1l1u6d1r2u2l7u1l1d6l1d1r4d1r1u3d1r2u3r2d3r1d1l2d1l1u6d1r2u2l7u1l1d6l1d1r4d1r1u1

;25
 #######
#  . .  #
# $$$$$ #
#.$...$.#
# $.*.$ #
#.$...$.#
# $$$$$ #
#  . . @#
 #######
Solution: undefined

;26
#################
##  #  ###  #  ##
#  $ $  #  $ $  #
# $ # $ # $ # $ #
#   #   #   #   #
# $ # $ # $ # $ #
#   #   #   #   #
# $ #.......# $ #
#   #...+...#   #
#################
Solution: undefined

;27
#################
##  #  ###  #  ##
#  $ $  #  $ $  #
# $ # $ # $ # $ #
# $ # $ # $ # $ #
# $ #.$ # $.# $ #
# $ #.. # ..# $ #
# $ #.......# $ #
#   #...+...#   #
#################
Solution: u1l1u3l1d2l1d1r4d1r1u1l3u5l1d1l1d4r2u3l1u1l1d3r1u5l1d3u2l2d6l2u6r4d3u4r1d2r1l1r1d1l1u1l1d1u2l4d5r1d1r1u5d5l2u6r4u1r1d6u5l5d4r1d1r1u4d3l2u4r4u1r1d2l1r1l1d1r1u1r1d3l1d1r3l2u5l6d3r1d1r1u3d2l2u3r4u1r1d5u4l5d1r1l1d2r2u2l1u1r3u1r1d4u2l1u1l4d2r1d1r1u2l1u1r3u1r1d2l1d1r1u1r1d4r2d1r2u1l3r1u5r1u1r1d6u1l1r1u4l2d5r1d1l1r1u2r1u1l1r1u3l2d4r1d1l1r1u1r1u2l1r1u2l2d4u3d4u5r1d1r1d1l1u1l1d2u1d2u4r4d6r2u6l4u1l1d4l1d1r1u1r1d1u4r4d6u1l1d1l1u5,14-2l3u1l1d2l1d1r1u1r1d2,15-3l1,13-4u1r1u1l3d1l2u1r1u1r1d3,15-4l1r1d4l2u5r1u1l3u1l1d6,15-5l1r1d2l2u4r1u2d1l3u1l1d5,15-6l1d1l1u4r1u1l3u1l1d1r1u1l1d4

;28
#####
#   #  #####
# * ####   #   #######
#  *     * #   #     #
### ####   #   #     #
  # #  ## ##   #$$$$##
  # #   # #    #    #
 ## ##  #.#    #    #
 # * ####.#### #$$$$#
 # *   ..... # #    #
 #   ####.#### # $ @#
 #####  #.#    # ####
        # ######  #
        #         #
        #  ########
        ####
Solution: l1u1l1u1d1r2u1l1u2r1l2u1d1r2u1l1,4-3l1,2-9r8,3-7d1l1d1r7,1-3r1,3-2d6,2-9r5,10-3l7u2l2d2r1l1u2r2d7,18-10l1u1l1d3r1d1l7d1l1u10r1u1l7d5l1d1r4l2u1l1u7l2d2r1l1u2r2d7,16-7d5r1d1l7d1l1u10r1u1l7u2l2d2r1l1u2r2d6,18-8l1r1u2l2d6r1d1l7d1l1u10r1u1l6,17-6d3r1d1l1u1l1d3r1d1l7d1l1u10,16-4d8r1d1l7d1l1u6,18-5l1r1u2l2d9r1d1l7d1l1u5,17-3d6r1d1l1u2l1d4r1d1l7d1l1u4,20-4l3u1l1d9r1d1l7d1l1u3,19-8u3l1u2r2d1l3u1l1d9r1d1l7d1l1u2

;29
#############
#           #
# +******** #
# *       * #
# * ***** * #
# * *   * * #
# * *   * * #
# * *   * * #
# * ***** * #
# *       * #
# ********$ #
#           #
#############
Solution: undefined

;30
#############
##         ##
# #  $ $  # #
#  *******  #
#  *. $ .*  #
# $* ... *$ #
#  *$.@.$*  #
# $* ... *$ #
#  *. $ .*  #
#  *******  #
# #  $ $  # #
##         ##
#############
Solution: undefined

;31
#######
#  $ .#
# * * #
#+ $  #
# * * #
#  $ .#
#######
Solution: undefined

;32
#######
#. @ .#
# * $ #
# $#$ #
# $ * #
#.   .#
#######
Solution: undefined

;33
#############
#..  ...  ..#
#.$$$$$$$$$.#
#.$   @   $.#
#.$$$$$$$$$.#
#..  ...  ..#
#############
Solution: undefined

;34
   #####
   #   #
   # + #
#### * #
#    * #
# $*** #
#      #
########
Solution: undefined

;35
#########
#   #   #
# # # $ #
#    ** #
# # **  #
#  ** # #
# **    #
# + # # #
#   #   #
#########
Solution: undefined

;36
##########
#  . . . #
#  $ $ $ #
## #######
#        #
#@       #
####### ##
# $ $ $  #
# . . .  #
##########
Solution: undefined

;37
   ####
   #  #
   #  #
####$ ####
#   ..$  #
#  $..  @#
#### $####
   #  #
   #  #
   ####
Solution: undefined

;38
#############
#  #  #@ #  #
#  #  #  #  #
# $#$ # $#$ ####
#   ..$.. ..$  #
#  $.. ..$..   #
#### $#$ # $#$ #
   #  #  #  #  #
   #  #  #  #  #
   #############
Solution: undefined

;39
     #####
     #   #
     # $ #
     #   #
    ### ###
#####  .  #####
#   # $.$ #   #
# $  ..@..  $ #
#   # $.$ #   #
#####  .  #####
    ### ###
     #   #
     # $ #
     #   #
     #####
Solution: undefined

;40
      #######
#######  .  #######
#     # $.$ #     #
# $ $  ..@..  $ $ #
#     # $.$ #     #
#######  .  #######
      #######
Solution: undefined

;41
#######
#     #
# $ $ #
#**@**#
# . . #
#     #
#######
Solution: undefined

;42
#######
#  .  #
# .$. #
#**@**#
# $ $ #
#     #
#######
Solution: undefined

;43
#############
#.....#.....#
#.$$$$#$$$$.#
#.$@      $.#
#.$ $$$$$ $.#
#.$ $...$ $.#
### $. .$ ###
#.$ $...$ $.#
#.$ $$$$$ $.#
#.$       $.#
#.$$$$#$$$$.#
#.....#.....#
#############
Solution: undefined

;44
#############
#.....#.....#
#.$$$$$$$$$.#
#.$@  #   $.#
#.$   $   $.#
#.$   #   $.#
##$#$###$#$##
#.$   #   $.#
#.$   $   $.#
#.$   #   $.#
#.$$$$$$$$$.#
#.....#.....#
#############
Solution: undefined

;45
#############
#.....#.....#
#.@$     $ .#
#.$$$$ $$$$.#
#. $  $  $ .#
#. $  $  $ .#
##  $$ $$  ##
#. $  $  $ .#
#. $  $  $ .#
#.$$$$ $$$$.#
#. $     $ .#
#.....#.....#
#############
Solution: u1r2d1l2u1l1d3r1u2r1u1l1d5u4r3l1d2l2r2u1l2r1d1r2u2d1l3d3r1u4r1u1l1d4l1d5r1d1l1r3u1l3r2u2l2r1u6d8r1d1l1r2u1r1u1l4r3u2l3r3u4r1u1l4r3d4l1u4d5u2l1d5u5d5r5l1u2l2u1l1d3u4r2d3r1d1l1u1l1d1u1r1u1r2u1l3r2d1r1d2l1d1r3u1l2u1l2d1r1u1r1d1l1d1r1u1r3u2l1d2l2u1r2u1r1d1l3u1r2u1r1d1l3u1r2l4r4u5r1u1l3d1r2d1r1u1d2l1u2l2d1r2d1r1u1d2l1d2l3u2r1u3d2r2l2d1r2l1u3l3d1r4l1d4u2l1d5u7l1d7u2l2u3r3d1r1u4d3l4u1r4d1r1u3d2l6d3l1d1r7

;46
#############################
#          ... ...          #
# $$$$$$$$$...@...$$$$$$$$$ #
#          ... ...          #
#############################
Solution: undefined

;47
#############################
#   $  $  $... ... $  $  $  #
#  $  $  $ ...@...$  $  $   #
#   $  $  $... ... $  $  $  #
#############################
Solution: undefined

;48
#############################
# $  $  $  ... ...$  $  $   #
#  $  $  $ ...@... $  $  $  #
#   $  $  $... ...  $  $  $ #
#############################
Solution: undefined

;49
####
#  #### #####
# *   ###   #
#  #        #
## ##*#### ##
 #    #### #
 # ##* $.# #
 #    #### ##
 # ##.####  #
 #  @$      #
 #########  #
         ####
Solution: undefined

;50
###############
#  $..$ $..$  #
#  $..$ $..$  #
#  $..$@$..$  #
#  $..$ $..$  #
#  $..$ $..$  #
###############
Solution: u1l1r1d2l1u1l2d1l1r1u2l1d1l2u2r2d2r4u2l1r1d4l1u2l5d2r2l2u2r6u2l1d1r1d1l4u2l2d1r2l2d3r2u1d1l2u1r2u1r4u1r1l1d2r1u1d1u1r2u1r1l1d2r1l1u2r1d1l4u2r1l1d2r6u2l2r2d1l2r1d1l4d1l1d1r1u2r5d2l2r1u1l1r2u2d1l5d1l2u2d1r3l2u2r1d1l1d1r1l5d1l2u1r3l2u2r1d1l1d1r1

;51
###########
#.   *   .#
# #$#$#$# #
# $  @  $ #
# #.#.#.# #
#    *    #
###########
Solution: undefined

;52
#########
# . . . #
# .@. $ #
# . $ $ #
# $ $ $ #
######  #
     ####
Solution: undefined

;53
#########
#. . .  #
#.$.$.$ #
#.$.$.$ #
# $ $ $ #
###### @#
     ####
Solution: undefined

;54
###########
#. . .  @ #
#.$.$.$ # #
#.$.$.$ # #
# $ $ $ # #
# ####### #
#         #
###########
Solution: undefined

;55
#############
#. . . .  @ #
#.$.$.$.$ # #
#.$.$.$.$ # #
# $ $ $ $ # #
######### # #
#           #
#############
Solution: undefined

;56
        #####
      ###.  #
    ###. .$ #
  ###. .$.$ #
###. .$.$.$ #
#. .$.$.$.$ #
# $ $ $ $ $ #
##########@ #
         ####
Solution: undefined

;57
#######
#     #
# *.* #
# *+$ #
# $** #
#     #
#######
Solution: undefined

;58
###########
#         #
# *.* *.* #
# $*$ $*$ #
# *.* *.* #
#         #
# *.* *.* #
# $*$ $*$ ##
# *.* *.*  #
#        @ #
########   #
       #####
Solution: undefined

;59
#############
#     #     #
# *.*   *.* #
# $*$ # $*$ #
# *.* # *.* #
#     #     #
## ####### ##
#    @#     #
# *.* # *.* #
# $*$ # $*$ #
# *.*   *.* #
#     #     #
#############
Solution: undefined

;60
#############
#          @#
# *.$ # $.* #
# *$* # *** #
# *.* # *.$ #
#     #     #
# ######### #
#     #     #
# *.* # $.$ #
# **$ # *** #
# $.* # *.* #
#           #
#############
Solution: undefined

;61
#########
#       #
# $###$ #
#  # #  #
# $###$ #
#...@...#
# $###$ #
#  # #  #
#### ####
Solution: undefined

;62
#######
#     ####
# $ $ #  #
#  * ##  #
# $ * .  #
#### * +##
   #. *  #
   #   * #
   #######
Solution: undefined

;63
#########
##  #  ##
# $ $ $ #
#  .+.  #
##$.#.$##
#  ...  #
# $ $ $ #
##  #  ##
#########
Solution: undefined

;64
#########
#       #
# . # $ #
## .#$ ##
 #. @ $#
## .#$ ##
# . # $ #
#       #
#########
Solution: undefined

;65
      ###
     # # #
    ## . ##
   ##  . ###
  ###$#.#   #
 ## .*. ...##
#    $#.#   #
# $$$ $*$ ##
#   @$ .###
 ### $  ##
  ## $ ##
   #   #
    ###
Solution: undefined

;66
#######
#.... #
#      #
##.... #
 #  #  ##
 ##$$$$ #
  #     ##
  # $$$$ #
   #    @#
   #######
Solution: undefined

;67
#######
# .@. #
#$$$$$#
# $ $ #
#.....#
#######
Solution: undefined

;68
     #####
     #   ###
 ##### #   #
 # ....### #
## $$$ $ # #
#  $ $$$ # #
# ##....@# #
#  ####### #
##         #
 ###########
Solution: undefined

;69
#########
##  #  ##
##  @  ##
#. $#$ .#
#.$ # $.#
#$ $#$ $#
#.$ # $.#
#.. # ..#
#########
Solution: undefined

;70
#############
#   * # *   #
# * * # *   #
#  $* @ **. #
# * * # *   #
#   * # *   #
#############
Solution: undefined

;71
#####
#...#
#$$$#
#   #
#.$.#
#$@$#
#.$.#
#   #
#$$$#
#...#
#####
Solution: undefined

;72
############
##       ###
## $ $ $   #
#  ######  #
# $#... #$ #
#  #... #  #
## #... #$ #
## ###.##  #
#    $$$ $ #
#   ##@ #  #
############
Solution: undefined

;73
###############
#   *     *   #
# ## ## ## ## #
# #     #     #
#   $#     # +#
# ## ## ## ## #
#   *     *   #
###############
Solution: undefined

;74
      ############
      #         .#
 ###### #######.##
##       #      .##
#@$  # $   $ # $ .#
### ####### #######
  #          #
  ############
Solution: undefined

;75
 #######
 #     #
 #$$.$$#
## ... ##
# $...$ #
#  ...  #
##$$ $$##
 #  @  #
 #######
Solution: undefined

;76
 #######
 #     #
 #$$.$$#
## ... ##
# $.*.$ #
#  ...  #
##$$.$$##
 #  @  #
 #######
Solution: undefined

;77
##### ####### #####
#   ###  #  ###   #
#.@$ #       #    #
###  #  ###  #  ###
 ## ### ### ### ##
 #  ###  #  ###  #
 #       #       #
 ##  #  ###  #  ##
  ####### #######
Solution: undefined

;78
#######
#  #  #
# *$* #
# ... #
# $*$ #
#  @  #
# $*$ #
# ... #
# *$* #
#  #  #
#######
Solution: undefined

;79
    #####
  ###   #
  #*# $ ###
#####   #*#
#   #@######
# $ #..    #
#    ..# $ #
###### #   #
 #*#   #####
 ### $ #*#
   #   ###
   #####
Solution: undefined

;80
   #####
   #   ###
 ### $ #*#
 #*#   #####
###### #   #
# *  ..# $ #
# $ #..  * #
#   #@######
#####   #*#
  #*# $ ###
  ###   #
    #####
Solution: undefined

;81
############
#  . . . . #
# $$$$$$$$ #
# . . . .$.#
########.$ #
# . . . .$.#
#@$$$$$$$$ #
#  . . . . #
############
Solution: undefined

;82
#############
###.#.#.#.###
#  $ $ $ $ .#
# $ $ $ $ $##
##.#.#.#.$ .#
######### $.#
##.#.#.#.$ .#
#@$ $ $ $ $##
#  $ $ $ $ .#
###.#.#.#.###
#############
Solution: undefined

;83
#######
#@. $ #
# . $ #
# .*$ #
# $*. #
# $ . #
# $ . #
#######
Solution: undefined

;84
###########
#@. $ . $ #
# . $ . $ #
# .*$*.*$ #
# $*.*$*. #
# $ . $ . #
# $ . $ . #
###########
Solution: undefined

;85
 ####
 #  #####
 #$ $ $ #
 # ...  #
##$.$.$##
#  ... #
# $ @ $#
#####  #
    ####
Solution: undefined

;86
#####
#   #####
# $ $ $ #
## ...  #
##$.@.$##
#  ... #
# $ $ $#
#####  #
    ####
Solution: undefined

;87
#########
#  . .  #
# .$.$. #
#.$$$$$.#
# .$@$. #
#.$$$$$.#
# .$.$. #
#  . .  #
#########
Solution: undefined

;88
#########
#       #######
# $$$$$ #.....#
# $...$ #.$$$.#
# $.$.$  .$+$.#
# $...$ #.$$$.#
# $$$$$ #.....#
#       #######
#########
Solution: undefined

;89
 #######
##  #  ##
#  $$$  #
#..$+$..#
#..$.$..#
#  $$$  #
##  #  ##
 #######
Solution: undefined

;90
  #####
 #.   .#
#..$$$..#
# $$.$$ #
# $.@.$ #
# $$.$$ #
#..$$$..#
 #.   .#
  #####
Solution: undefined

;91
   ##########
####  . . . #
#   $ $ $ $ #
#.$.@.#######
#   $ $ $ $ #
####  . . . #
   ##########
Solution: undefined

;92
  #########
  #   #   #
###.# #.# ###
#   $ # $   #
# # #.# #.# #
# $ $ # $ $ #
###.# #.# ###
  #   @   #
  #########
Solution: undefined

;93
  ########
  #@  #  ##
### $$$ $ #
#   $...# ###
# $...#...$ #
### #...$   #
  # $ $$$ ###
  ##  #   #
   ########
Solution: undefined

;94
  ###########
  # *  *  * #
### *  *  * ###
#   *  *  *   #
# + ******* $ #
#   *  *  *   #
### *  *  * ###
  # *  *  * #
  ###########
Solution: undefined

;95
 #####   #####   #####
##   ## ##   ## ##   ##
# $ $ ###     ### $ $ #
#  $  .....@.....  $  #
# $ $ ###     ### $ $ #
##   ## ##   ## ##   ##
 #####   #####   #####
Solution: undefined

;96
 #####   #####   #####
##   ## ##...## ##   ##
# $ $ ###.$$$.### $ $ #
#      ...$@$...      #
# $ $ ###.$$$.### $ $ #
##   ## ##...## ##   ##
 #####   #####   #####
Solution: undefined

;97
#######
#  .$ #
#$..$ #
#..$$ #
#.$$. #
#.$@  #
#######
Solution: undefined

;98
#####################
#   #   #   #   #   #
# # # #   # # #   # #
#   #   #   #   #   #
###*###*###*###*###*#
#   #       #       #
#@#$# # # # # # # #.#
#       #       #   #
###*###*###*###*###*#
#   #   #   #   #   #
# #   # # #   # # # #
#   #   #   #   #   #
#####################
Solution: undefined

;99
            ###
         ####  #  ##
      ####     # #..#
   ####    $## # #..#
 ###    $## #  # #  #
#    $## #  #  # #  #
# $## #  #  #   #   #
## #  #  #  #       #
#  #  #  ####      #
#  #  ####        #
#  ####          #
####           ##
 #@         ###
  ##########
Solution: undefined

;100
 #########
 #       #
## #$#$#$##
# $       #
#   .#. # #
#.#.###.#.#
# # .#.   #
#       $ #
##$#$#$# ##
 #@      #
 #########
Solution: undefined

;101
        #################
       #*****************#
      #***             ***#
      #**     $   $     **#
      #*  $              *#
      #*          ##  $  *# ##
      #*         #  #    *##  #
####  #*      $  #   #   *#   #
#  ## #*         #    ##@#    #
##  ###*   $     #            #
 ##  ##*       $#              #
  ##  #* $      #   .#     .#  #
   ####*        #   ##   # ##  #
     ##*     $  # ..         ..#
      #** $     # .. #  #  # ..#
      #***       #   #######  #
     ###**********#          #
    #   #####################
    #  ## #  #     #  # #  #
    ####  ###       ###  ##
Solution: undefined

;102
         #
         ##
        ###
        # ##
       ## ###
       ##   ##
     #### # ###
    ###     #
      # # #+###
      #      ###
    #####  # #
   ###       #
     # # # #####
     #        ###
   ##### ## # #
  ###         #
    # # ### #####
    #          ###
  ##### #### # #
 ###           #
   # # ##### #####
   #            ###
 ##### ###### # #
###             #
  # #$####### ###
 ##             ##
###################
       #####
       #####
      #######
Solution: undefined

;103
         #
         ##
        ###
        #@##
       ## ###
       ##   ##
     ####$# ###
    ###   $ #
      # #$#$###
      #   $  ###
    #####  # #
   ###       #
     # # # #####
     #        ###
   ##### ## # #
  ###  .....  #
    # # ### #####
    #  .....   ###
  ##### #### # #
 ###         $ #
   # #$##### #####
   #         $  ###
 #####$###### # #
###          $  #
  # # ####### ###
 ##             ##
###################
       #####
       #####
      #######
Solution: undefined

;104
###########
#     ## @#
#  ## ##$ #
#   #$ $  #
#...# $ $ #
#... $ $  #
#...# $ $##
#***#    *#
###########
Solution: undefined

;105
#########
#   @   #
# ##### #
# $   $ #
#  $$$  #
# $   $ #
#.## ##.#
#. . . .#
#   .   #
#########
Solution: undefined

;106
    ###############
    #             #
##### ##### ##### #####
#   # #   # #   # #   #
# $   #     #     # + #
#   # #   # #   # #   #
## ## ## ## ## ## ## ##
 # #   # #   # #   # #
 # #     #     #     #
 # #   # #   # #   # #
 # ##### ##### ##### #
 #                   #
 #####################
Solution: undefined

;107
    ###############
    #      *      #
##### ##### ##### #####
#   # #   # #   # #   #
# $   #     #     # + #
#   # #   # #   # #   #
## ## ## ## ## ## ## ##
 # #   # #   # #   # #
 # #     #     #     #
 # #   # #   # #   # #
 # ##### ##### ##### #
 #   *           *   #
 #####################
Solution: undefined

;108
####################
##................##
#  ##  $    ..    @#
# ####$ $###..###  #
# #### $ # #..###  #
#  ##    ###..#    #
# $ $ $########$$$ #
#  $ $   ###  #  $ #
# $ $ $  ###  #  $ #
#  $ $ $ # # $$$$  #
##  #  # # #      ##
####################
Solution: undefined

;109
  #####
  #   #
###$ $###
# $...$ #
#  . .  #
# $...$ #
###$ $###
 #. . .#
 # $$$ #
 #.$@$.#
 # $$$ #
 #. . .#
 #######
Solution: undefined

;110
#######
#    ##
# $$$ #
# $...#
#@$$$.#
# $...#
# $$$.#
## ...#
#######
Solution: undefined

