;1
###
#  ####
# $@$  #
# $#...#
#  *** #
#     #
####  #
    ##
Solution: r1d2l1d1r1l3u3r1l1d2r1u1l1d2r3u1l1r1u1r2d1l2d2r1u2d1l4u2r1d1l1d1r3l3u4r1d2l1d2r3u3l1r1d2r2u2l2r2d1l1d1l1d2r1u2r1u2l2d1r1d2l1u1d1l3u2r1d1l1d1r3l3u4r1d2l1d2r3u1r1u2l2r2d2l1d2r1u2d1l4u2r1d1r1l2d1r3d1r1u1l4u4r1d2l1d1r1

;2
  #####
  #@  ##
###.   #
# $*$  #
#  . ###
## * #
 #  ##
 ####
Solution: 3-2d1r1,4-5l1u2,6-3l1,4-2d1,1-3r3,3-1d1,4-3l1,4-5u2,1-3r2,2-6u1,5-2l1,3-1d1,3-2d2,4-4u1,5-2l1,1-4r1,6-3l2

;3
 ######
 #    #
 #$$@ #
 #..###
##.*  #
#  $  #
#  # ##
##   #
 #####
Solution: 2-1d1r1,2-2d3r1u2,5-5l1,2-7u2r1,4-6u1,2-3d2,3-1d2,2-7u4,3-3d1,4-5l1,2-4d1,2-1d2,5-2l2,2-1d1,5-4l1,3-5u1,2-7u1,1-5r2,4-6u1,5-4l1

;4
  ####
 ##  #
 # $ #
## * #
# ..@##
#  *  #
###$  #
  #  ##
  ####
Solution: 2-2r1,4-3l1,4-5l1,4-1d2,3-7u4,4-3d2,4-7u2,1-5r2,3-1d1,2-2d1,4-3l1,5-5l1,3-6u3,4-3d1,1-4r1,5-5l1,3-1d1,2-2d1

;5
 ######
##    ##
#   #. ##
# # @*$ #
#  .*   #
####$ ###
   #  #
   ####
Solution: 6-2d1l2,5-4l1,4-6u2,2-4r1u1r1d1,7-4l4,4-3r1,4-6u2,1-4r2,3-1d2r1d1,5-4u1,4-6u1,7-3l1

;6
  #####
###   ####
# .$.$@  #
#  $.$.  #
### # ####
  #   #
  #####
Solution: l1d1,4-3l1,5-5u1,4-3r2,3-1d2,1-3r3,5-2l2,6-3l1,3-5u2r1,5-4u1,3-1d2,1-2r2,3-5u1,4-3l1,5-1d2,1-3r2,5-2l2,5-5u2,6-2l1,8-3l1

;7
   ####
 ###  #
## $$ ###
# ....  #
#  $$   #
### @####
  ####
Solution: l1u1r2u3l1d1r1d2l3u2r2u1r1l1d2l1r2d1u1l2d2r1u1r1u1r1l1r2d1l2u1l1u2r1d1l1d1r1l1u1l2d1r1u1r2d2l1u1d2l1u1r2u3l1d1l2d1l1d1r1u2r3d2l1u1l1r2u2l1d1r1d2l1d1l1u1r4u1l1

;8
  ####
###. #
# $ .##
# # ..#
# @ # #
# $$$ #
##   ##
 #  ##
 ####
Solution: 3-4d1,5-5l1,4-6l1u3,1-5r1,2-7u2,3-4d1,3-1d1,1-2r2,4-1d1,3-4u1,2-2r1,3-3r1,4-1d1,3-7u4,2-2r1,1-4r1,3-5u3

;9
   ####
   #  #
  ##$ ###
###  .  #
# .*$*  #
# # @ ###
#   ###
#####
Solution: u1r1,4-4l1,7-4l2,3-3r2,4-3d1,4-1d2,7-3l1,5-4u1,3-4r2,1-4r2,5-5l1,5-1d2,3-6u1,4-5u2,4-4l1,4-1d2,5-5u1l1,5-4u1,7-4l1,5-1d1

;10
######
#    #
# $ $##
# #@$ #
# * # #
## .. #
 #  .##
 #####
Solution: 1-4r1,3-3d1,5-3l1,4-5l1,3-2d2,2-6u1,4-5l1,4-1d1,5-3l1,3-4u1,1-4r1,2-6u1,3-3d1,2-5r1,3-1d3,3-4d1,2-6r1,1-2r1,3-1d3

;11
    ###
  ##  #
 # $  #
# .* .#
#  $  #
###@#*#
  #   #
  #####
Solution: 5-6u3,4-3l1d1,1-3r2,3-6u1,4-4l1,1-4r2,5-3l2,5-1d3,1-3r1,2-2r1,3-4u1,5-4l2,4-1d1,2-2r1,5-3l1,4-1d2,2-3r1,5-6u3l1,1-4r1,4-3l1,3-5u1r1,5-3d1,5-1d1

;12
  ####
###  #
# $  ###
#@#.$  #
# $ $# #
## . ..#
 #  ####
 ####
Solution: 1-4r1,3-5u2r1,3-1d3,3-6u1,4-5u2,3-3d1,4-5l1,4-1d2,6-3l2d1,3-5r1,1-2r2,4-1d2,3-4u1,2-6u1,6-5l2,4-3d1,3-1d1,1-4r2u1,4-2l1,3-6u3,3-5r2,4-3d1,3-5r1,3-1d3,1-2r1,3-1d1

;13
 ####
##  ####
# .$$  #
# .@.  #
# $$. ##
###  ##
  ####
Solution: 3-1d1r1,4-3l1,3-5u1,1-4r2,4-5u1,6-2l3d1r1,3-5u1,1-2r1d1r1,3-1d1,4-2d1l1,6-3l1,5-4l1,3-5u1,1-4r2u1r1,4-2l1,6-3l1

;14
  ####
  #  #
###  ##
#  $$ #
# #*. #
# . . #
##$#@##
 #   #
 #####
Solution: 4-4u1l1,4-1d2,3-5u2,1-3r2,2-7u1,1-5r1,5-3l2,3-1d2,4-5u2,2-5r1,1-3r2d1,4-4d1,2-5r1,5-3l2,4-1d2,1-3r1,3-4u1,5-5l1,3-1d2,4-5u2,4-7u2l1,4-3d1,4-1d2

;15
   ####
   #  ####
  #  *   #
###@*.*  #
#  * $ * #
#   ##  ##
#### #  #
     ####
Solution: 4-2r2d2,3-3r1,4-4l1,1-4r1,3-5u1,6-4l3,8-4l1,7-4l1,4-3r2,8-2l2,6-6u3,4-4r1,6-3d1,6-6u2,7-2d2,5-3r1,5-1d1r1,5-4u1,8-3l2,1-4r5,3-2d1,4-4l1,6-3l1,5-1d1,8-4l2,7-6u2,4-4r1,6-3d1,8-2l2,6-6u2,7-2d2,7-6u1,1-4r1

;16
 #####
 # @ #
##$ $#
#  $ ###
# .*.  #
##.*.  #
 # $ ###
 # * #
 #  ##
 ####
Solution: r1d3l1u1l2d1r1u1r2l2d1r1l1d2r1u1r1l2u2r1d1u1r1u2l1d1r1d1l1d1l1d2r1u1r1u2d1r2d1l3d1l1d2r1u1r1u1d1l2u1r1u1r1u2l1d3u5r1d2l1d1l2u1r1d1r1u1d3l1u2r1u1r1u2l1d3l2u1r1d1r1u1l1d3r1u1l1u2r1d1u1r1u2l1d1r1d1l1d1l1d2r1u1r1u2d1r2d1l3d1l1d2r1u1r1u1d1l2u1r1u1r1u2l1d1l1d2u2r2d1l1u4r1d2l1d1l2u1r1d1r1u1d3l1r1u3r1u2l2d2r2u1l1d3r1u2l3d1r1u1r2d2l1d1l1u1r2u1r2d1l3d2r1u1l1u1r1u2l1u2r1d4l1u2l2d1r1u1r2d2l1d1l1u1r2u1r2d1l3d2r1u1l1u1r1u2l1d2u2l2d1r1u1r1l1d1r1u1r1u2l1d1r1d1l1d2r1u2d4l1u1r1u2r2l2d2l1u1d1u1r1u2l1u2d2r1l1d2u4r1d2l1d1l2u1r1d1r1u1d2r1d2l1u1l1u2r1u1r1d1l2d2r2u1d1l2u2r1d1r1d2l1d1l1u2d1r2u2l1d1u3r1d2u2d1l3u1r1d1r2u3l2d2u2d2l1d1r1u3r2d2l1r1u2l2d2r2d2l1d1l1d2r1u1r1u4d2l1d1u1r1u1r2d1l2u2l2u2r2d3u1l2u1r1u1r1d2

;17
  ####
  #  ###
 ##    #
## $.$ ##
# .***. #
#  $.$  #
### @ ###
  #  ##
  ####
Solution: 4-5u2r1,4-4l1d1,1-4r2,4-5u1,3-7u2,4-4r1,5-2l1d3,2-3r1,4-4l1,4-2d1,4-7u1,5-6u2,7-4l1,3-1d2,6-2d1l1

;18
  #####
 ## @ ##
## $.$ ##
# .***. #
#  $.$  #
##     ##
 ###  ##
   ####
Solution: 4-2d1r1,4-3l1d1,1-3r1,2-2r1,5-1d1,6-2d1l1d1l1,5-6u1,6-5u1,7-3l1,2-5r2,4-4l1,2-5u1,4-4r1,5-6u1,6-5u1l1

;19
  #####
  #   ##
###.   #
# $**  #
# *@*.##
#  *$ #
##    #
 ######
Solution: u1r1,6-3l1,5-4l1u1,1-3r2,2-5u1,4-4l1,3-1d2r1,1-3r2,5-2l1,5-2d2,4-4u1,4-6u2,5-3l1,4-1d1,2-5r1,2-3d1r1,5-6u1l1,2-6u1

;20
 #####
 #   #
##*$@####
# .*$   #
#  .*$  #
## #. ###
 #    #
 ######
Solution: 2-1d3,2-2r1,3-4u1r2d1l2,1-4r2,7-3l1,6-3l3,3-4r2,1-3r1,4-1d2l1,2-2r1,2-4u1,5-4l1,2-6u2r1,4-3d1,7-4l2,5-6u2l1,4-1d2r1,7-3l3

;21
  #####
 ##   #
 #  # #
##$..$#
# .$$.##
# $..$ #
## #@  #
 #   ###
 #####
Solution: u1l1r1d1r2u1d1l2d1l2u1d1r2u1r2u1l1u2d3u3l1r1d3l1d1l2u2d2r2u1r1u1l1r1l1d2l2u2r1l1d2r2u1r1u3l2d1u1r2d1l1r1d2l1u1r1u2l2u2r2d4l1u1d3l2u2r1u2d1r2d1l1d2l2u2l1u1r2l1d3r2u2r1u4l2d1l1d3u3r1u1r2d3l1d3l2u3r1l1d3r2u2r1u4l2d1u1r2d4l1d2l2u3r1u1d1l1d3r2u2l1r1d2l2u2r4d1l1u1l3d2r2u1r1u5l2d3u3r2d5u2l1r1d2l1r1u5l2d2r1d1r1u1d3l1u1d2l2u2r1l1d2u2r2d1r2u1l1u2l2d1u1r2d3u2l1r1d2l1u1d2l2u2r1l1d2r2u1r1u1l1r1u2l2u2r2d4l1u1r1u3l2d2r1d1r1u1l1d4l2u2r1l1d2r2u2r1u2l2d1u1r2d2l1u1d3l2u2l1u1r2l1d3r2u2l1u1l1d1r1u3l1d2r1d1r2u2l1r1d2l1u1l3d1r1u1r2d3l2r2u3l2u2r1u1r2d2u2l2d1l1d2r2d3l2u2l1u1r2l1d3r2u2l1r3d1l1u1l2u1l2d1r1d2r2u1r1u2l1r1d2l1d1l2u4d1u2r1u1r2d3u3l2d1l1d2r2l3d1r1d2r2u2l1u1l2d1r1u3r1d1u2r2d2l1r1u2l2d1l1d5r2u3l1r1d2r2u1l1

;22
 #####
 #   ####
 # #    #
 #$$..  #
## ** ###
# ..$$#
#  #  #
## @ ##
 #####
Solution: l1u4r3l2d1u1r2d1l1u1l2d4r2u3r1u1l1u2d1r3d1u1l3d4r1u2l1u3l2d3r1l1u3r2d3l2r3d2l1u1r1u1l1u3l2d2u2r2d1r1d2u2r2l3d4r1u2l1u3l2d3r1l1u3r2d2l1d1l1u1r2d1r1d2l1u1r1u1l1d3l2u2r1l1d2r2u1r1u2l1u1l2d2r1u1r2d2l1u1r1u1l1d3l2u1l1u1r1d2r2u5r1d2u2r2d1u1l3d5l2u3r1l1d3r2u3r1u2l1d2l2d3r2u1r1u2l1r1d2l1u1r1u1l1d3l2u2r1l1d2r2u1r1u2l1u3l2d3u3r2d3r1d2l1d1l2u1l1u1r1d2r2u1r1u2l1u2r1d2u2r2d1l2u1l1u1l2d6r2u1r1u2l1u1r1d3l1d1l2u6r2d1r1d2l2r2u2l1u1l2d3u3r2d2r1d1l1u3l2d2u2r2d3r1d2l1u1r1u3l1u1l2d2r1l1u2r2d1r3d1l1

;23
  #####
  #   #
##@ # ##
#  $$..##
# #.$$. #
#  ..$$ #
####  ###
   #  #
   ####
Solution: r1d1u2r2d2l1d1u1r2d1l1d1l2r2u4l2d1l1d1r1u2r2d4l2u2l2d2u2r3l1d2r2u1l1u1r1l1d4r1u2l1u2l3d2r2l2u2r3d2u2r1u2l2d1l1d1r1l2d2r4u2d1r2d1u1l2u1l1r1d4l1u2r1u1r2d1l1u1l1d1l4u2r1u1r1u1r2d2l1d1r1d1l1d2r1u2l1u2r1u2l2d1l1d1r1l2d2r2l2u2r2u2r2d2l1d2r1l4u2r2d1r1d1l1u4r2d2l1r1u2l2d2r1d2r1u1d3l1u1r1u2l1u1l3d2r1

;24
    ####
#####  #
#  ##  #
#   $*.#
#  #*@*##
##  .*$ #
 ## #   #
  #   ###
  #####
Solution: u1l2,5-4d1,4-5u1,5-3l1,5-7u2,7-5l1,6-3d2,4-4r1d1,5-1d2,6-5u2,5-7u1,7-6l1,4-5r1,6-4l1,5-7u1,6-6u1l1,6-3d1,6-1d2,2-2d1r3,2-5u1,1-3r3,7-5l1

;25
 ####
 #  #
 #  ##
 # . ##
 #$*  ##
## **  #
#   *$ #
# @ .###
###  #
  ####
Solution: 2-5u2,4-4l1,2-3d3,3-6u1,2-1d2,5-5l1d1,2-5r1u2,5-5l1,4-8u2,1-7r2,4-6u1,6-6l1,5-4l1,2-3d2r1,3-1d1,1-6r1,3-7u1

;26
  ####
 ##  ##
 #    #
##*$* ##
# .@.  #
# *$*  #
#   ####
#####
Solution: u1d1l2d2r2u1r1u1l1r2l2u1r1d2l1d1l2u2r2u1r1u2l1d3l2d2r2u1r1u2d2l1d1l1u1r2u1r2d1l3r1l1d1l2u1r3u2l1d1r1d1l1u1r3d1u1l3d2l2u2d1r1d1r1u1r1u1r2d1l3r1u2l1u2r1d1r1d1u1l2d1r1d2l1u2d3l2u2r2d2l1r1u3r1u2l1d1l1d1u1r2d1l1d2r1u1d1r2u1l1d1l2u3r2d2r1d1l1

;27
 #####
 # . ##
## $  #
# * * ##
# ***  #
#  @   #
########
Solution: u1,4-2l1,3-4u1r1,3-4r1,1-3r1,1-4r1,2-1d2,4-3l1u1,3-5u1,1-4r1,2-2d1,4-3l1,1-3r2,2-5u1,4-4l1,6-4l1,5-4l1,1-3r1,5-2d1,2-5u1,4-4l1,6-4l1,3-2d1

;28
  ####
  #  #
###  #
# $$ ###
#. .$. #
# .*.  #
##$ $###
 # @ #
 #####
Solution: l1u2r1u2r1u2l1d4l2u2r1l1d2r2u2d2l1r1u2r1u2l1d2l2d2r3u2d2l2d2r2u1l1u1l2u2r3d2u1r2d1l3d2r1u1l1u1r1u2l1u2r1d4l1u2l2d1u1r2d4r1u2l1u2l2d2r1l1u2r2d2l2u1r1d1r2d2l2u2l1u2r3d2u2d1r2d1l2u2l3d2r1d2r2u2d2l2u2r1l2u2r2d1r1l2r2u3l1d2l1d4r2u1l1d1l1u1

;29
 #####
 #   ###
## *.* ##
#  $*$  #
#  *.*  #
### @  ##
  #  ###
  ####
Solution: u2r1d1l1u1l1d1l2u1d1u1r1u2r2d2r1d1l2r1u3l2d2r1d1r1u1d1r3u1l2d1l2u1l2d1r4l1d2l1u1r1u1l1r2u1r2d1l1d1l1r1u2l1d1l2u1r2l2d3r1u1l1u2r2d1r1d1l1u2l2d1r1l1d2r1u1r2u1r1u1l2r1d2l3u2l2d1r1

;30
  ####
 ##@ #
 # $ #
## * #
#  ..#
#  * #
###$ #
  #  #
  ####
Solution: 4-5l1,2-2r1,3-7u2,4-3l1,4-1d4,3-5u2,4-7u2,1-5r1,3-4d1,3-1d1,2-2d1,4-3l1,1-4r1,4-5u2,2-2d1,3-5u1,1-4r1,4-1d2,3-7u1

;31
 #####
 #   ###
## $$  #
# * .*.#
#.*. * #
# @$$ ##
###   #
  #####
Solution: l1u2r1u2r2d1r2d2l1d2u2l1r2u2l2u1l2d3u3r2d1r2d2l3r2d2l2u1r1u1r2u2l2d1r1l1u2l2d2l1d2r2d1r2u2d2l2u1r1d1r1u1l4u2r1u2r2d2l1d1l1d1r1u2r1u2l1d1l1d1u1r2d1l1d3r2u1l1u1d2l1u1

;32
  ####
 ## @###
## $$$.#
#  .$..###
#  ..$.  #
###.$$$  #
  #   ####
  #####
Solution: l1d1l1d2r3l3u2r1d1r1d1l1u3r1d1r1l2d2r1u1d1l1r2l2d2r2u1r1u1d1l1d1l1u1r2u1r2d1l3d1l2u1r3l3u2r1d1l1u3r1d2l1d3r2u1l1d1l1u3r1d1l1d2r2u1d1l1u1r2u1r2d1l3d1l2u1r1l1u2r1d1r2l3d2r2u1d1l2u3l2d1r2d2r2l2u3r1u2l1d1r1d1l1d1l2u1r1d1r1d2r2u1d1l2u3r1u2l1d1r1d1l1d3r2u1l1d1l1u3r1d1l1d2r2u1r1u1l2u1l1d1r1u3d3u3l1d1l1d1l1d1r1u2r2d2r1d2l1u1r4u1l1

;33
 ######
 #    #
## ## #
#  $. #
# ***.#
## $@ #
 #   ##
 #####
Solution: l1,2-3r1d1r1,1-4r1,5-3l1,2-6u3,4-3l1,2-4r1,4-3d1,1-3r1,2-1d2,1-4r1,4-6u1,2-3r1,4-5l1,2-6u1

;34
  ####
 ##  #
 # . ##
## *  ##
# *$*  #
#  *   #
#  @####
#####
Solution: 2-5r2u2l1d1,4-5l1,1-4r2,6-5l2,3-4r1,3-6u1,2-2d1,3-5u1,1-4r1,4-1d1,4-4l1u1,6-4l1,5-3l1,1-5r1

;35
  #####
###   #
#  @# #
# #...##
# $.$. #
##$$$# #
 #     #
 #######
Solution: u1r2d3r1d2l3u2r1l1d2r1u2d2r2u2l1u3l2d3u2l2d2r1l1u2r2u1r2d2l1r1d1r1d2l2u2r1u3l2d1l2d2r3l3u2r2d1r1d1l1r1d2r2u2l1r1d2l2u2l1u2l2d2r3d2l2u1d1r2u2d2l2u1r1u3l2d2r1d1r1u1d2r3u2l2r2d2l4u2l1u2r2u1r2l2d1l2d2r2d2r3u2l2r2d2u2l1u1d1r1d2l4u2r2l3u2r2d2l1d2r4u2l2r1u1l1r1d1r1d2l4u2l1u2r2u1r2d1u1l2d1l2d2r1d2r2u2d2l2u2r2d2l1u1

;36
 #####
 #   #
## *$###
# *@*  #
# .*   #
##   ###
 #  ##
 ####
Solution: d1,3-3r1,4-5l1,1-3r1,4-1d2l1,2-2d1,4-2l1,4-5u2,1-4r1,6-3l3,4-1d1,3-3r1,3-5u2,1-3r1,2-1d2,1-4r1,4-3l1,2-6u1,6-3l1

;37
  ####
 ##  #
##   #
# $ $##
# ... #
# $.$ #
##@.$##
 ##  #
  ####
Solution: u1,1-3r1,4-4u1,3-2d1,5-5l1,2-5u1,1-3r1,4-1d3l1,3-6u1,5-5l1,4-7u2,4-5u1,2-3d1r1d1,5-4l1u1l1,2-2d1,1-5r1,4-1d2

;38
 #####
 #   #
 # # #
##..$###
# $*$  #
# $..  #
#  @####
##  #
 ####
Solution: 3-5u1r1,1-4r1d1,4-2d1l1,2-2d2,1-6r1u1,4-5u2,3-3d1,6-4l2,2-3d1,2-6u1r2,2-3d1,3-5u1,6-5l2,4-1d2,3-4r1,6-4l2,2-6u2,2-5r1,3-7u1

;39
  ####
  #  #
###  ###
#   $$ #
#+**...#
#   $$ #
###  ###
  #  #
  ####
Solution: u1r2d1r1d1l1u3r1d1l1d2r1u2l1d4r1u2l1u2l2d2r1l1u2r2d2r1d2l1u2l2u2r3d2u1r2d1l3d2r1u1l1u1r1u2l1u2r1d4u1r2u1d1l2d1l1u2d4r1u2l1u2l2d2r1l1u2r2d2u1l1r1d1r1d2l1u2l1u2r2d2u1r2d1l2u2l2d1r2u3l1d2r1d2r2u2l1r1d2l2u2d1u1l2d2r2l1d2r1u2l2u2r2d1l1d2r1u1l1u2r3d2l2r2u2l3d2u2r1d1l1d1r1l1u4r1d2l1d2r1d2l1u4r1d2u2r2d2l1r1u2l3d2r1l1d2r1u2l1u2r1u2l1d4r1u2r2d2u2l2d4l1u2r1u2r2d2l1r1u2l2d2u1r1l1d1l1d2r1u2r1u2l2d1r1d2l1u1r1u2l1u2r1d2

;40
  #####
### @ ###
#  .$.  #
#  ***  #
###$.$###
  #   #
  #   #
  #  ##
  #####
Solution: l1d1u1r2d1l1d1l1d2u2r2d1u2r2d1l1u1l2d1l1d2r1l1u2r2l2d2r1d1r1l1u1l1r1u2r1u2l2r2d1u1l2d2u1l2d1r2u2r2d1l2r2d2l1u1r1u1r2d1l1u1l1u1l2d2r1d2u1r1u1l2u2r1d1r1d2l1u1d3r1u3l2u2r1d2l3u1d1r4d2l2r2u2l4u1r2d1r1d1r1d2l1u1l1u1d1r2u2l2r1d1l1u3r1l1d3u2l2d1r2d1r2l2u3r2d1l2d2r2u1d1l1u1l1d1r2d2l1d1l1u2d1r2u2l1d1u2l1u2r2d3u3l1d1l1d1l2u1r2u1r2d3l1d1l1u1r2u2l1r1d1r2u1l1d1l1d1l2d3r1u1r1u2d2l1u1

;41
#######
#  #  ##
#  #   #
# .*$# #
#  *@  #
# .*$###
## # #
 #   #
 #####
Solution: u1l1r1d2l1u1l1u1d1r2u1l1d1l2d1r1u1d1u1r4u2l1u1l1d2l1d1r1l2d3r2u2l1r1d2l2u2r1u2r1d2u3r2d2l2d1l2d2r2u4d2u2l1d1r1d3l2u2l1u2r1d1l1u3r1d1l1d2r5u2l1u1l1d2u1r2d2l2

;42
###
#  ######
#    $   #
#  **.**  #
#   *@*   #
##########
Solution: r2u1d1l4u1d1r2u1l1u1l1r1d2l1u1d1r4u1l1r3d1u1l4r4d1l2u1l2d1l2u1r4l6u1d2r2l2u3r1d1l1d2r2u1r1u1l1d1r3u1l2d1r3d1r2u1l1u1l2d1r1l4r4d1r2u1l1u1l2d1l1d1r2l1u2d1l2u1d1r2u1r2d1r1d1l2r1u2l2d1r1l3u1r2l2d1l1d1l2u1r3l3u2r1d1l1d2r2u1r1u1l1r3d1r1d1r2u1l1u1l4d1r1l2d1l2u1r3l3u2r1d1l1d2r2u1r1u1l1d2l2u1r2l2u2r1d1l1d1r1

;43
   #
  ##
 #  #
 # $ #
# .$.#
# $.$ #
# .$. #
###@###
 #  #
 #  #
 #  #
 ####
Solution: u1l2u2r2d4u2r2u1l1d1l3u2r2d1u1l2d2r2u1r2d1l2u2l1u2r1d1r1d2l1u1r1u1l1d5l1d2r1u5r2d1l1u1l1d2u1r1u3l1d1l2d2r2u1d1l2u2r2l1d1r1u3l1d1r1d5l1d2r1u4

;44
#####
#   #
#   #
#*+*#
#   #
#*$*####
#      #
#  #   #
########
Solution: d1l1u1d1r2u1l2d2u1r2d1u1l2d1r1d2l1u2d1r3d1r2u1l3u1l1u2r1d2l2d2r1u2d1r2d1r2u1l3u3l1u2r1d4l1u2d2l1d2r1u2d1r1u3l2d1u1r2d2l1d1l1u1d1r3d1r2u1l3u3d2l2d2r1u1r1u3l2d2r1u1d3l1u1r1u2r1u3l2d1r1u1r1d1

;45
   ###
  # @ #
 # .#. #
 #$$*$$#
#  * *  #
#   .   #
####. ###
   #  #
   ####
Solution: l1d1l1d2l1d1r3l2u3r1u1r1l1d1l1d3r2u1r1d1l3u3r1u1r2d2u2l2d1l1d2r1l1u2r1d1u2r2d2l1r1u2l2d1l1d3r3u2l2r2d2u2l2u1l1d1r3d2l2u1d1r2u2l2r2d2r2u1d1l3d2u2r1u1l1d1r3u1l1d1u1l1u1l2u2r2d1r1d1l1d2l1r1u2r1l1d2l2r3u1d1l2d2r1u1l1u1r1u4l2d1u1r2d4l1r1u4l2d2r1d2u1r2l2u1l1u2r2d2l1d2r1u2d4l1u2r1u2l2u2r2d4l2r1d2r1u4d1r2d1l1u1l1d1u2l2u2r2d1r1d1l1d2l2u2d2u2d2r2u2d2r1u1d1l3r2u3r1d1l1d2l2u2r2d2l1d2r1u2l2u2r1d2u2r1u2l2d2r1d2r1u2d4l1u2r1u2l2u2r2d4l2u2r2d2l1d2r1u2l2u2r1d2l3u1r2u1r2u2l2d1l1d1u1d2r1l1u1r1d2r2u2d2l2u4r2d2l1r1u2l2d1l1d2r1d1r2u1d1r2u1l1d1l3u1l1u2r1u1r2d1r1d1l1u2l2d1l1d2r1u1d2r2u2d1u1d2l2u2r1l1d2r2u1l1u1l2d1l1d1r2l1u2r2d1r1d1r2u1l1u1l1

;46
 ####
 # @#
 #  #
##$$###
#     #
# #   #
#.*.*##
##   #
 #  ##
 ####
Solution: 3-2d2,1-6r1,4-7u2,2-6r1,3-4d1,2-2d1,5-4l1,3-5u2,3-5d1,3-8u1,4-7u2,3-5d1,4-7l1,1-4r1,3-3d2,2-6r1,5-4l1,4-7u1,3-3d2,2-6r1,2-8u1,5-5l1,3-4d2l1,3-8u1,4-7u1l1,3-1d4,4-4d1

;47
   ##
  #  #
 ##. #
 # . #
##$.$###
#@$.$  #
# $.   #
###  ###
  ####
Solution: r1,1-6r2u1r1u2,2-3d2,4-4l1,4-7u2,1-6r1,6-5l3,4-3d1,3-5r1,3-7u2,1-5r1,2-3d2,4-4l1d1,4-1d2,3-7u2,1-6r1,6-5l3u2,4-3d1,3-5r1,3-7u2,1-5r1,2-3d2,1-6r1,4-5l1u1,2-4d1,3-7u2,1-6r1,6-5l2

;48
 ####
 #  ######
 #       #
 # $@#$# #
##.*..*. #
#  *  * ##
# #$##$##
#      #
########
Solution: u1l2d1r1l1d2r1u1l1u2r6d2l5u1d1r1l1u1l1u2r1d1r5d2l4u1d1l1u1l1u2r1d1l1d1r1d2l2d2r2u3r2d1l1u1r3d1l2u1l2d1l2d2r5u2r1u1l2r1d3l5u2r4u1r1d1l5d2r2u1d1l2u2r2u2l1d1r1d3l2u2r1u1r1d1r2u1l1r3d1l1u1l2d1l3d2r5u2r1u1l2r1d3l5r5u2l2r3u1r1u2l2d1u1r2d2l1d1l2u1r1d3l5u2r4u1r1d1l4u2r1d1r1d1u1l2u3r1d1l1d2r2d1r2u3l3d1l1d2l1d2r5u2d2l5u2r4l4d2r2u1d1l2u2r1u2r1u1r1d1u1l1u1l1d2

;49
 ####
 #  ######
 # $   $ #
 #   # # #
##***.**@#
#  .  . ##
# # ##$##
#      #
########
Solution: u2l2d2u2r2d2l1d1l1u1d1l3u1r1u2r2d2l1d1l1u1d1l1d2l2u2r2u1r3u2l3d1l1d1r1d3l2u2,2-1d2r1d4l2u2r1l1d2r2u4l1d1r1d3l2u2r1u1r1d1l1u4r1d1r3d2l3u1l1u1r1d3l2d2r2u4d1r2d1l1u1l1d1u1r4d1l2u1l2d1l2d2r5u2r1u1l2r1d3l5u2r4u1r1d1l5d2r2u1d1l2u2r4l2u2l1u2r1d4r2u1r1u2l2r2d2r2u2l3,3-4r3u2r2d2l1d1l1u1l3d1l2d2r5u2r1u1l2r1d3l5u2r4u1r1d1l5d2r2u1d1l2u2r4l2u2l1d1r1d1r2u1l2d3l2u2r2u2l1d1r1d3l2u2r1u1r1d1u2l1u2r1d1l1d2r6u2l5u1l1d2,3-4u1l1u1r1d3l2d2r2u3r2d1l2r2u1r2d1l2r2u1r1u2l2d1u1r2d2l1d1l2u1r1l3d1r2l2d2l2u2r2u1r2d1l1u1r2u2r2d2l1d1l1u1d1l1u1l2d1l2d2r5u2r1u1l2r1d3l5u2r4u1r1d1l5d2r2u1d1l2u2r4l2u2l1d1r1d3l2u2r1u1r1d1l1u4r1d1l1d2r1u1d2r2u1l1r3d1l1,6-7u2r1u1l2r1d3l5u2r4u1r2d1l2r2u1r1u2l2d1u1r2d2l1d1l2u1r1d3l5u2r4u1r1d1l4u2r1d1r1l2u3r1d1l1d2r2d1r2u3l3d1u1r1d1l2d2l1d2r5u2d2l5u2r4l4d2r2u1d1l2u2r1u2r1u2l1d2

;50
   ###
  # @ #
 # $#$ #
 # .*. #
#  *.*  #
#  $ $  #
####. ###
   #  #
   ####
Solution: l1d1l1d2r1l1u2r1d1r2l1d2r1l2u1r1u1l1r1d2r1d2l1u2l1u2r2d2l1u1r3d1l2u1l2u3r2d1r1d1u1l1u1l2d3r2d1r2u1l2r1u2l1u1l2d3r2d1r2u1d1l1u1l3u3r2d1r1d1u1l1u1l2d3r2d1r2u1l2r1u2l1u1l2d4r2u1l1d1l1u1r3u2l1d1r1d1l1d1l1d2r1u3r2d1l1u1l1d1l2u1l2d1r4u1l2r3u2l1d1r1d1l1d1l1d2r1u3r1u2l1d1u2l2d2r1d2u2l1u2r2d1r1d2l1d1l1u1d1l1u1d1l2u1r2d1r2u1r2d1l4u1l2d1r4u1d3l1u1r1u1l2r2u1r2d1l1u1l1d1l2u1l2d1r4u1l2r3u2l1d1r1d1l1d1l1d2r1u3d1l2u2d2r2u1r2d1l1u1l1d1r1u3l1d1r1d2l3u2r2l2d2r1u1d1r2u1l1u2r1d1l1d2l2u2r2l2d2r1d2r1u2l2u2r1d2u2r1u2l2d2r1d2r1u2d2r2u1l2u1l2u2r2d1r1d1l1d2r2u1l1d1l1u1d1l2u1r1d1l3u1r2d1r3u3l1u1l2d1l1d1,1-4d1r1l1u1r1

;51
  ####
 ##  #
## . ###
# $  $ #
# ..$  #
#####@ #
    ####
Solution: 6-3l1,5-3l1,2-2d1r1,3-4r1u1,1-4r2,5-5u1,6-3l3,1-3r1,3-4r1,4-1d2,3-4u1,5-5u1,6-3l3,3-4r1,3-1d1,2-2d1,3-4u1,6-4l2

