;1
###########
#     #   #
# $$$ #$# ####
# $ $ $  ... #
#  #  ###..# #
#  ## #....# ##
#  $  #....#  #
#  $$$#### $$ #
###@  #  #    #
  #####  ######
Solution: r2u2l2r2d2l2u1l2u6r4d2r5l5u2l4d6r1u1d1r1d1r2u2l2d1l2u6r4d5u5l2d1r1u1r1d3l1u1r1u2l4d1r1l1d2r1u1l1u2r4d2l2r7l1u2l2d1u1r2d2l4r5d5r3u2l1u3l3u2l2d2r1l1u2r2d4r1d1l2r1u3l4u2l2d1r1l1u1l2d6r2u1r2u2l1u1r4l1u2r2d3r1d1l2r1u2l4d3l2d1l2u6r4d1u1l4d6r2u1r2u2l1u1r4l1u2r2d3r1d2l2u1r1u1r1u1r1l1d3u3l6r1u2l2d1r1u1r1d1l1d1r4l1u2r2d4r1d1l1u3l5u2l3d1r3u1r1d1l1d1r4l1u2r2d3r1d1l1u2l5u1l3d1u1r3d1r8d3r1d2l3u3d3r2u1l1d1l1u2d1u1l1u3r3d3u3d3r1d1l2d1l1u1r2u4l8u1l3d2r1u1r6l1u2r2d4u2l8u2r1d1l1d1r7l1u2r2d3u1l4d3l2d2r2u4l1u1r4l1u2r2d2l4d3l2d1r1d1r1u4l1u1r6l9d3r3d1r1u3l1u1r5l8d3r1u2l1u1r7

;2
###########
#   ##   @#
# #$#. $$ #
# $  .## $##
# $##.## $ #
# $.....   #
#  ##.## ###
# $##.##$$ #
##   .     #
 ###########
Solution: l3d1l1d3r5u1l1d1l4u3r1u1r3d3r1d1l2r1u4l3d1l1d6l3u1l1u2r1l1u2r2l2d4r1d1r3u6r1u1r3d4l4d3l3u1l1u4r3l3d4r1d1r3u3r4u4l3d1l1d1l4d4r1d1r6u2d2l6u1l1u4r4u1r1u1r3d4u4l3d1l1d1l4d4r1d1r3u3r3d3r2u1l1d1l4u3r3d2u2l3d3r3u3l2r2d3l6u1l1u4r4u1r1u1r3d2l1d2l3d3l3u1l1u4r4u1r1u1r3d3r1d1l3r2u4l3d1l1d1l4d4r1d1r6u3d3u3r1u4l3d1l1d4u4r1u1r3d4l2r1d3l6u1l1u3d1r1u1l1u1r3l3d4r1d1r6u3r1u4l3d1l1d3u3r1u1r3d4l3r3u2l1d1r1d1l2r2u4l1d3r1d1l1d3l6u4l1u1r3l2d5r6u7l2d1l1d1u1d1l4u2r2d1u1l2d2r3l2d5r6u1r2d1l4r2u6l2

;3
##########
#    #   ####
# $ $$ $$#..#
# $  #   #..###
# ##$  $$#..  #
#  $ ##$  ..  #
# $  $ $@#..  #
#    #   #..###
##########..#
         ####
Solution: 6-6l2,4-5l1,4-3d2,8-3d2,4-7u1,8-7u1,6-4r1,6-6r1,7-4d1r3,12-5l1,10-6u3,8-3d1,7-5r3,12-5l1,10-4d3,8-7u1,7-5r3,12-5l1,10-4d2,6-6r1,8-7u1,7-5r3,12-5l1,10-6u2,8-1d3,7-5r3,11-6u3,6-2r1,8-1d3,7-5r3,11-4d3,4-4d1,4-1d1r3,8-1d3,7-5r3,11-6u2,4-4u1,3-2r4,8-1d3,7-5r3,11-4d2,1-2r6,8-1d3,7-5r3,11-4d1,12-6l1,4-7u4,3-2r4,8-1d3,7-5r3,11-6u1,12-4l1,1-3r2,4-4u1,3-2r4,8-1d3,7-5r4,12-6u1,13-4l1,1-5r2,2-7u1r5,8-7u1,7-5r4,12-4d1,13-6l1,4-4d1,3-6r4,8-7u1,7-5r3,1-5r2,4-4d1,3-6r4,8-7u1,7-5r2

;4
          ####
 ##########  #
 #           #####
## # ######   $  #
# $  #    # #### #
# $  # #   ......#
#  $$#    ########
## $@#    #
 #  ##    #
 ##########
Solution: l1u1,1-4r1,4-7u3,15-3l3,11-2d2,12-5l3,8-4d2,9-7l1,4-4u1,3-2r8,12-1d1,13-3l1,11-2d2,12-5l3,8-4d1,9-6l1,2-4r1,4-5u2,3-2r8,12-1d1,13-3l1,11-2d2,12-5l3,8-4d2,6-6r2,9-5d1,2-6u1,1-4r2,4-5u2,3-2r8,12-1d1,13-3l1,11-2d2,12-5l3,8-4d1,9-6l1,2-5r1,4-6u3,3-2r8,12-1d1,13-3l1,11-2d2,12-5l3,2-8u2,1-5r2,4-6u3,3-2r8,12-1d1,13-3l1,11-4u1,9-8u2,6-6r2,8-4d1r7,9-7u1,8-5r6,7-6r1,9-7u1,8-5r5,7-8u1r1,9-8u2,8-5r4,6-6r2,9-7u1,8-5r3,11-1d3

;5
 ##############
 #    ##      #
##$ $ ## $#$  #
#  $  #.$ # $ #
#   # #... $  #
# $ $$#.#.#  ##
## #$  ...#@ #
 #   $#.#.##$#
 ##   #...   #
  ############
Solution: 12-4u1,11-3d1,12-8u4,5-6u3,4-3l1,3-5r1d1,5-4d1,4-6r4,9-7u2,10-4l2,8-4u1,7-3d3,1-5r1,2-5r1,3-5r1,5-4d1,4-6r4,9-7u2,10-4l1,5-8u1,4-6r4,9-5d2,10-8l2,3-7r1,5-8u1,4-6r4,9-5d1,9-6d1,10-8l1,5-1d1,5-4u1,5-1d4,4-6r4,9-5d2,3-2r1,5-1d5,5-8u1,4-6r4,9-5d1,1-3r3,5-2d3,4-6r4,2-1d3,1-5r3,5-4d1,4-6r3,9-4l1,7-3d2,11-1d2,12-4l4,7-3d1,9-1d2,10-4l2,11-6u1,12-4l3,8-1d1,9-3l1,13-3l1,11-2d1,12-4l2,9-3d1,12-1d2,13-4l3

;6
   ########
####  #@  ##
#   ..$$#  #
# $#..#  $ #
#  #..# $  #
# $#..#$$$ #
#  #..# $  #
# $#..$  $ #
# $ ..#   ##
###########
Solution: 10-7l1,7-7l1,6-7l1,4-8u4,1-8r3,9-7l4,4-8u2,4-4u1,3-2r1,4-6u2,5-1d3,9-4d1,9-2d1,7-4d2,8-7l3,4-8u2,5-4d1,7-1d2,7-2l1,5-1d3,4-4u1,3-2r1,5-1d2,4-6u3,3-2r1,5-1d1,7-3d3,8-7l3,4-8u4,9-5d1,10-7l5,4-8u3,9-3d3,10-7l5,4-8u2,9-6l1,7-5d1,8-7l3,4-8u1,2-6d1,1-8r2,9-5l1,7-4d2,8-7l3,8-3d3,9-7l3,2-4u1,1-2r3,2-6u3,1-2r2

;7
   ######
####....####
#  #.... $ ##
# $$....# $ ##
#  #....#  $ #
# $## # ## $ ##
#   $ $ ##  $ #
# $ $#$ #@$$$ #
#    #  #     #
###############
Solution: 13-6l1,12-4l1,11-3l1,10-2l4,6-2l1,4-1d2,12-6l1u1,10-5u1,9-4u1,12-4l1,11-3l1,10-2l3,5-2r1,7-3u1,10-5u1,9-4u1,11-3l1,10-2l3,6-3u1,9-4u1,10-2l4,5-3u1,11-8u3,12-4l1,10-5u1,11-3l1,9-4u1,10-2l5,4-3u1,5-6l2,1-6r2,1-7r1,2-4d1,2-2d1r3,6-2d1,2-5u1,1-3r4,2-7u2,5-6l2,2-5d1,7-6l2,6-8u1,5-6r1,7-5d1,2-5u1,1-3r3,5-2d1,5-6l1,2-8u4,1-3r3,4-6l1,2-7u3,1-3r2,9-7r1u3,11-3l1,9-4u1,10-2l5,11-8u1,11-7u2,12-4l1,10-5u1,11-3l1,9-4u1,10-2l4,13-7l2,10-8u2,10-6u2,11-3l1,9-4u1,10-2l3,7-8u5,3-8u1,2-6r4,7-7u3,4-8u1,3-6r3,7-7u2

;8
######   #####
#    #   #   #
#    ##### $ ##
# $$  $  #$ $ #
## ##### $  $ #
 #...... #$$  #
 #.####.##    #
 #...... $$$$ #
 #####  #    @#
     ##########
Solution: 13-3l1d1,10-4u1r1,10-6u1,10-8u1l3,2-4u1,1-2r1,11-4d1,10-5d1,10-6r1,10-3d2,8-4r3,11-8u3,5-7r1,7-8u1,4-3l1,2-2d3,2-7u4,7-3l3,7-7u1,8-5l1,5-5r1,8-5l4,11-7l3,7-8u2,8-5l3,10-5d1,11-7l3,7-8u2,8-5l2,13-3l1,10-1d5,11-7l3,7-8u2,8-5l1,12-3l1,10-2d4,11-7l3,7-8u2,13-7l5,7-8u1,11-3d3,12-7l8,11-1d5,12-7l7,13-4l2,10-3d3,11-7l5,13-6l2,10-5d1,11-7l4,12-4d2,13-7l5,2-1d5,4-3l1,2-2d3,4-2l1,2-1d3

;9
   ##########
#### @#  #  #
#..# $$  #$ #
#..   #   $ #
#  ## # $#$ #
#..#  #$ #  #
#  # $$  #$ #
#..   #     #
#..####  ####
####  ####
Solution: 5-7u1r2u1,8-5u2,8-5d1,7-3d2,8-6l3u1,4-5d1,5-7l3,1-8u2,8-1d2,8-8u1,11-3l3,7-2d3,8-5d1l3,8-5u2,8-8u3,5-3d2,4-5d1r1,5-7l2,2-6d1,5-6r2,5-1d2,5-3d2,5-7u1,7-2l2,4-1d1,5-3l2,5-4d1,2-2d3,1-6u1,1-3d1,2-7u3,2-2d3,1-6u1,5-7u1,10-1d1,11-3l3,8-1d1,7-4u1r1,8-2l3,4-1d1,5-3l2,5-4d1,2-4u1,2-7u1,1-3d1,6-6l1,4-5d1,5-7l3,1-6d1,10-3l2,7-4u1,8-2l3,4-1d1,5-3l3,1-4u1,10-5u1,11-3l3,7-4u1,8-2l3,4-1d1,5-3l3,10-7u3,11-3l3,7-4u1,8-2l3,4-1d1,5-3l2,8-5d1,9-7l1,7-8u1,8-6l3,4-5d1,5-7l3,8-3d3,9-7l1,7-8u1,8-6l3,4-5d1,5-7l2

;10
 #############
 #           #
 #$$ $ ##  $$#
 # # ####$   #
 #  ...## $$ #
 # #.#. $$  $##
##..... # $#  #
# .#.####$ $$ #
# ...#  #    @#
######  #######
Solution: 12-6u1,10-5u1,9-4u1,10-7u1,9-6u1l2,6-4d1,7-6l2,4-7u1,9-5r1,10-2d1,10-5u2,9-3d1,10-5l3,10-1d2,4-6u3,6-4d1,7-6l2,4-7u2,5-4l1,12-5l5,6-4d1,7-6l2,4-5d1,2-1d6,1-8r2,4-1d2,4-3d1,10-3d1,11-5l4,6-4d1,7-6l4,2-5d2,1-8r1,9-1d2,9-3d1,10-5l3,6-4d1,7-6l4,2-5d2,9-8u2,10-5l2,8-5l1,6-4d1,7-6l4,2-5d1,12-8u1l2,9-8u2,10-5l3,6-4d1,7-6l4,12-5d1,13-7l1,12-7l2,9-8u2,10-5l2,8-5l1,6-4d1,7-6l1,6-6l2,12-3d3,13-7l3,9-8u2,10-5l3,6-4d1,7-6l2,12-4l2,9-3d1,10-5l3,6-4d1,7-6l1,12-1d3,12-4d2,13-7l3,9-8u2,10-5l3,6-4d1,11-1d3,12-5l3,9-5l2,2-4r3,2-2r1,4-1d2,3-4r1,6-2l1,4-1d2

;11
 ####
 #  ####
##   $ #  ####
# $$#  ####  #
# $ #   $@   #
#   # $##### #
# $ ## #..## ##
#      #.. $  #
###### #  ### #
   # $$#..#   #
   #    ..# $ #
   #####..#$$ #
       #  # $ #
       #..   ##
       #..####
       ####
Solution: 11-10d2,13-12l1,12-13l2,12-7l3,9-12d1,11-11d1,12-13l3,8-12d1,8-8u1,9-4l3,6-2l3d3,6-6u2,6-10u5,5-5u1r2,7-4r4,12-3d3,13-7l3,9-8u1,4-9r1,6-8d1,5-10r2,8-9d2,6-2d1,5-4r6,12-3d3,13-7l4,1-3r1,3-2d1,3-5d1,2-7r3,6-6d3,5-10r2,8-11u1,2-5d1,1-7r2,3-7r2,6-6d3,5-10r3,9-9d2,2-3d3,1-7r2,3-7r2,6-6d3,5-10r3,9-11u3,3-3d3,2-7r3,6-6d3,5-10r3,9-11u1,2-1d5,1-7r4,6-6d3,5-10r3,5-4u1,6-2l2,3-1d5,2-7r3,6-6d3,5-10r2,8-13u1,9-13u1,13-11l1,11-10d2,12-13l3,13-10l1,11-9d3,12-13l2

;12
 #########
##       #    #####
# $# $$  ######   #
#     #####  ## # #
#  $$   #  $      #
##  #$  # #  ## ###
 # $# $ #$#...# #
 #  ## $# #.#.# #
 # $$   #.....$ #
 #$ # $ #.#.#.###
 # $#  $ .....#
 # @########  #
 ####      ####
Solution: 2-10u5,3-5u1r2,5-1d1r1,5-4u1,2-1d1,1-4r1,2-4u1r2,3-5u1,4-3l1,3-7u1,3-9u1r2,6-10r5,1-3r1,2-1d1,6-2l1,5-4u1,3-6d1,3-4d1,2-2d1r2,2-5u1,3-7u1,3-9u1,3-6u2,3-8u1,11-3d1,9-5d3,11-6u1,10-4r5,11-10r1,13-11u3,15-8l3,11-9u4,10-4r1,12-3d1,13-6d1,14-8l2,11-9u3,12-4d1,11-6u1,10-4r1,12-3d1,7-8l1,6-7u1,6-8l3,3-7u1,5-9r1,7-8d1,6-10r6,13-11u2,14-8l4,7-6d2,7-8d1,6-10r6,13-11u2,14-8l3,2-9u1,3-11u2,2-8r4,7-7d2,6-10r6,13-11u2,14-8l2,11-7d1,13-6l1,11-7u2,3-4d4,3-10u1,2-8r4,7-7d2,6-10r6,13-11u3,11-3d3,13-6d1,14-8l2,2-6d3,2-2d2,4-3l1,7-4l3,3-3d4,2-8r4,7-7d2,6-10r2,8-10r4,13-11u3,13-6d1,14-8l1,17-4l5,11-3d2,12-4d1,6-6u1,7-4l3,3-3d4,2-8r4,7-7d2,6-10r6,13-11u4,5-6u1,6-4l2,3-3d2,3-5d2,2-8r4,7-7d2,6-10r6,13-11u3,4-1d2,5-4l1,3-3d4,2-8r3,5-8r1,7-7d2,6-10r6,13-11u2,6-2l1,4-1d2,5-4l1,3-3d4,2-8r4,7-7d2,6-10r6,13-11u1,5-2d1,6-4l2,3-3d4,2-8r4,7-7d2,6-10r1,7-10r5,8-2l3,4-1d2,5-4l1,3-3d4,2-8r4,7-7d2,6-10r5,2-2d1,1-4r1,3-3d4,2-8r4,7-7d2,6-10r4,2-6u1,1-4r1,3-3d4,2-8r4,7-7d2,6-10r3,2-11u6,1-4r1,3-3d4,2-8r2,4-8r2,7-7d2,6-10r2

;13
 #####
##   ####   #######
# $  #  #####     #
# # ##.....       #
# # # .###.### ## #
#   $ .###.###    #
# $ # .....  # #  ##
# $ ###### # #     #
# #$ $   #   ###   #
#   $$#$ ##### #####
# $$$ #  #
#  #  $$ #
####    @#
   #######
Solution: 6-8l1d1l2,3-9u4r2,6-4d1,5-6r1,6-6r4,12-6l1,10-7u3,9-3r4,13-3r1,14-3r2,17-2d4,18-7l2,4-9d1,5-9d1,1-9r1,2-11u1r1u4,2-5r3,6-4d1,5-6r5,12-6l1,10-7u3,9-3r1,10-3r3,14-2d1,1-6r1,3-7u1,2-5r3,6-4d1,5-6r5,12-6l1,10-7u3,9-3r3,12-3r3,15-3r1,17-2d4,1-9r1,3-10u4,2-5r1,3-5r2,6-4d1,5-6r5,12-6l1,10-7u3,9-3r5,14-3r2,17-2d3,5-8l1,3-9u3,2-5r1,3-5r2,6-4d1,5-6r5,12-6l1,10-7u3,9-3r5,14-3r1,1-7r1,3-8u2,2-5r3,6-4d1,5-6r5,12-6l1,10-7u3,9-3r4,1-2r1,4-2l1,3-3d2,3-7u1,2-5r1,3-5r2,6-4d1,5-6r3,8-6r2,12-6l1,10-7u2,7-10u1,8-8l3,5-8l1,3-9u3,2-5r3,6-4d1,5-6r2,7-6r3,12-6l1,10-7u1,1-2r1,3-1d3,2-5r3,6-4d1,5-6r4,7-12u1,7-11u1,7-10u1,8-8l4,3-9u1,3-8u2,2-5r3,6-4d1,5-6r3,5-12u3,6-8l2,3-9u3,2-5r3,6-4d1,5-6r2,7-11l1,5-12u3,6-8l2,3-9u3,2-5r3,6-4d1,5-6r1,5-10l1,4-12u3,5-8l1,3-9u3,2-5r3,6-4d1,2-10r1,4-11u1,4-10u1,5-8l1,3-9u3,2-5r3,15-3l8,6-2d1,17-3l9,8-3l1,14-5u1,15-3l2,13-3l4,9-3l1,18-7l1u1,17-6u2,16-8u1,14-7r2,16-7u1,17-5l1,17-2d3,16-5l1,14-6u2,15-3l6,18-7l1,16-8u2,17-5l2,14-6u2,15-3l5,17-5d1,18-7l1,16-8u2,17-5l2,14-6u2,15-3l4

;14
    ###########
   ##    #    #
   #  ## #$## #
   #          #
   ## ## #### ###
  ### #....  ...#
  #  $#....  ...#
### $ #############
#    $          $ ##
# #$# ####$## #$$  #
#  $ $# #  $  # $  #
#### @# #   $      #
   #### #########  #
                ####
Solution: 4-10l1u2,4-8r6d2r1,11-11r5,15-8d1r1d1,5-7u4,10-1d1,9-3r2,11-3r1,13-2d2,12-5r2,5-1d1,4-3r3,8-2d2,9-5l1,5-11u2,5-9u6,5-1d1,4-3r3,8-2d3,9-6l1,1-10r1,2-10r2,5-11u1,5-10u7,5-1d1,4-3r8,13-2d2,14-5l2,12-5l2,3-6d1,2-8r1,3-8r1,5-9u5,5-4u1,5-1d1,4-3r4,8-3r1,9-3r3,13-2d2,14-5l3,3-7r1,5-8u5,5-1d1,4-3r8,13-2d2,14-5l1,12-8l7,3-8r1,5-9u6,5-1d1,4-3r8,13-2d3,14-6l4,18-9l1,17-8l3,14-8l1,13-8l1,12-8l7,3-8r1,5-9u1,5-8u5,5-1d1,4-3r2,6-3r6,13-2d3,14-6l3,11-5r2,16-10u1,17-8l5,12-8l7,3-8r1,5-9u1,5-8u5,5-1d1,4-3r8,13-2d3,12-6r2,17-12u2,18-9l1,16-10u1,17-8l12,3-8r1,5-9u6,5-1d1,4-3r8,13-2d3,12-6r1,15-11u1,15-10u1,16-8l11,3-8r1,5-9u1,5-8u5,5-1d1,4-3r8,13-2d3,15-11r1,17-12u2,18-9l1,16-10u1,17-8l12,3-8r1,5-9u2,5-7u4,5-1d1,4-3r7,11-3r1,13-2d2,9-11r7,17-12u2,18-9l2,15-10u1,16-8l11,3-8r1,5-9u6,5-1d1,4-3r1,5-3r2,8-2d3,13-10l2,10-11u2,11-8l6,3-8r1,5-9u1,5-8u5,5-1d1,4-3r3,8-2d2

;15
           ########
           #      ##
    ####   #  $$ $ #
  ###  #######$ $  #
###  $ #.....#  #$ #
#   #   .....# $# ##
# # ## #.....$  # @#
# #    #.....# $#$ #
# ############  #  #
#            $ ##$##
#######$$ ## $    #
      #  $  $  $$ #
      ###   ###   #
        ##### #####
Solution: 17-5u1,18-2l1,15-1d1l1d4l3,11-6l2,8-7u2,14-6d4,15-4u1,15-6u1,12-2r1,14-1d4,15-6l2,13-6l1,10-6r1,12-7u2,15-3d1,15-1d1,17-2l3,15-4u1,14-2r1,15-6u1,12-2r1,14-1d4,15-6l3,11-7u1,11-6u1,15-5u1,15-8u2,14-10l1,13-11l1,12-9r1,14-10u3,15-6l3,12-6l1,10-7u2,12-11l1,9-12u2,8-9r5,14-10u3,15-6l3,12-6l2,9-7u2,6-4l1,7-11u1,6-9r7,14-10u3,15-6l5,9-7u1,10-5l3,6-6u1,12-11u1,11-9r2,14-10u3,15-6l3,11-7u1,10-5r1,16-12u1,17-10l4,12-11u1,11-9r2,14-10u3,15-6l3,11-7u1,15-12u1,16-10l2,13-11u1,12-9r1,14-10u3,15-6l4,10-7u1,13-11r2,16-12u1,17-10l2,14-11u4,15-6l5,9-5d1,8-7r3,8-11u1,7-9r5,12-9r1,14-10u3,15-6l1,14-6l4,9-5d1,8-7r1,9-7r1,11-11l1,9-12u2,8-9r5,14-10u3,15-6l5,9-5d1,8-7r1,15-4d2,17-2l2,14-1d3,14-4d1,15-6l5,9-5d1,17-4u1,18-2l3,14-1d4,15-6l4,11-6l2,8-5d1,15-2d1,17-3l2,14-2d3,15-6l6,15-5u1,16-3l1,14-2d3,15-6l2,13-6l3,15-8u4,16-3l1,14-2d3,15-6l4,17-8u4,18-3l3,14-2d3,15-6l3,17-10u3,17-7u2,17-5u1,18-3l3,14-2d1,14-3d1,14-4d1,15-6l2,6-3d1,5-5r3,3-4r2,6-3d1,5-5r2

;16
  ################
  #              ##
  # ########## $$ #
 ##$#........#    #
##   ........#  $ #
#   ####..#####$ ##
#      #..$   # $#
#  #   #  # # #  ##
########### #$#   #
   ##    $   $  # #
   #  $$$$# $$ $  #
   # $  #  @#  $$ #
   #    ########  #
   ######      ####
Solution: 11-6l2,8-7u2,12-9r2,14-10r1u2,16-7u1,15-6u2,16-1d1,3-2d3,2-6r2,6-6l3,9-4l1,8-4l4,3-3d2,10-9l3d1l1,13-11u1,11-10r1,14-9l2,11-10u1,14-10l1,13-7d2,11-9u2,12-6l3,8-7u2,9-4l1,8-4l4,3-3d1,13-11u1,14-9l1,11-10r1,13-9l1,11-10u3,12-6l3,8-7u3,9-3l3,13-11u1,14-9l2,11-10u3,12-6l3,8-7u3,9-3l2,17-10l3,13-11u1,14-9l2,11-10u3,12-6l2,10-6l1,8-7u3,9-3l1,16-12u1,17-10l3,13-11u1,14-9l2,11-10u3,12-6l2,9-7u2,9-5u1,8-3r3,14-11r1,16-12u1,17-10l3,13-11u1,14-9l2,11-10u3,12-6l2,9-7u3,8-3r2,15-6d3,16-10l2,13-11u1,14-9l2,11-10u3,12-6l2,9-7u3,8-3r1,17-4l1d3,17-8l1,15-7d2,16-10l2,13-11u1,14-9l2,11-10u3,12-6l1,11-6l1,9-7u3,16-2d1,16-3d1,16-4d3,17-8l1,15-7d2,16-10l1,14-11u1,15-9l2,13-9l1,11-10u3,12-6l1,11-6l1,10-6l1,8-7u3,14-2r1,16-1d3,16-6u1,16-3d4,17-8l1,15-7d2,16-10l2,13-11u1,14-9l2,11-10u3,12-6l2,9-7u2,8-4r3,14-3r1d6,16-10l2,13-11u1,14-9l2,11-10u3,12-6l2,9-7u2,8-4r2,17-3l1,15-2d3,15-5d4,16-10l2,13-11u1,14-9l2,11-10u3,12-6l1,11-6l1,9-7u2,8-4r1,4-10r1,5-9r6,13-9l1,11-10u3,12-6l2,9-7u2,6-11u1,5-9r2,7-9r4,13-9l1,11-10u3,12-6l2,9-7u1,7-12u2,6-9r5,13-9l1,11-10u3,12-6l3,8-7u2,4-11r2,7-12u2,6-9r5,13-9l1,11-10u3,12-6l3,8-7u1,9-11u1l1,8-9r2,11-10u3,12-6l3,7-11u1,6-9r4,11-10u1,11-9u2,12-6l2,2-7u1r1u1,1-5r1,2-4r2,4-4r2,3-6u1,2-4r2,4-4r1,3-6r1,6-6l3,2-7u1,1-5r1,3-6u1,2-4r2

;17
  ##################
  #  #@ .......#   #
 ##  # #.#####.    #
##      .......## ##
#    # #  ###### $#
#    # #### $  $$ #
#  # # ## $ #  $  #
#    # # $  ###  $##
#   ## #  $     $  #
##  #  #  #### $   #
 ####  $$$$ # $   ##
    #  #        ###
    #############
Solution: r8,17-3d1,16-4d1l1d2,16-7d2l1,16-5d1,17-6d2,15-9u1,9-11u2,8-7r1,15-8u1r1,9-7d1r6,8-11u1l1,6-11u7,7-3l3,2-3r5,8-4u2,7-1r2,9-1r4,8-8d1,9-10l2,6-11u7,7-3l3,2-3r3,5-3r2,8-4u2,7-1r4,11-1r1,9-10u1,10-8l1,8-7d2,9-10l2,6-11u7,7-3l3,2-3r5,8-4u2,7-1r4,11-10l1,10-10l3,6-11u7,7-3l3,2-3r4,6-3r1,8-4u2,7-1r3,16-9u1,18-9l2,15-10u1,16-8l7,16-6d1,8-7d2,9-10l2,6-11u7,7-3l3,2-3r5,8-4u2,7-1r2,17-8l8,8-7d2,9-10l2,6-11u7,7-3l3,2-3r5,8-4u2,7-1r1,15-5d2,16-8l7,8-7d2,9-10l2,6-11u2,6-9u5,7-3l3,2-3r5,8-4u2,13-5r2,16-4d3,17-8l8,11-5r4,16-4d3,8-7d2,9-10l2,6-11u7,7-3l3,2-3r5,8-4u1,17-8l8,8-7d2,9-10l2,6-11u7d4,7-3l3,3-2d2,4-5l1,2-4d3,1-8r1,13-10r1,15-11u1,15-10u1,16-8l7,8-7d2,9-10l2,6-11u7,7-3l3,3-2d2,4-5l1,2-4d2,9-6r1,11-5d2,12-8l3,8-7d2,9-10l2,6-11u2,6-7d1,6-10u6,7-3l3,3-2d2,4-5l1,1-7r1,2-4d2,11-7l1,9-6d1,10-8l1,8-7d2,9-10l2,6-11u7,7-3l3,3-2d2,4-5l1,14-10u1,15-8l6,8-7d2,9-10l2,6-11u7,7-3l3,3-2d1,3-5u1,3-2d2,17-10l1,15-11u2,16-8l3,13-8l4,8-7d2,9-10l2,6-11u7,7-3l3,2-3r1,4-4u1,17-6d1,17-9u1,17-6d1,18-8l1,17-8l8,8-7d2,9-10l2,6-11u7,7-3l3,17-6u3,18-2l3,2-3r3,5-3r8,4-1d1,3-3r9,2-6u1,1-4r1,4-5l1u1,2-3r6,8-3r3,2-6u1,1-4r2,4-5u1,3-3r7,2-8u3,1-4r2,4-5u1,3-3r6,4-7l1,2-8u3,1-4r2,4-5u1,3-3r5,3-9u1,4-7l1,2-8u3,1-4r2,4-5u1,3-3r4

;18
    ####   #########
#####  #####   #   #
#@ $     $    $$   #
# $$## #####$# $$$ #
# $  # # ....#     #
##$  # # ...########
 # $## ## ####...  #
 #  #  $      .....#
 # $#$ ##  ###  ...#
 #  #  ##### #######
 #  #  #
 # $ $ #
 ###   #
   #####
Solution: 2-2r3,6-1d6r8,16-7u1,15-8u1,16-6l1,5-7d2,6-9u1,5-7r12,18-6d1,4-11r1,6-12u4,5-7r11,17-6d1,1-4r1d3,3-7d2,2-11r2,8-2r4,14-1d1l8,4-2r1,6-1d5,5-7r10,16-8u1,15-6r1,12-4u1,11-2r1,14-2l8,4-2r1,6-1d5,5-7r8,13-7r1,16-7l6,9-8u2,8-5r2,14-2r2,18-2l7,11-2l5,4-2r1,6-1d5,5-7r9,16-7l1,15-7l5,9-8u2,8-5r1,17-4u1,18-2l12,4-2r1,6-1d5,5-7r9,16-7l6,9-8u3,8-4r3,16-4u1,17-2l6,11-2l5,4-2r1,6-1d5,5-7r9,16-7l6,9-8u3,8-4r2,15-4u1,16-2l10,4-2r1,6-1d5,5-7r4,9-7r5,16-7l6,9-8u3,8-4r1,14-4u1,15-2l9,4-2r1,6-1d5,5-7r9,16-7l6,9-8u3,4-11r1,6-12u4,5-7r9,16-7l3,13-7l3,9-8u2,3-9d1,2-11r3,6-12u4,5-7r10,16-6d1,18-6l1,3-5d5,2-11r3,6-12u4,5-7r9,15-8u1,4-4l1,3-2d1,3-3d7,2-11r3,6-12u4,5-7r12,1-3r1,3-2d8,2-11r3,6-12u4,5-7r11,1-4r1,3-3d7,2-11r3,6-12u4,5-7r10,2-9u4,1-4r1,3-3d1,3-4d6,2-11r3,6-12u4,5-7r9,5-9d1,4-11r1,6-12u4,5-7r8

;19
              ####
          #####  #
          # $  $ #
    ####  # $ $  #
    #  #### ##$# #
 #### $#.....#   #
 # $ $  ..#..# $##
 #  $ $#..#..   #
 # ### #..... ###
## $ # ## ## ###
# $ $   $ #    #
#@ $   $ $#    #
#######   #    #
      ##########
Solution: 2-11r1,3-10r2,6-11r1,9-12u4,9-6d1,8-8r3,12-7d3,11-11r1,13-12u1,7-11r1,9-12u4,9-6d1,8-8r3,12-7d3,11-11r1,7-10r1,9-11u3,9-6d1,8-8r3,12-7d1,12-8d2,12-12u4,13-7l1,11-8u1,5-10r3,9-11u3,9-6d1,8-8r1,9-8r2,12-7d3,1-10r6,11-7u1,12-5l1,11-2r2,13-3l1,11-2d3,15-3l2,12-12u4,11-7r1,7-10r1,9-11u3,9-6d1,8-8r3,12-7d3,3-7r1,4-6r1,3-11r5,9-12u4,9-6d1,8-8r3,5-6r2,8-5d2,2-6r5,8-5d1,6-8u1,5-6r3,6-4d1,5-6r2,4-7r1,11-5l2,9-7u1,6-6d3,5-10r3,9-11u4,4-9l1,2-8d1,1-10r7,9-11u3,11-7u1,12-5l1,14-7l1,13-8l3,12-8u2,13-3l1,11-2d3,11-5d2,12-8l1,14-5u1,15-3l3,11-2d3,11-5d2,15-1d1,16-3l4,11-2d3,11-5d1,15-7u1,16-5l1,14-6u2,15-3l3,11-2d3,13-2r1,15-1d1,16-3l3,13-3l1,11-2d2,12-12u5,14-10l1,12-11u3,14-11l1,12-12u3

;20
    ########
    #      ###
   ##$ ###   #
####     $   #####
#   $ $$$  ###   ##
# ##### ####    $ #
# #   ...# $ # $$ #
#     ...# $ ##$  #
######...#  $ # $ #
     #...$$  $ $  #
     #...#    #  ##
     #...###### @#
     #####    ####
Solution: 17-5l1,16-7d1,15-8d1,14-9l2,12-7d1,10-7r1,12-8u1,10-10u1l2,7-5u1r1,8-3r2,6-3r2,5-4r1,7-3d3,3-4r1,7-8u4,7-8d1,6-10r1,8-9d1,10-7d1,11-10u1l2,9-9l1,7-8d2,13-9l6,6-8d2,17-9l10,6-10u2,7-7l2,15-11u1,16-9l9,6-10u3,11-7d1,12-9l4,7-10u2,6-7r1,16-5d3,17-9l8,9-9l1,7-10u3,12-5d3,13-9l4,9-9l1,7-10u1,8-8l1,10-6r1,12-5d3,13-9l2,11-9l3,7-8d1,8-10l1,14-5r1,16-4d4,17-9l6,11-9l3,7-8d1,14-6r1d2,16-9l9,16-5d2,16-7d1,17-9l3,14-9l6,7-5d1,8-6d3,6-7r1,8-6d2,8-3l2,4-4r2,7-3d3,6-7r1,8-6d1,10-4l2,7-3d2,7-5d2,4-3r1,6-2d1,5-4r1,7-3d3,6-7r1,3-7r2,7-6l2,5-1d2,4-4r2,7-3d2,6-6r1,10-3l3,6-2d1,5-4r1,7-3d2,7-5d1,12-3l1,11-3l4,6-2d1,5-4r1,7-3d2,3-6r2

;21
######     #######
#    #  ####     #
# #$$####@ #  #  ##
#    ......#      #
# # #.##.#.## #   #
#    .##.#.## ##  #
#### ...... $     #
#  ##### ####  ####
#   $ ##$ $ #######
#  $#    #$    $  #
#   $$## # $$$    #
## #$ $        $$ #
 #    ##########  #
 ######        ####
Solution: 11-6r2,15-6l1,13-7u4,13-1d1,12-3r3,16-2d2,8-7d2,5-8l2,5-9d1l2u1,1-10r1,5-12u1r3u5,8-11r4u1r1,14-9r1,2-7d1,4-8l1,1-9r1,2-7d1,5-11u1,5-8d2,2-10u1,5-12u1,2-7d1,5-9d1,2-10r2,4-12u1r1,7-11l2,15-10l1,14-11l6,12-10r1,10-10r1,11-8l1,8-4d1,7-6r6,15-6l1,13-7u3,12-3r1,13-3r2,16-4u1,10-8l1,8-9u3,8-4d1,7-6r6,15-6l1,13-7u4,13-1d1,12-3r2,15-4u1,10-10u1,11-8l2,8-9u3,8-4d1,7-6r6,15-6l1,13-7u4,13-1d1,12-3r3,13-9l2,10-10u1,11-8l2,8-9u3,8-4d1,7-6r6,15-6l1,13-7u4,17-9l3,14-9l1,13-9l2,10-10u1,11-8l2,8-9u3,8-4d1,7-6r4,11-6r3,3-1d3,2-5r2,5-6u1,13-10l2,10-11u2,11-8l2,8-9u5,9-3l5,3-2d2,2-5r2,15-10l4,10-11u2,11-8l2,8-9u5,9-3l6,16-12u2,17-9l6,10-10u1,11-8l2,8-9u4,8-5u1,9-3l5,3-4u1,14-11r1,16-12u2,17-9l5,12-9l1,10-10u1,11-8l2,8-9u5,7-3r2,10-2d2,6-11r7,13-11r2,16-12u2,17-9l5,12-9l1,10-10u1,11-8l2,8-9u5,7-3r2,10-2d1,5-9d1,3-10r1,4-12u1r8,12-11r3,16-12u2,17-9l6,10-10u1,11-8l2,8-9u5,7-3r2,5-9d1,3-10r1,4-11r11,16-12u2,17-9l6,10-10u1,11-8l2,8-9u5,7-3r1,5-9d1,4-11r2,6-11r2,8-11r2,10-11r3,13-11r2,16-12u2,17-9l4,13-9l2,10-10u1,11-8l2,8-9u5,2-8d1,1-10r3,5-9d1,4-11r4,8-11r7,16-12u2,17-9l2,13-9r1,16-9l2,14-9l3,10-10u1,11-8l2,8-9u4,3-8d1,2-10r2,5-9d1,4-11r2,6-11r9,16-12u2,17-9l2,15-9l4,10-10u1,11-8l1,10-8l1,8-9u3,1-3r5,3-1d1,2-3r3,4-1d1,3-3r1,16-6l10,16-4d1,17-6l6,11-6l4,13-1d1,13-2d1,13-3d2,14-6l6,17-3l2,16-1d4,17-6l8,15-3l1,13-2d1,13-3d2,14-6l4,15-1d1,16-3l1,15-3l1,13-2d1,13-3d2,14-6l3

;22
 #######
 #     #####  ######
 # $$# #   # ##    #
 #  $  # $ ###     #
 #  $# # $     #   #
 # $ # ##$######  ##
 #   #  # ##  ## ##
###$$#$ #.....    #
#  $ $ $#.###.##  #
#  $  $ $.....##  #
# # #$  #.###. #  #
#@ $  ###..... #  #
###   # ###########
  #####
Solution: 2-11r1,5-11u1,7-9r2,7-9u1,6-8u5,5-3l1d1,4-6d2l1d1,6-10u2,7-6d1,9-9r3,13-10u1,8-4r1d3,9-7d2,8-3r1,11-4l1,9-5u1,13-9u1,12-7r3,16-6d1,16-7d2,9-11u1,9-10u1,9-9u2,7-7d1,6-9r4,10-9r2,13-10u1,9-5d4,13-9u1,12-7r3,16-6d1,16-9u5,15-3r1,17-2d1,9-11u4,4-8r2,7-7d1,6-9r6,13-10u1,9-5d4,13-9u1,12-7r3,16-6d1,16-9u5,15-3r1,9-11u4,5-10u1,3-9r3,6-9r5,11-9r1,13-10u1,9-5d4,13-9u1,12-7r3,16-6d1,9-11u4,4-8r2,7-7d1,6-9r6,13-10u1,9-5d4,13-9u1,14-7l1,6-6d2,16-9u5,18-4l1,11-7r4,16-6d1,9-11u2,9-9u2,5-9r7,13-10u1,9-5d1,9-6d3,13-9u1,14-7l1,6-1d7,5-9r7,13-8d2,14-11l4,4-4d4,3-9r9,13-8d2,14-11l3,3-11u1,2-9r10,13-8d1,13-9d1,14-11l2,4-1d7,3-9r8,11-9r1,13-8d1,13-9d1,14-11l1,1-8r2,4-7d1,3-9r9,13-8d2,3-11r1,5-12u2,4-9r7,11-9r1,13-8d1,3-6d2,2-9r10,3-4d4,2-9r9,2-2r1,3-2d5,3-7d1,2-9r8,4-1d7,3-9r6,11-7r1,13-6d1,16-9u1,17-7l6,11-7l1,9-6d2,9-2d4,9-6d1,10-2d1,11-4l1,9-3d3,16-11u1,16-10u2,17-7l1,16-7l4,12-7l1,17-2d1,15-3r1d4,16-9u1,17-7l2,15-7l3,18-3l1,16-2d5,16-9u1,17-7l4,18-4l1,16-3d4,16-9u1,17-7l3

;23
           ####
         ###  #####
  ######## $  $ $ #
  #......# ##     #
  #...... $    # ##
  #####..#$##### #
 ##   #..# # $ $ #
 #  # #..#  $  $ ##
 #     ..# # $    #
 #   $#  # ## $$  ##
## #  # $#   $  $$ #
#    $# @##  $$#   #
#     ########     #
#######      #######
Solution: undefined

;24
      ##########
  #####  #     ####
  #   #    ### #  #
  # $ #$$   $  #$ #
 ## $## ####$###  #
 #   #....#    #$ #
 #  $#....# ## $  #
 #   #....   $$## #
 # ###....# # $   #
## $ #....# # $ $ #
#  $ #....# #$ $  #
#  $ # ####$ $   ##
###     @## $ $ ##
  ####      #####
     ########
Solution: 11-12u1,12-11r2,14-10r1,15-8l1u1l4,9-6d3,14-10u1,13-9u1,15-8l1,14-7l4,9-6d2,13-9u1,14-7l4,9-8u2,14-5d2,15-8l1,13-9u1,14-7l5,8-8u2,11-11u3,12-7l2,9-6d1,13-11u1,13-10u2,14-7l2,12-7l1,11-7l2,8-6d3,13-12l1,11-13u5,12-7l3,8-6d1,8-7d1,17-9l3,13-10u2,14-7l2,12-7l3,8-6d1,16-6l1,14-5d2,15-8l1,13-9u1,14-7l6,7-6d3,16-4d1,17-6l2,14-5d2,15-8l1,13-9u1,14-7l6,7-6d1,7-7d1,16-2d3,17-6l2,14-5d2,15-8l1,13-9u1,14-7l3,11-7l3,7-6d1,17-10l1,16-10l2,13-11u3,14-7l2,12-7l4,16-11l4,11-12u4,12-7l3,15-12l3,11-13u5,12-7l1,11-7l1,7-4u1r1,7-1d4,6-6r2,10-3l2,7-2d3,6-6r1,13-3l2,11-3l3,7-2d3,12-5u1,13-3l5,7-2d2,4-9l1,4-11l1,3-9d1,2-10u3,3-12u1,2-10r1,4-9d2,3-12r3,8-12l1,6-13u7,1-11r2,4-10d1,3-12r3,8-12l1,6-13u2,6-11u4,2-5d5,1-11r2,4-10d1,3-12r3,8-12l1,6-13u1,6-12u4,5-3l1,3-2d3,4-5u1,4-7u1l1,2-5d5,1-11r2,4-10d1,3-12r3,8-12l1,6-13u3,6-10u1,5-3l1,3-2d4,4-7l1,2-6d4,1-11r2,4-10d1,3-12r3,8-12l1,6-13u3,4-6u2,5-3l1,3-2d4,4-7l1,2-6d1,2-7d3,1-11r2,4-10d1,3-12r3,8-12l1,6-13u2

;25
           ####
     #######  ###
 ##### $        ###
##   #   $$$ # $  ##
#    # $# $  $     #
# # ## $    #$#  $ #
#   # $## ### ###$##
##  # $       ##  #
 #@ # ########## ##
 ##.......     # ##
 # .#.#.#.### $ $ #
 # .......# # $ $ #
 ######   # ##    #
      #####  ######
Solution: 5-7r1u2r3,8-7l2,5-6d3,5-11u1,6-9l2,3-10u5,9-4u1,6-3d3,7-7l1,5-6d3,5-11u1,6-9l2,3-10u4,7-3d1,8-5l1,6-4d1,6-5d1,7-7l1,5-6d3,5-11u1,6-9l2,3-10u2,8-2r4,11-5l4,6-4d2,7-7l1,5-6d4,4-11r3,9-11l1,7-12u1,13-11r1,17-10l1,11-4l1,9-3d1,10-5l3,6-4d2,7-7l1,5-6d4,4-11r4,9-12u1,12-4r3,16-5u1,10-2d2,11-5l4,6-4d2,7-7l1,5-6d4,4-11r4,12-3l2,9-2d2,10-5l2,8-5l1,6-4d2,7-7l1,5-6d4,4-11r3,18-5l1,17-7u2,18-4l8,9-3d1,10-5l3,6-4d2,7-7l1,5-6d4,4-11r2,13-6u1,14-4l4,9-3d1,10-5l3,6-4d2,7-7l1,5-6d1,5-7d3,4-11r1,15-5r1,17-6u1,18-4l8,9-3d1,10-5l3,6-4d2,7-7l1,5-6d4,15-2d1,16-4l6,9-3d1,10-5l2,8-5l1,6-4d2,7-7l1,5-6d3,3-6d4,2-11r1,4-4l1d6,1-4r1,3-3d6,17-3l1,15-2d1,16-4l3,13-4l3,9-3d1,10-5l1,9-5l2,6-4d2,7-7l1,5-6d2,6-9l2,14-2l1,12-1d2,13-4l2,11-4l1,9-3d1,10-5l3,6-4d2,7-7l1,5-6d2,6-9l1,6-2r5,12-1d2,13-4l1,12-4l1,11-4l1,9-3d3,10-7l3,14-9d1,16-10l2,14-12u1,13-11u1,15-10l1,14-9l3,11-9l4,13-11u1,14-9l2,12-9l2,10-9l2,15-12u1,16-10l2,13-11u1,14-9l1,13-9l4,17-11l2,14-12u1,15-10l1,13-11u1,14-9l4,7-7l1,5-6d2

;26
##############
#....      ..#
#.##.## $##..#
#.##.##  ##..####
#.... #####..#  ###
#  # $#    ..#$ $ #
####  # # #  #  # #
#  #$$#  $####$   #
# $  $  #  $   $$ #
#  $ $###@$ # $ $ #
#  $#   ### ### $ #
##  $   # # $ #   #
 #  ##### #       #
 ####     #########
Solution: 9-8u1,6-8l2,4-9l1,4-8u4,5-6d1,5-4d1,4-2d1,6-8l1,5-4l3,1-5u2,5-8d1,4-9u4,5-4l3,1-5u1,5-5d2,6-8l1,4-9u4,5-4l3,3-9d1,3-12u1r2,5-11u2,6-8l1,4-9u4,5-4l2,1-9r2,3-9r1,5-10u1,6-8l1,4-9u4,5-4l1,9-7u1,8-5r2,11-6u4,12-1l10,10-8r3,15-7d3,17-9l1d1,16-7d1,13-8r2,9-9r1,17-8l7,9-9u3,8-5r2,11-6u4,12-1l9,11-10u1,12-8l2,9-9u3,8-5r2,11-6u2,11-4u2,12-1l8,13-11l1,11-12u3,12-8l2,9-9u3,8-5r2,11-6u3,14-6d1,15-8l2,13-8l3,9-9u3,8-5r2,11-6u2,16-10u1,17-8l1,16-8l6,9-9u3,8-5r2,11-6u1,8-3u1,7-1r3,14-4d1,14-5d2,15-8l2,13-8l1,12-8l2,9-9u3,8-5r3,12-6u4,17-5l2,14-4d3,15-8l3,12-8l2,9-9u3,8-5r3,12-6u3,15-10u1,16-8l1,15-8l5,9-9u3,8-5r3,12-6u2,16-12u3,17-8l4,13-8l3,9-9u3,8-5r2,10-5r1,12-6u1,15-12u3,16-8l6,9-9u3,8-5r3,13-9r1,15-10u1,16-8l6,9-9u3,8-5r2,2-7d1r1,4-9u7,2-10u1,1-8r2,4-9u6,3-11u2,2-8r1,4-9u1,4-8u4,7-11l1,6-11l2,3-12u3,2-8r1,4-9u4

