;1
   ####
####  ####
#    $   ##
#   #  #  #
## #.**.#$##
#   *..*   #
# $ *..*   #
## #.**.#$##
 #$@#  #  #
 # $ $    #
 #    $  ##
 ##  #####
  ####
Solution: d1,5-10r1,9-8u2,8-6l2,5-5u1r1,6-2l3,5-2d1,6-4l1,6-8u3,3-5r1d1r2,8-5l1d1,1-2r3,5-1d2,10-5l2,1-6r1,4-9r1,6-10u3,7-6l1,3-11u1,2-9r3,6-10u3,8-10l3,4-11u1,3-9r2,6-10u2,2-9u3,1-5r2,2-6r1,9-3d2,10-6l2

;2
 #######################
##   #  #  #  #  #  #  ##
#   $        $          #
##.# #.###.#.$ #.$$###.##
#  #.# #.$ # $ #   # #  #
# .###.##  # $ #$$$# #. #
#  #.# #.$ # $$# @ # #  #
##.#$#.###.###.###.###.##
#   $           $  $ $  #
##  #  #  #  #  #  #   ##
 #######################
Solution: 17-8l7,5-8l2,2-9u3,4-8u1,4-1d2,10-6l1,10-4l1,10-8l3,6-9u5,12-2r9,22-1d3,20-8l13,6-9u3,18-4d3,19-8l12,6-9u1,14-7u4,15-2l4,10-1d5,12-6r1,14-7u4,15-2l4,10-1d1,14-4l1u1,14-2l11,2-1d1,12-5u1,12-5r1,22-8l19,2-9u1,18-2d5,17-8r4,22-9u1,17-4u1,16-2r5,22-1d1,16-6u2,16-5r1,18-4d2,14-4d2

;3
################
#....#         #
#....# # ##  # #
#....  $ #  #  #
##  #  $   #   #
#    #$$$$#  # #
# ## $    $ ## #
#    $ ## $$$  #
# #$$$ ## $  # #
# #  $    $    #
#   ##$$$$#  ###
#  #    $  #...#
#     # $#  ...#
# ## # # #  ...#
#@         #...#
################
Solution: 8-3l5,2-4u2,1-1r2,11-9l2,6-6u2,7-3l4,2-4u2,3-1l1,8-4l1,6-5u1,7-3l3,3-4u2,7-6u2,8-3l5,2-4u2,9-6u1,10-4l3,6-5u1,7-3l3,3-4u1,2-2r1,8-6u1,9-4l1,7-5u1,8-3l5,2-4u1,3-2l1,9-11u6,10-4l3,6-5u1,7-3l3,3-4u1,6-11u7,7-3l4,2-4u1,4-9r1,6-10u6,7-3l5,4-6r1,6-7u3,7-3l4,4-7r1,6-8u4,7-3l3,3-9u1,2-7r3,6-8u4,7-3l2,11-6d2,10-9r1,12-8d3,11-12r2,14-13u1,13-7l1,11-6d2,10-9r1,12-8d4,11-13r2,14-12d1,9-8r2,12-7d4,11-12r2,9-7r1,11-6d2,10-9r1,12-8d4,11-13r2,9-6r1,11-5d3,10-9r1,12-8d4,11-13r1,13-12d1,7-9r4,12-8d3,11-12r1,13-13u1,7-11u1,6-9r5,12-8d3,11-12r1,9-11l1u1,7-9r4,12-8d4,11-13r1,8-13u3,7-9r4,12-8d5,7-12u2,6-9r5,12-8d4,4-7d1,3-9r8,12-8d3,5-7d1,4-9r7,12-8d2

;4
#####################
#.  #.  #.$.#  .#  .#
# #   #   #   #   # #
#  .#   . $ .   #.  #
# #  .#$$ # $$#.  # #
#  .#   # $ #   #.  #
# #   #$$ # $$#   # #
#  .#   # $ #   #.  #
#@#   #$$$*$$$#   # #
#  ..   # $ #   ..  #
# #   #$$ # $$#   # #
#  .#   # $ #   #.  #
# #  .#$$ # $$#.  # #
#  .#   # $ #   #.  #
# #   #$  #  $#   # #
#.  #.  #.$.#  .#  .#
#####################
Solution: 9-3r2,7-5u1,8-3l2,5-2d5,7-7u3,8-3l1,7-9u4,5-7d1,6-9l4,1-8d6,7-3l1,5-2d6,6-9l4,1-10u8,7-5u1,8-3l2,5-2d6,6-9l2,3-10u6,7-11u7,8-3l2,5-2d6,6-9l2,3-10u4,7-13u9,8-3l2,5-2d6,6-9l2,3-10u2,7-15u6,7-9u5,8-3l2,5-2d6,6-9l2,3-8d4,13-3l7,5-2d6,6-9l2,3-8d2,9-12l1,7-13u9,8-3l2,5-2d6,6-9l2,9-4l1,7-5u1,8-3l2,5-2d2,5-4d10,9-9u5,8-3r3,13-3l7,5-2d6,5-8d3,11-7l1,9-8u1,9-7u3,10-3l4,5-2d2,5-4d4,6-9l1,11-5l1,9-6u2,10-3l4,5-2d3,9-6l1,7-7u3,8-3l2,5-4u2,5-7u2,13-5u1,14-3l5,13-7u3,12-3r2,15-2d3,13-9u4,15-5d3,14-9r4,19-8d6,13-5u1,12-3r2,15-2d6,14-9r4,19-10u8,11-6r1,13-7u3,12-3r2,15-2d6,14-9r2,17-10u6,11-4r1,13-5u1,12-3r2,15-2d6,14-9r2,17-8d4,13-11u7,12-3r2,15-2d6,14-9r2,17-8d2,13-13u9,12-3r2,15-2d6,14-9r2,17-10u4,13-15u11,12-3r2,15-2d6,14-9r2,17-10u2,11-9u5,10-3r4,15-2d6,14-9r2,11-12r1,13-13u9,12-3r2,15-2d6,14-9r1,9-13r1,11-14u10,10-3r4,15-2d12,9-15r1,7-10r1,9-9d5,9-1r1,7-8r1,9-9u7,9-11r1,11-12u8,10-3r4,15-2d9,11-10r1,13-11u1,13-10u6,12-3r2,15-2d3,11-8r1,13-9u5,12-3r2,15-4u2,15-7u2,9-9r1,11-10u2,11-8u4,10-3r1

;5
###############
#             #
# $  # $ #    #
# $ # $#$ #   #
# $# $   $    #
#   $   # $#  #
#$# $  #  $ #$#
#  #$ #   $   #
#    $   $ #$ #
#   # $#$ # $ #
#    # $ #  $ #
#             #
# #####@##### #
#..... .......#
#..... .......#
###############
Solution: 13-7u2,10-4l1d2l1d4,9-11l1,6-10r1d2,8-13l5,8-9d1,9-11l1u1l1d2,8-13l4,6-8d2r1d1l3u1l2d1r4u1r1d2,8-13l3,11-9r1d1r1d1l5u1l1d2,8-13l2,12-7d3r1d1l5u1l1d2,6-13r5,11-7l2u1l1d4,9-11l1u1l1d2,6-13r4,10-8l1u1l1d3,9-11l1u1l1d2,6-13r3,4-8r3u1r1d3,9-11l1u1l1d2,6-13r2,11-6l1,9-5d2r1d1l1u1l1d3,9-11l1u1l1d2,6-13r1,10-4d2r1d1l2u1l1d4,9-11l1u1l1d3,8-14l5,7-4r1,8-2d1r1d4r1d1l1u1l1d3,9-11l1u1l1d3,8-14l4,7-4r1u1r1d4r1d1l1u1l1d3,9-11l1u1l1d3,8-14l3,3-6r1d1r1d1l2d1l2u2r1d3l1d1r5u1r1d3,8-14l2,5-5d2l1d1r3u1r1d3,9-11l1u1l1d3l1d1r5,13-8d5,13-3d9,1-5d8,3-3l1,1-2d10,6-2d1l1d4l1d1r3u1r1d3,9-11l1u1l1d3l1d1r4,7-4l1u1l1d4l1d1r3u1r1d3,9-11l1u1l1d3l1d1r3,8-2l1u1l1d3r1d1l1u1l1d3l1d1r3u1r1d3,9-11l1u1l1d3l1d1r2,4-4d1l1d1r1u1r1d2l1d1r3u1r1d3,9-11l1u1l1d3l1d1r1,2-3d1l1d1r3u1r1d3l1d1r3u1r1d3,9-11l1u1l1d3,2-1d3l1d1r3u1r1d3l1d1r3u1r1d3,9-11l1u1l1d2

;6
##############
#    ###   #.#
# $     $  #.#
# $  # #   #.##
## ### ##$##..##
# $  #$#   # @.#
#  $ $   $  ...#
# $  #$#   #.. #
## ### ## ##..##
#  $ # # $ #.##
# $$     $ #.#
#    ###   #.#
##############
Solution: 8-6r4,14-6l1,12-7u5,9-5u2,9-1d4,8-6r4,14-6l1,12-7u4,9-2l5,1-3r1,2-4d1,4-6r8,14-6l1,12-7u3,6-4d1,5-6r7,14-6l1,12-7u2,1-7r1u1r10,13-7u2,2-4d1,1-6r11,14-6l1,12-5d5,6-8u1,5-6r7,14-6l1,12-5d4,10-10l1u3,8-6r4,14-6l1,12-5d3,7-10r1,9-11u4,8-6r4,14-6l1,12-5d2,2-11u4,1-6r11,14-6l1,12-5d1,4-7l1,2-8u1,1-6r12,14-7u1,2-1d4,1-6r11,13-5d2,4-2l1,2-1d4,1-6r11,13-5d1,4-10l1,2-11u4,1-6r12,4-9l1,2-10u3,1-6r11,4-3l1,2-2d3,1-6r10

;7
     ###
    ##.##
    #...#
  ###..@###
  #  ...  #
### ##.## ###
#     $     #
#  #  $  #  #
##$#$###$#$##
#  #  $  #  #
#     $     #
###  # #  ###
  # ## ## #
  #  $ $  #
  # ## ## #
  #       #
  #########
Solution: 5-7r1u5,8-7d2,7-10l2,2-9u2,1-6r4,6-7u4,7-2l1,4-9u2,3-6r2,6-7u3,5-3r1,7-4u1,4-11u4,3-6r2,6-7u2,7-4l2,10-9u2,11-6l4,6-7u2,5-4r2,8-11u4,9-6l2,6-7u3,7-3l1,3-4r1,9-4l1,7-9l2,4-10u3,3-6r2,6-7u4,6-7r1,8-8u1,9-6l2,6-7u3,8-13l1,6-14u4,7-9l2,4-10u3,3-6r2,6-7u2,4-13r1,6-14u4,7-9l2,4-10u3,3-6r2,6-7u1

;8
    #####       #####
  ###   ###   ###   ###
 ##      .## ##   $   ##
 #    # ...# #  $$#  $ #
## #    .#.###$#  $  # ##
#    # #  ..#    # # $  #
#  @   ....*.$ $$$$$$$  #
#    # #  ..#    # # $  #
## #    .#.### #     # ##
 #    # ...# #  $ #    #
 ##      .## ## $ $$$ ##
  ###   ###   ###   ###
    #####       #####
Solution: 11-7u1,12-6r1,20-7u3d1r1l1d2r1l1d2r2u2r1u2l1,20-2d6l1d1r1,17-4r2,20-5u1,15-5d1l6d1l1u3l1u1r1,16-7u1,18-7u1l9d1l1u4l1u1r1,20-6l11u1l1d3l1d1r1,18-4d1,19-6l10u1l1d4l1d1r1,16-4d1,17-6l6d1l1u3,16-2d3,17-6l6d1l1u2,14-7r1,16-8u1,17-6l7u1l2d1r1u1r1d3,22-5l1r2d2l1u1l12u1l2d1r1u1r1d2,20-4d1r1d1l11u1l1d1l1d1r2,20-2d3r1d1l12d1l1u3,23-5l2d1l3u2r2d1r1d1l12u1l1d3,22-3d1u1l1u1l1d3r1d1l11d1l1u1l1u1r1,17-2r1u1r1d2u1l3d1u1r1d1l1d3r2u2l1u1l1d2u1r2d2u2r1u1r1d2u1l2d2l8d1l2u2r1d1l1d1r1,21-6l12d1l1u2,14-3d2r1d1l6u1l1d2,19-11u2r1u3l2d2r1d1r1u2r1u1l13,22-9l1d1l1u3r1u1l12,19-11u2d2l2u1r1d1r1u1l2u2r2l2d2r2u1r1u2r1u1l11r8d2r1d1r1u2r1u1l10,15-10r1u3d1r2u2l6,16-10r2d1r1u2d1l2u2r2d1r1u2r1u1l8

;9
 ############
##   #  #   ##
# @ $# $ $ $ #
#  $    # $  #
# $$ #..#  $ #
### #....## ##
#   ..##.. $ #
# $ ..##..   #
## ##....# ###
# $  #..# $  #
#  $ #   $ $ #
# $ $ $ # $  #
##   #  #   ##
 ############
Solution: 2-3r1d3,6-12u3,7-8l1,5-11l1,2-12u1r4,7-12u3,6-8r1,3-9d1,2-11r4,7-12u3,1-10r2,4-9d1,3-11r3,7-12u2,8-10r1,11-11l1,11-9d1l4,6-11u2,9-12u1,10-10l3,6-11u1,9-9r1,1-9r1,2-8u1r2,1-6r3,1-4r1,3-3d3,2-7r1,4-9l1,2-10u3,1-6r2,12-6l1,11-5u1,12-2l1,9-1d1,8-2l1,6-1d3,7-5l1,5-3l1,2-3r4,7-2d2,4-1d1,3-3r3,7-2d1,11-2l4,6-1d3,9-4u1,10-2l3,6-1d2,11-6l2,8-7u1,12-11l1,10-12u4,10-8u1,11-6l2,12-9l1,10-10u3,11-6l1,11-2d4,12-7l3,9-3r1,11-2d4,12-7l2

;10
  ##########
 ##  #  #  ##
##  $#      ##
#      $# $  #
# $$ #..# $  #
### #+*..## ##
#   .*##..$  #
#  $..##*.$  #
## ##..**# ###
# $$ #..#  $ #
#    #   $   #
##    $ #$  ##
 ##  #  #  ##
  ##########
Solution: r2l1u3r1d2u2d1l4u2r1l1d2r4u1r4d4l2r2d1l1d3r2u1l1d1l1u3r1u1l1d4l3d1l1u2d2l2u1l2d1r4d1r1u2r3d2l1u1r1u1l3d1l1u1d1l4u4l1u1r2u1,4-1d1l1d1r3u1r1d1,5-5d2,3-6r1d1r1u1,2-7r2l2d3r2u1l1d1l1u3l1u1r3l1u2r1u2l1d4l1d1r1u4l2d1r1u1r1d2,2-6r1,9-4r1u1r1u1l4u1l1d3,11-5u1r1u1l2d1l1u1r1u1l3u1l1d2

;11
 #########
##       ##
# $$$ $$$ #
#      #  #
#   # $   #
# $#  $ $ #
# $  $# $ #
## $   $ ##
 ## $ $ ##
  ## $ ##
   ##@##
  ## ..##
  #. ...#
  #. ...#
  #.....#
  ##...##
   #####
Solution: u1l1u2r1u3r1u1l3r2d8r1d1l2,8-1d1r1d2l3u1l1d9r1d1l2,7-5l1u1l1d9r1d1l2,9-5l3u1l1d7l1d1r2,9-6l1d1l1u1r1u1l2u1l1d8l1d1r2,7-7l1r1u2l2d8l1d1r2,7-8l1u1l1d4l1d2r1u1l1u1r1,6-1d3r1d1l1u1l1d8r1d1l1u1l1d2,8-2d2r1d1l3u1l1d8r1d1l1u1l1d1,8-2l2u1l1d11l1d1r1u1r1d2,1-3r4d1r1l1u2r1d2r1d1l1u1l1d8l1d1r1u1r1d1,3-1d1r1d1l1u2r2d11l1d1r1,1-3u1r3u1r1d13,1-3r3u1r1d11,4-5d1,1-6r3u1r1d7,3-8u1r1u1r1d5l1d1r1,2-6r2u1r1d6,2-4d1l1d1r3u1r1d5

;12
 ####  ####
 #..####  #
 #.. $    #
## $ ###  ##
# $#$  .#  #
# $  .# #$ #
# $# #.  $ #
#  #.  $#$ #
##  ### $ ##
 #    $@..#
 #  ####..#
 ####  ####
Solution: l4,1-5r1u3,4-2r4,10-6l1d3,9-6l2d2,6-9r1,9-8l1d1,7-7d1,6-9r1,2-5r2u2,5-2l1,2-3r1u1,4-4u1,5-2l1,2-7u4,2-10u4,1-5r2,4-4d2,9-4d4,9-1d4,10-6l2,7-7u2

;13
 ###########
##    #    ##
#  $$   $$  #
# $#.# #.#$ #
# $...#...$ #
#  #.$ $.#  #
##  # $ #  ##
#  #.$ $.#  #
# $...#...$ #
# $#.# #.#@ #
#  $$   $$  #
##    #    ##
 ###########
Solution: 10-7d1,7-8u1,6-7l1,5-6u1,6-5r1d2,5-6r1,7-7u2,4-1d3,1-4r2,2-2d1,1-4r1,2-2r1,4-1d1,1-8r3,4-11u2,2-10r1,4-11u1,2-10u1,1-8r1,8-1d2,10-2l1,8-1d1,11-4l1,8-11u3,10-10l1,8-11u1,10-10u1,11-8l2,10-2d5,11-8l1

;14
 ##### #####
##   ###   ##
#   $   $   #
#  #.# #.#  #
# $**.#**.$ #
## #.$ $.# ##
 #  # $ #  #
## #.$ $.# ##
# $.*.#.**@ #
#  #*# #.#  #
#   $   $   #
##   ###   ##
 ##### #####
Solution: 10-5u1,8-1d1,5-2l1,4-3d1,5-4d1,6-5r1,7-6d1,6-7l1,5-5d2,5-6r1,7-5d1,6-7r1,10-2d1,11-4l1,8-11u1,5-10l1,1-8r1,2-5u1r2,2-2d1,1-4r2,2-2r1,4-1d1,4-10l1,2-11u6,1-4r1

;15
 ##### #####
##   ###   ##
#  $   $$ $ #
# $#.# #.#$ #
# $...#...  #
## #.$$ .# ##
 #$ # $ # $#
## #. $$.# ##
#  ...#...$ #
# $#.# #.#@ #
# $ $   $$  #
##   ###   ##
 ##### #####
Solution: 8-11u3,7-8u1l2,1-10r1,4-11u1,11-8l1,7-7u2,11-2l1,8-1d1,10-5d3,5-6u1,1-4r1,2-5d2,1-8r3,8-2l3,4-1d2,7-5l2,6-7u1,5-5r2,10-8l2,10-10l1,8-11u2,10-10u1,11-8l1,2-10r5,8-11u1,2-10u1,1-8r2,2-2d1,2-3d4,1-8r1,2-2r1,4-1d1,10-2d1,11-4l2,8-2r1,10-1d2,11-4l1

;16
    #########
    #       #
   ## $ $ $ ##
####   $ $$  ####
#   # $  $  #   #
# $$ # $ $ # $$ #
#   $ #$ $#  $  #
#  $   $ $    $ #
# $ $ # $ # $$  #
# $  ### ###  $ #
#   ## # # ##   #
#####  #@#  #####
       # #
      ## ##
#######. .#######
#...... . ......#
#........ ......#
#################
Solution: u7l1u1l2u2r2d1u1r2d1l1d13r1l2d1r7,11-2l2u1l1d14,10-4u1r1u1l2u1l1d13l1d1r7,10-3l1u1l1d12l1d1r6,10-5u1l1u1l1d11l1d1r5,10-5l1u1l1d10l1d1r4,6-3r1d1r2u2l1d12l1d1r3,6-1d1r1u1r1d13l1d1r2l2d1,5-3r2u1r1d12r1d1l7,5-4r2u1r1d11r1d1l6,6-5r1u1r1d10r1d1l5,8-7r1u2r1u1l1u1l1d11r1d1l4,8-7l1u2l1u1r1u1r1d11r1d1l3,9-7r2u1r2d1l4u1l1d8r1d1l2r2d1l7,13-7d1r2u1l6u1l1d9r1d1l6,14-10u2r1u1l6u1l1d9l1d1r6,13-10u2r1u1l5u1l1d9l1d1r5,12-9u1r1u1l4u1l1d9l1d1r4,13-4d2l1d2r2u1l5u1l1d9l1d1r3,15-5l1d1r1d1l6u1l1d9l1d1r2,13-4d2r1d1l5u1l1d9r1d1l5,7-7l2u1l2d1r4u1r1d9r1d1l4,3-9u1d2l2u3r6u1r1d9r1d1l3,4-9u1l1u1r4u1r1d9r1d1l2,1-9r1u1l1u1r6u1r1d8l1d2r1u1r1u1l1,3-10u2l1u1r5u1r1d8r1d2l2u1r1d1r1u1,3-4d2,2-7r5u1r1d9r1d1l1,1-5r1d1l1d1r6u1r1d9,3-4d2l1d1r5u1r1d8

;17
##################
#..#             #
#..#  # $ $ $ ## #
#..# ### # #  #  #
#..# # $$###$##$ #
#..#       $@$ $ #
#..  $# $ # $$ # #
#  #  #  ###   # #
#    ###  #  ### #
#..#    $ $      #
#..# ##$  #  # $ #
#..#  #  ### ##  #
#..#  ##$$ #$##$ #
#..#             #
##################
Solution: l7,8-10u1,4-4d7,8-7d1,9-9l4,4-10u3,5-7u1l3,1-5d7,4-13u6,5-6l3,1-5d6,6-5l1,4-4d1,5-6l2,2-5d7,11-9l6,4-10u3,5-6l2,2-5d6,8-7u1,9-5l4,4-4d1,5-6l3,1-5d5,7-11u1,8-9l3,4-10u3,5-6l2,2-5d5,8-13u3,9-9l4,4-10u3,5-6l2,2-5d4,12-13u3,13-9l8,4-10u3,5-6l3,1-5d4,10-12l1,8-13u3,9-9l4,4-10u3,5-6l2,2-5d3,15-11u1,16-9l11,4-10u3,5-6l3,1-5d3,15-13u3,16-9l11,4-10u3,5-6l2,2-7u5,12-5d3,13-9l8,4-10u3,5-6l2,2-7u4,14-6l1,12-5d3,13-9l8,4-10u3,5-6l2,2-7u3,12-3d5,13-9l8,4-10u3,5-6l2,2-7u2,14-5l9,4-4d1,5-6l2,2-7u1,12-1d3,13-5l8,4-4d1,5-6l3,1-7u5,9-2r2,12-1d3,13-5l8,4-4d1,5-6l3,1-7u4,16-5l11,4-4d1,5-6l3,1-7u3,15-3d1,16-5l11,4-4d1,5-6l3,1-7u2,7-2r4,12-1d3,13-5l8,4-4d1,5-6l3,1-7u1,8-3d1,9-5l4,4-4d1,5-6l3,6-4r1,8-3d1,9-5l4,4-4d1,5-6l2

;18
###########
# .. #    #
# .  #$#$ #
# .  #  $ #
# #  # $$ #
#    #  $ #
#.  .#  $ #
##$## $#  #
#    @    #
# $#$ ##$##
# $  #..  #
# $  #   .#
# $ $#  #.#
#  # #  ..#
#    #....#
###########
Solution: 2-8u2,1-5r1,3-6u4,4-1l1,1-10r1u4,1-5r1,3-6u3,4-2l1,1-13r1,1-12r1u6,1-5r1,3-6u4,4-10l1,2-11u5,1-5r2,4-4d1,4-13u1l1,2-13u7,3-5l1,1-4d1,4-10u1,5-8l2,2-9u3,1-5r1,3-6u2,4-3l1,8-8d2,7-11r1,9-10d3,9-5l1d5,9-11l1,7-10d2,6-13r1,9-3l1d7,7-11r1,9-10d2,6-4r1,8-3d7,9-11l1,7-10d3,6-14r1,6-5r1,8-4d6,9-11l2,6-10d3,8-1d9,9-11l1,7-10d3,6-3r1,8-2d8,7-11r1,9-10d1,6-6d1,5-8r2,8-7d3,9-11l2,6-12u1,6-1d6,5-8r2,8-7d3,9-11l1,7-10d1,4-12u3,3-8r4,8-7d3,7-11r1,7-13u2

;19
      ###
    ### ###
  ###. ...###
  # $.$.$.$ #
 ## ###.### ##
 #  #...$.#  #
 #  $.....$  #
##  #... .#  ##
# #$ ##.## $# #
#  $  $     $ #
# $#$ $$$ $#$@#
#       $$  $ #
###   ###   ###
  ##### #####
Solution: 13-11l2,9-12u1l4,7-11u4,7-5d1,8-7l1,4-9l1u2,7-7l1,5-3r1,7-2d3r1,7-5d1,6-7r2,9-3l1,7-2d3,7-7u4,8-2l2,3-3r1,11-9u2,11-3l1,5-10r1,7-11u4,8-6l1,6-5d1,5-9r1,7-10u2,7-8u1,10-3l1,7-7u1,8-5l2,3-5d1r3,3-8u1,2-6r2,8-6l1,1-9r4,5-9r1,7-10u4,8-5l1,11-7u1l2,11-4d1,12-6l2,7-3r1,13-9l5,7-10u7,6-2r2,9-11u1,10-9l2,7-10u7,6-2r1,8-11u1,9-9l1,7-10u7,12-11u1,13-9l5,7-10u6,11-11l1u1,11-9l3,7-10u5,9-12u2,10-9l2,7-10u4,2-11u1,1-9r5,7-10u3,3-11r1u1,3-9r3,7-10u2,5-12u2,4-9r2,7-10u1

;20
###########
#     #   #
#   $  $  #
##### #   #
##### ###.#
#  #    #.#
# $   $ #.#
#  ### ##.#
## ###  #.#
# $   $ #.#
#   ##  #.#
### #####.#
### #   @ #
#  $    $ #
#    ##   #
###########
Solution: 2-13r3,7-13r1,5-13r2,1-9r1,2-9r1,2-5d4,5-2l2,6-2r2,1-2r6,7-6l1,1-10r1,3-9d3,2-13r3,6-10u1,5-9l2,2-10u3,2-5d4,1-10r1,3-9d3,4-13l1,6-9u3l1,7-5l1,5-6u3,6-2l3,3-6r2,6-7u1,7-5l1,5-6u3,6-2l1,9-1d5,7-2r1,9-1d4,3-2r5,9-1d3,1-2r7,9-1d2,9-14u5,7-13r1,9-14u4,5-13r3,9-14u3,1-13r7,9-14u2

;21
    #####
  ### . ###
 ##  ...  ##
## $#...#$ ##
#    #$#    #
#     $     #
# #$##$##$# #
#   $.@.$   #
# #$##$##$# #
#     $     #
##   #$#   ##
 ##$#...#$##
  #  ...  #
  ### . ###
    #####
Solution: 7-7r2u2,7-5l4,6-5u2,3-2d1,7-2l1,5-1d1,6-7u4,5-2r1,7-1d1,5-9r1d2,7-12l1,5-13u1,6-7d4,5-12r1,7-13u1,3-12u2,8-9l1,6-8d3,7-12l2,9-12u2,10-9l3,6-8d3,5-12r1,3-12r1,8-4r1,9-2d2,10-5l3,6-6u2,6-4u1,7-2l1,6-2l1,10-3d1,11-5l4,6-6u3,5-2r1,3-2r1,1-5r4,6-6u4,3-3d1,2-5r2,4-5r1,6-6u3,3-7u1,2-5r3,6-6u2,2-9r3,6-8d4,3-7d1,2-9r3,6-8d1,6-9d2,9-7d1,10-9l3,6-8d2,3-7r1,11-7l3

;22
 ########
##.     ##
#.. $$$  #
#..# $ # #
#  #   # #
#  # $$# #
#..#$  # #
#..$ # $@#
#..#   # #
#  # $ # #
#  #$  # #
#..#  $# #
#.. $$$  #
##.   $ ##
 ########
Solution: 4-1d2r1,6-4d4,4-7l2,1-6d4,4-9d1,5-4d1,4-5u2,5-1d1l2,2-1d5,3-7l1,1-6d2,7-2l4,2-1d5,3-7l1,1-8u4,4-7u4,5-2l2,2-1d5,3-7l1,1-8u1,1-10u1,6-6l1,4-7u4,5-2l2,2-1d5,3-7l1,7-13l4,6-4u1,7-2l5,5-10u1,6-8l1,4-9u6,5-2l2,2-1d9,5-13u3,5-12l3,7-12l4,4-12u9,5-2l2,2-1d6,6-10u7,7-2l4,2-1d5,6-13u10,7-2l4,2-1d4,8-7u1,8-7l1,6-8u5,7-2l4,2-1d1,6-9l1,4-10u7,5-2l2,5-4u2,6-1l3

;23
 ###############
 #      #      #
 # #$$   $ $ # #
 #   $ # #$  $ #
 # #$ $  $ $ # #
 # #  $ #$   # #
## # ##   ## # ##
# $ #  # #  # $ #
#       #       #
##  # # # # #  ##
 ##    ...    ##
  # # #.@.# # #
  #  .......  #
  #####...#####
      #####
Solution: 14-8u5l2,14-1d6,15-8l3,11-7d4,12-12l2,9-11d1,10-4u1r3,14-2d5,15-8l3,11-7d4,12-12l4,7-11d1,10-4r1,12-5u1,11-3r2,14-2d5,15-8l3,11-7d4,12-12l3,8-11d1,11-1d1,10-3r3,14-2d5,15-8l3,11-7d4,12-12l3,10-1d1l3,2-6d1,1-8r3,5-7d4,4-12r2,8-4r3,12-5u1,11-3r2,14-2d5,15-8l3,11-7d4,12-12l2,4-3r1,5-4r6,4-5u1,5-3l2,2-2d5,1-8r3,5-7d4,4-12r1,12-5u1,11-3r2,14-2d5,15-8l3,11-7d4,12-12l1,4-1d1,5-3l2,2-2d5,1-8r3,5-7d4,10-2d1,9-4r2,12-5u1,11-3r2,14-2d5,15-8l3,11-7d4,9-6u1,8-4r3,12-5u1,11-3r2,14-2d5,15-8l3,11-7d2,12-10l2,9-9d1,5-1d1,7-2l1,6-4u1l3,2-2d5,1-8r3,5-7d2,4-10r2,7-9d1,5-1d1,6-3l3,2-2d5,1-8r3,5-7d2,4-10r4,7-2l2,4-1d1,5-3l2,2-2d5,1-8r3,5-7d2,4-10r3,5-5r1,7-6u1,8-4l3,4-5u1,5-3l2,2-2d5,1-8r3,5-7d2,4-10r2

;24
       #####  ####
       #   ####  #
 ####### #   $ $ #
 #   ##  $ ## #  #
 # $   ..#.## $ ##
 # $ ##.... $ # #
 # #  $....## $ #
##$$ ##.#..   $ #
#  # ## $  ## @ #
#     $ # #######
#  ####   #
####  #####
Solution: 5-6r3,9-5d1,13-5l4,8-6u1,9-8l1,7-9u3,5-9r1,7-10u3,2-6d2,1-9r5,7-10u2,8-3d2,8-3r1,10-2d3,15-1d1l4,10-1d3,15-4u1,16-2l5,10-1d2,9-8u2,15-7l5,9-8u1,15-4l1,13-3d3,14-7l4,15-6l1,13-5d1,14-7l3,2-4r5,2-5r1,8-3d1,4-6u1,3-4r4,2-7r1,4-8u3,3-4r3

;25
###############
#   #####     #
#    . .      #
#.#.## ##.### #
#...  $  .... #
##.. # # ..## #
###### ###### #
#    # #    # #
# $$ #$# $$ # #
# $ $ $ $ $ # #
# $$ #$# $$ # #
#    #@#    # #
# #### ### ## #
#             #
###############
Solution: 5-4r3,9-3d1,8-5r1,8-10u1,4-10u1,5-9r1u4,4-4r4,9-3d1,6-11u6,5-4r6,8-9l1,6-10u5,5-4r5,11-9l4,6-10u5,5-4r4,10-7d1,11-9l4,6-10u5,5-4r3,10-11u1,11-9l4,6-10u7,5-2r3,9-1d1,9-11u1,10-9l3,6-10u7,5-2r6,9-7d1,10-9l3,6-10u7,5-2r4,8-7d1,9-9l2,6-10u7,7-2l3,3-1d3,4-5l1,1-9r4,6-10u7,7-2l3,3-1d3,2-7d1,1-9r4,6-10u7,7-2l5,1-1d2,2-11u1,1-9r4,6-10u7,7-2l5,1-1d1,3-11u1,2-9r3,6-10u7,7-2l4,1-2r1,3-1d2,4-4l1,3-7d1,2-9r3,6-10u7,7-2l4,1-2r1,3-1d2,4-7d1,3-9r2,6-10u7,7-2l4,1-2r1,3-1d1,11-2l5,13-2l5

;26
 ##############
 #     #      #
## ##    # ## #
#..... .....# #
#.. .# #. ..# #
###### ###### #
     #        #
 ##### $##### #
 #    #@#   # #
##$ $ #$#   # #
# $  $ $  $$$ #
#  $  #$#   # #
#   $$# #$$ # #
####      ### #
   ######     #
        #######
Solution: u1,8-6l1,6-7u3,7-3l4,2-2d1,1-4r2,4-13u2l1,5-11u1,6-10r1u3,9-6l2,6-7u3,5-3r2,8-2d1,7-12u5,8-6l1,6-7u3,7-3l4,2-2d1,3-4l1,3-10r3,7-11u4,8-6l1,6-7u3,7-3l4,2-2d1,5-8d1,4-10r2,7-11u4,8-6l1,6-7u3,5-3r4,10-2d1,9-4r1,9-13u3l1,7-11u4,8-6l1,6-7u3,7-3l5,11-11u1l3,7-11u4,8-6l1,6-7u3,5-3r4,10-2d1,9-8d1,10-10l2,7-11u4,8-6l1,6-7u3,7-3l4,4-8d1,3-10r3,7-11u4,8-6l1,6-7u3,7-3l3,5-13u2,4-10r2,7-11u4,8-6l1,6-7u3,7-3l2,1-10r5,7-11u4,8-6l1,6-7u3,5-3r5,1-11r3,5-12u1,4-10r2,7-11u4,8-6l1,6-7u3,5-3r4,2-8d1,1-10r5,7-11u4,8-6l1,6-7u3,5-3r3,13-10l5,7-11u4,8-6l1,6-7u3,5-3r2,11-8d1,12-10l4,7-11u4,8-6l1,6-7u3,5-3r1,11-12l1,9-13u2,10-10l2,7-11u4,8-6l1,6-7u4,7-2l1,5-1d1

;27
###############
#      #......#
# $$ # $.#....#
#   # $#@ #...#
# $# $ # $ #..#
#   $  #$$  ..#
# $ #$ #  #.$.#
#  #  $ $  #..#
# # $  #    # #
#    # #$#  $$#
#   # $#  #   #
#  #   $$  #  #
#      #      #
###############
Solution: 13-8d2,8-6u4,8-5r3,11-6r1u4,13-1l3,9-3d1,8-5r3,12-6u3,13-2l2,8-8u3,7-7l1,6-9d1,3-8r1,4-7r4,9-8u2,8-5r3,12-6u4,13-1l2,6-12u4,5-7r3,9-8u2,8-5r3,12-6u2,13-3l1,8-10u2,8-12u1l2,7-7r1,9-8u2,8-5r3,12-6u3,13-2l1,8-11u3,7-7r1,9-8u2,8-5r3,12-6u4,13-1l1,5-5d1,4-7r4,9-8u2,8-5r3,12-6u4,4-8r1,6-9u1,5-7r3,9-8u2,8-5r3,12-6u3,13-7u5,6-2d4,5-7r3,9-8u2,8-5r4,13-6u3,3-5r1,4-4r1,6-3d3,5-7r3,9-8u2,8-5r3,12-6u2,4-11r3,8-12u4,7-7r1,9-8u2,8-5r3,12-4d1,13-6l1,4-5r1,6-4d2,5-7r3,9-8u2,8-5r3,12-4d2,2-7u1,1-5r4,6-4d2,5-7r3,9-8u2,8-5r3,12-6u1,2-3d1,1-5r4,6-4d2,5-7r3,9-8u2,8-5r4,13-6u2,2-1d3,1-5r4,6-4d2,5-7r3,9-8u2,8-5r4,13-6u1,8-2l1,6-1d5,5-7r3,9-8u2,8-5r4,8-5u2,4-2l1,2-1d3,1-5r4,6-4d2,5-7r3,9-8u2,8-5r3,13-12u5,11-9r1,13-10u2

;28
#################
#       #.......#
# $$$ # $.#.....#
#  # $ ......#..#
# $  # ###.#..  #
#  $ $$ #       #
#  # $   $$  #  #
# ##  # # #  ## #
# $ $## # ##    #
# $@$ $ #       #
# $ $   #       #
#  ##$$ #  ##   #
# $$  $ #       #
#               #
#################
Solution: d1r2u1l1u3r3d7,9-5d1r2d1r1u5r1u1l2r1d2l4r3u2l1r1d2l4u1r1,7-6r4d1r1u5r1u1l2,9-8u1,8-6r3d1r1u5r1u1l1,5-9d2r1,7-12u5,6-6r5d1r1u5,5-10r1d1r1u4,6-6r5d1r1u1l1u1r2u1r2d2l1u4r1u1l1,5-9r1d1r1u3,6-6r5,12-7u1l1u1r2u1r2d2l1u4,5-13u1r1d1r1u6d2l3u3r7d1r1u1l1u1r2u1r2d2l1u3r1u1l3,1-10r5d1r1u4d2l3u3r7d1r1u2l1r2l1u2,2-13u1r4d1r1u6d2l3u3r7d1r1u1l1u1r2u1r2d2l1u3r1u1l1,5-12u2l1u1r2d1r1u3d2l3u3r7d1r1u1l1u1r2u1r2d2l1u3,2-12u1l1u1r5d1r1u4d2l3u1l1d1r1u3r7d1r1u1l1u1r2u1r2d2l1u2,2-10r4d1r1u4d2l3u3r7d1r1u1l1u1r3d1r1u4,1-8d1r5d1r1u3d2l3u3r7d1r1u1l1u1r3d1r1u3,1-8r2,4-7d1l1d1r3d1r1u3d2l3u3r7d1r1u1l1u1r3d1r1u2,2-3d1,4-3r7,6-6u2,5-3r5,4-4d1r1,6-6u2,5-3r4,2-6u1r3,6-6u2,5-3r3,4-7u1,3-5r2,6-4d1l1d1r5u1r2d2l1u1r1u1l1d1l1u1,2-3d1l1d1r4l1u2r2d2l1d1r6d1r1u1l1u1r2u1r2d2l1u1r1u1l1,4-1d3l1d1r2l1u2r2d2l1d1r6d1r1u2,2-1d1r2u1r1d1l1d1r3,2-4u1l1u1r3u1r1d1l1d1r2

;29
#################
#...           .#
# $#$  # # # $  #
#.  $ # # # # $.#
## $ #       #  #
#   #  #####  # #
#  #  #     # # #
# #  #  ### # # #
# .$ . #        #
# #$ # #  # # # #
# #  #  #$# # # #
# .#  #   # # #@#
#   #  ### $# # #
# $$ #     $..#$#
##.   ######$##.#
 ##.$      .   .#
  ###############
Solution: 5-3l3u1,3-1l1,4-4l1,2-5u3,4-3u1,5-1l1,3-12d1,12-2r1,13-3r1,15-4u2,15-14u10,1-13r1,2-14r1,3-15r2,5-14l1,4-13l1,3-15u1,2-14u2,3-12d1,4-14l1,7-15l3,12-13d1,13-15l1,14-1d1,15-2d12,13-3r1,2-8r2,9-11u2,8-8r6,15-7d6,10-13r2,11-11d1,10-13r1,3-10u1,4-8l1

;30
      #####
#######   ####
#.*.  $$  $  #
#.. ### ## # #
#...# #  # # #
## #  #  # # #
##$$  #$ # # #
#  #.$   # $ #
# . #$$$   #@#
#  #.$   # # #
##$$  #$ # # #
 # #  #  # # #
## ###  ## # #
#...  $$  $  #
#.. ###   ####
#...# #####
#####
Solution: d5l3d1l2u1l4,11-2l2u1l2d1r3d6l2,1-13r1u4l1u2r1d7l1d1r1u11,5-2r2,4-13l1,2-12d1l1d2u2r2d1l1u1l1d1,9-13l6,2-12d2,6-9l1d1l2,2-9d4r1d1l1,7-11d1l1d1r1,1-2r1d1l1u1r2d1l1r1d1l1,9-13l6d1l1u10r1u2l2d1r1u1r1d1,7-9d3l1d1r1d1r2u1l6d1l1u10,5-2l3r1d1l1,7-7d5l1d1r1d1r2u1l6d1l1u10,7-5d7l1d1r1d1r2u1l6d1l1u9,2-6r2d1r2,7-6d6l1d1r1,5-5d1l1d1r2,7-6d3l2,9-13l6d1l1u5,7-9d3l1d1r1d1r2u1l6,2-12d1,5-9u1d1r2u2l2,9-2l6,12-2l8r3d10l1d1r1d1r2u1l7,12-7l1,10-6d6,11-13l8,5-8r1u1r1d5l1d1r1d1r2u1l5

;31
###############
#     #   #   #
# $$  $   $ $ #
#  $ ###### # #
# $$ #@  #  $ #
#    #  $    ##
######$##  ##.#
 #   # $   #..#
 #    $   #...#
 ## #### # ...#
 #  $   $*....#
 #   #   #.  .#
 ##############
Solution: 7-5r3,7-8l1,6-7r2,9-8u1,6-8l2,2-8r4,3-10r3,8-11u2,8-10r4,13-11u4,6-10r5,12-11u3,8-7d2,7-10r5,13-11u3,6-8r1,8-7d2,7-10r5,13-11u2,6-5d2,5-8r2,8-7d2,7-10r5,13-11u1,9-7u1,10-5l3,6-4d3,5-8r2,8-7d2,7-10r4,12-9d1,11-11r1,13-4l1,12-5l5,6-4d3,4-8r3,8-7d2,7-10r5,11-3d1,12-5l5,6-4d3,5-8r2,8-7d2,6-10r4,11-9d1,12-11l1,13-2l1,11-1d3,12-5l5,6-4d3,5-8r2,8-7d2,7-10r3,11-11u2,11-2l2,7-2r4,13-2l1,11-1d3,12-5l5,6-4d3,5-8r2,8-7d2,7-10r3,11-11u1,7-2l2,2-3r1,3-1d1r8,13-2l1,11-1d3,12-5l5,6-4d3,4-8r3,8-7d2,7-10r4,12-11u2,1-2r10,13-2l1,11-1d3,12-5l5,6-4d3,5-8r2,8-7d2,7-10r4,12-11u1,2-5u2,1-2r10,13-2l1,11-1d3,12-5l5,6-4d3,5-8r2,8-7d2,7-10r4,4-4u1,3-2r8,13-2l1,11-1d3,12-5l5,6-4d3,5-8r2,8-7d2,7-10r3,2-4r1u1,2-2r9,13-2l1,11-1d3,12-5l5,6-4d3,5-8r2,8-7d2,7-10r2,4-5u2,3-2r8,13-2l1,11-1d3,12-5l5,6-4d3,5-8r2,8-7d2,7-10r1

;32
#############
#....#  ##  #
#.. .# $ $$ #
#.....@ ##  #
#....## #  ##
##.####$#  #
#  #       #
# $  $ ###$####
## ###    $   #
# $ # $# ## $ #
#    $  $ ## ##
#######  $## ##
    ###$ $    #
    #    $#   #
    #     #####
    #######
Solution: 1-7r1,2-8d1,4-10r2u2,8-9d1l1,7-11d1,8-13l1,8-10d2,5-10r2,8-9d1,8-12r3,13-12l1,12-10u1,11-8l3,10-8u2,4-7l1,2-8u6,3-1l1,6-6d1l3,2-8u5,1-2r2,4-3u1,7-4d1,8-6l2,10-4d2,10-1d3,7-1d1,10-2l3d1,6-1d1,7-3l3,3-4u2,7-5u2,8-2l1,6-1d1,7-3l5,1-2d1,10-6u3,11-2l4,6-1d1,7-3l4,2-4u1,3-2l1,10-8u5,11-2l4,6-1d1,7-3l4,2-4u2,4-6r5,10-7u4,11-2l4,6-1d1,7-3l5,6-9u2,5-6r4,10-7u4,11-2l4,6-1d1,7-3l3,3-2d1,2-4r1,8-8l1,6-9u2,5-6r4,10-7u4,11-2l4,6-1d1,7-3l3,3-4u1,2-2r1,8-12u3,9-8l2,6-9u2,5-6r4,10-7u4,11-2l4,6-1d1,7-3l3,3-2d1,8-14u5,9-8l2,6-9u2,5-6r4,10-7u4,11-2l4,6-1d1,7-3l4,2-2d5,13-8l6,6-9u2,5-6r4,10-7u4,11-2l4,6-1d1,7-3l4,2-2d4,1-7r3,5-13r1,7-14u3,6-10r1,8-11u2,9-8l2,6-9u2,5-6r4,10-7u4,11-2l4,6-1d1,7-3l4,2-4u1,2-9u4,6-7l3,2-8u2,12-12l3,8-13u4,9-8l2,6-9u2,5-6r4,10-7u4,11-2l4,6-1d1,7-3l4,1-10r6,8-11u2,9-8l2,6-9u2,5-6r4,10-7u4,11-2l4,6-1d1,7-3l3,9-14u1,10-12l1,8-13u4,9-8l2,6-9u2,5-6r4,10-7u4,11-2l4,6-1d1,7-3l2,9-10d1,10-12l1,8-13u4,9-8l2,6-9u2,5-6r4,10-7u4,11-2l4,6-1d1,7-3l1

;33
 #####  ####
 #.  ####  #
 #.#   $   #
 #.### # # ##
 #   $ $ $  #
## ### # ## ##
#. ..#$@$$   #
#..# # $ #   #
#.##  # #  # ##
# $      $#.. #
# $#$#$# $ ...#
## #      #####
 #     ####
 #######
Solution: d1,8-7u1r2,10-10l1,9-8d1,8-9d1r1,9-11l3,6-4l3,2-3d3,6-7u3,4-11u4,1-9r3,6-9l1,4-8d1,6-2r2,8-4l5,2-3d2,1-6r1,12-6l1,10-4l7,2-5u3,9-6r1,11-10l2,11-5d1,10-7r1,12-6d2,13-9l1,8-4d1,7-6r3,11-5d1,10-7r1,12-6d2,8-11u1,7-9r1,9-8d1,8-10r4,6-11u1,5-9r3,9-8d1,8-10r3,7-7d1,6-9r2,9-8d1,8-10r2,6-2d1,7-4l4,2-5u2,8-2r1,10-1d2,11-4l8,2-5u1,2-11u1,3-9l1,1-10u3,4-11u1,5-9l3,1-10u2,6-11l1,4-12u2,5-9l3,1-10u1

;34
##################
#   #        #   #
# $$#$ $ # # # $ #
#  $     # #$# $ #
# $ ##$## $  $  ##
# # $ $  # # #   #
#  $#   $# # # $ #
### #     $ $#   #
# $ #  #$# #  ####
# #  ###  #  #   #
#  ..#.   #    $ #
###..#.#  #  # $ #
#...##.# # #$## ##
#. . ...#      $ #
#. .....# $ ## $ #
#...#...#   @#   #
##################
Solution: 16-13l5,16-14l1,12-13u2l1u2r1d1,16-10l1d3,12-12u1l1u2r1d1r2l2u3l5r5d3r2d1r1d2l3u2l1u1r1u3l2u3r2d5u2l5u2r1d1l1d1r3l3u1l2u1r1u2l3d10l1d1r2u1r2d2l1u1l1u1r1d1r1u2,8-7d2r1d1l2,3-1d11l1d1r3d1r1u1,1-4u2r1u1r1d12l1d1r2u1r1d1,1-4u1r1u1r1d11l1d1r3u1r1d1,1-4r1u1r1d10l1d1r4u1r1d1,1-8r1l1d2r2u4l2u2r2d9r1d1l2d1l1u2,7-1d1r1d1l5u1l2d1r1u1r1d10l1d1r4,6-1d1r1d1l4u1l2d1r1u1r1d7u1l2d2r2u1r1d1,5-1d1r1d1l3u1l2d1r1u1r1d7u1l2d2r2,5-5l1,3-4d9r1d1l1d1l1u2,8-5l4,3-3d10l1d2r1u1l1u1r3,6-8u2r1u1l3r2u2l3d10l1d2r1u1l1u1r2,12-7l6d1l1u2r1u1l2r2u2l3d10r1d1l2d1l1u1,10-2d4,11-7l5d1l1u2r1u1l2r2u2l3d10r1d1l1u1l1d1r1d1l1,12-4r2u3r2d2l1d1u1r1u2l2d2r1d1l4,10-3d3,11-7l5d1l1u2r1u1l2r2u2l3d10r1d1l2,12-2d1u2l2d3r4d3r2u2l1u1l1r1d1r1d2l2u2r1u1l4r1u3l2d5u2r2d3l6d1l1u2r1u1l2r2u2l3d10r1d1l1u1l1d1,16-6l1d1l1u2r1u1l4r1u3l2d5u2r2d3l6d1l1u2r1u1l2r2u2l3d11,16-2l1u1l1d3r1d2l1u1r1u1l4r1u3l2d5u2r2d3l6d1l1u2r1u1l2r2u2l3d10l1d1r4,16-3l1u1l1d1r1d1l4r1u3l2d5u2r2d3l6d1l1u2r1u1l2r2u2l3d10l1d1r3,12-11u6,11-4r3d1r1u2r1u1l1u1l1d2r1d1l4r1u3l2d5,11-7l5d1l1u2r1u1l2r2u2l3d10l1d1r2,14-10l1,12-11u6,11-4r3d1r1u2r1u1l1u1l1d2r1d1l4,10-3d3,11-7l5d1l1u2r1u1l2r2u2l3d10l1d1r1,16-10l3,12-11u6,11-4r3d1r1u2r1u1l1u1l1d2r1d1l4r1u3l2d5u2r2d3l6d1l1u2r1u1l2r2u2l3d10,15-15u4r1u1l3r2d3l3u8d2l2u3r4d1r1u2r1u1l1u1l1d2r1d1l4r1u3l2d5u2r2d3l6d1l1u2r1u1l2r2u2l3d9,14-15u1,13-13r1d1r1u3r1u1l3r2d3l3u8,11-4r3d1r1u2r1u1l1u1l1d2r1d1l4,10-3d3u2r2d3l6d1l1u2r1u1l2r2u2l3d8,9-13r5d1r1u3r1u1l3r2d3l3u8d2l2u3r4d1r1u2r1u1l1u1l1d2r1d1l4r1u3l2d5u2r2d3l6d1l1u2r1u1l2r2u2l3d7,10-15u1l1u1r5d1r1u3r1u1l3r2d3l3u8d2l2u3r4d1r1u2r1u1l1u1l1d2r1d1l4r1u3l2d5u2r2d3l6d1l1u2r1u1l2r2u2l3d6

;35
#############
#  . . . .  #
# # # # # # #
# # # # # # #
#.$ # $ # $.#
# # # # # # #
# #$$$#$$$# #
# # # # # # #
#.$ # $ # $ #
# # # # # #.#
# # # # # # #
#  . .@. .  #
#############
Solution: r3,9-4r1,11-5u1,9-8r1,11-7d1,9-5d5,7-7u1r1,9-7u1,5-8r1,7-7d3,3-4l1,1-5u1,3-8l1,1-7d1,3-5d3,5-7u1l1,3-7u3,1-10u1,3-8d2,5-4d6,1-2d1,3-4u2,7-6u2,11-2d1,9-6u4d4l2u4d2l1r1d4l2u6

