;1
 #########
 #   ##  #
 #    $  #
 ## ###  #
  # # .. #
### $  #.#
# $$# ##.#
#  @     #
##########
Solution: u3d1r1,5-4d1,7-2l3u1l2d1r4l3d3,7-1d1,3-7u4,5-7u1,6-5l1,7-2d1r1d1l1,2-2r4,7-1d2,5-5l1,3-6u3,2-2r5,1-6r1d1r1u4,8-1d4,2-2r5u1r1d3

;2
#######
#  $. #
# # # #
#  $  #
# # #.#
# @*  #
#######
Solution: r1u2,4-1l1d1,4-3l1,1-3r2,5-5l1,3-3r1,5-2d1,1-1r2

;3
#########
#       #
# #####$##
# # $    #
# # ###  #
# # #  $.#
# # # # *##
# # #   *@#
# # ####. #
# #     . #
# ###### ##
#        #
##########
Solution: l2,7-6u1,7-3d2,8-5d2,8-9u4,5-7r2,7-5d1,8-6d1,7-1d4,3-3r3,8-7d1,6-7r1,8-6d1,9-9l1,7-2d2,8-3d2,6-5r1,6-9r1,7-5d1,6-7r1

;4
 ######
 #    #####
##$#$  $  #
#+*...*.  #
# $$     ##
#  #######
####
Solution: r2,2-5u1r3,6-2r1,3-3r1,1-3r1,5-4r1u1,8-4l4,4-3r1,2-1d2r2,4-1d1,5-2d1r1,8-3l1,7-2l2,5-3r1,9-2l2,3-3r1,4-4r1u1,4-1d1,3-3r1,2-5u1,1-3r1,4-4l1,2-5u1,5-4r1,6-3r1,9-3l1,8-4l6,1-5u1,4-3r1,5-1d1,7-2l2,4-1d1

;5
 #######
##     #
#  ### #
# #  # #####
#   .#     #
###* ##### #
 ## .$     #
 #..*##$ ###
 #     $$  #
 ###### @  #
      ######
Solution: u1l4u1,2-8r6,3-6u1,4-5d1r4d1,7-8u1,8-6l4,3-5d1,3-3d1,10-6l3,4-8u1l1,3-6u1,4-4l1,4-5d1,7-6l3,8-9u1,10-8l2,7-9u1,3-7u2,8-6d1,7-8u1,8-6l4,3-5d1,3-3d1,9-8l1,7-9u2,8-6l1,7-6l2,1-4r2

;6
     #####
    ##   ####
    # $#   .#
##### $. #$ #
#    $  ##.$#
#   #**...$@#
#####    ####
    ######
Solution: u2,11-5l3,6-6u1r1,7-3l1d1l3,1-4r5,6-1d1,5-2d1r1,10-2d1,9-5l1,6-6u1r2,6-5u1l1,6-2d1,8-3l1d1,5-4r1,6-5r1,7-3d1,5-3r1,5-4l2,1-4r4,6-3d1

;7
##########
#     @  #
# *$*$*# #
# .$.$.$ #
# * .$. ##
# *##   #
# *.#  ##
########
Solution: d2,4-1d2r1d1r1u1,2-3r1,3-4r1u1,1-6r1,1-4r1d1,4-4l1,2-3d1,6-4l3,5-6u1,4-4r1,5-1d2,3-1d1,4-3l1,8-3l2d1l1,6-3l1,6-6u1,7-5u1,8-3l1

;8
 ########
 #      #
 # #$.# #
## #+*. #
#   $ $##
#   #  #
########
Solution: r1d1l2,2-5u1,4-1d2r1d2u1l2,7-3l2,6-5u1,7-3l1d1l1u1,1-4r4,2-2d1,6-5u1,1-4r4,7-3l1,6-5u1

;9
########
#      #
# #### #
# #  . #
# #$ . ###
# # #***.#
# $@$    #
######   #
     #####
Solution: r2u2,3-3d1,6-3l1,5-6r1u1r1,8-6l1,6-7u1,1-6r1,2-6r4,8-6l1,7-5l1,6-7u1,3-4d1,2-6r3u1,5-6r1,8-6l1,7-5l1u1l1,6-7u1,5-6u1r1,6-2d2,5-3d1,3-4r1,3-3r1

;10
 ####
 #  ######
 # $     #
##..## # #
# .*     #
#  ###*.##
## $@#  #
 #  $  $#
 ####   #
    #####
Solution: l1,2-7u1,3-7r2,7-8u1l1,6-6u2,4-2l1,2-4r4,7-5d1,6-7l2,2-6u1,1-4r1,6-2d3,8-4l1,6-5u1,6-7u1,6-4u1,7-2l1,2-4r1,2-1d2,3-4r3,6-2l2,3-1d1,8-4l1,2-5u1,7-4l4,6-6u1,7-4l3,7-8u2,2-7r3,6-8u2

;11
########
#.  .  #
#....  #
# $$#  #
### ## ##
#   $ $ #
# $   $@#
#  ######
####
Solution: l1u3,3-2d3r1,4-6r1,2-7u1,1-5r1,2-6r1u4,4-1l2,1-3r1,6-5l1,5-6l2,3-4u1,4-2l2,2-7u1,1-5r1,3-6u3,2-2r1,5-5l1,7-6l4u4r1,6-1d3,2-7u1,1-5r1,3-6u3,2-1r2,4-2l1,7-5l3,3-6u3,6-1l1,6-2l1

;12
#####
#   ####
# # .  #
# $$.  #
### .  #
  # * ##
  #$*$#
  # .@#
  #####
Solution: u3,6-3l1,3-7u1r1,5-7u3,3-4d1,4-4d1,3-2d1,4-2d1,1-3r2,5-4u1,3-5u1r1,5-5u1,3-7u1,4-5d1,3-4u1,3-1d1,4-2d2,2-3r1,3-6u2,4-4d1,3-4u1,3-1d1,4-2d2,2-3r1,6-2l1d1,6-4l1

;13
  #####
### $.#####
#    ..   #
# ##$..   #
#  $@## ###
### $  $#
  ###   #
    #####
Solution: l1,3-5r2,7-6u3,4-2d2,8-2l2,5-5r1,7-6u3,1-4r2,3-5r3,6-2l1,8-2l2,4-3d1,3-5r2,7-6u2,5-5r1,3-1r1d2,8-3l2,6-2l2,4-3d1,3-5r2,7-6u2,8-3l1,5-5r1,7-6u3,8-2l1,2-2r2

;14
 ##### ######
##   ###    ###
#      # ##   #
#  $ #   #  # #
#  #$##### ## #
# *......*.#  #
# $ $####$$$ ##
##   #  # @###
 #####  ####
Solution: u2l6u2l1,2-4u1,1-2r1,1-6r1u1,2-5u1,4-7u2l1,9-7u1,10-5l6,2-4d1r5,2-2d2,1-5r5,4-3d1,3-5r2,4-1d3,3-5r1,2-7u1,3-7u1,3-1d1,2-3r1,4-2d2,12-6l2,9-7u1,10-3d1

;15
 #########
 #   #   #
##.#$# #.#
# $.$ $ $#
# @$  .  #
#.# # #.##
#   #   #
#########
Solution: r3d2r2u2r1u1d1l1d2l2u3r1l1d1l2u1r1d1l3u1r1d1r3d2r2u2l5u1l1d1r3u1l1d1l2u1r1u2r2d2l1d1r2l3r2u3l2d2l1r3d1r1d2r2u2l1u1l2d1r1d2r2u2r1u1l2r1d3l2u2r1u1r1d1l3u1r2d1r2u1l2d1l3r1u3l2d2l1d1r5l2u1l1d1l1u1d1r4u1l2r4d1l1

;16
 #### ####
 #  # #  #
 #  ###  #
 #$..... #
 # #### ##
 # #@$  ##
## #$#   #
#  # $ $ #
#     # ##
##  #   #
 ####  ##
    ####
Solution: r2,7-6u3,2-2d5,1-8r3,4-5d2,6-7l1d1l2,2-9u6,4-6d1,8-7l3,5-10u2l1u1r2,7-8u1,8-6l1,2-8r2,5-9u1,4-5d2r2,7-8u1,3-8r1,7-1d1,8-3l1,7-7u2,5-9u1,4-7r2,7-8u1,2-1d6,1-8r3,7-5u2l3,7-1d1,8-3l3,7-7u4,7-1d1,8-3l2,6-7u1,5-5r1,7-6u3,7-1d1,8-3l1,5-9u1,4-7r2,7-8u4

;17
 #######
 #     #
##$### ####
#  # .  $@#
#  $...#  #
#  #$. #  #
##$# .##$##
 #  $.   #
 ###   ###
   #####
Solution: l3,2-1d2,2-5u1r2,4-3r2,2-2d1,1-4r1,4-6u1,8-7u2,8-3l1,4-8u1,2-7u2,6-2d1,5-3d2,4-5d1,4-3d1,2-5u1r2,5-3d1,8-5u1,9-3l3,2-2d1,1-4r3,3-7r1,4-6u1

;18
###### ######
#    ###    #
# $    $  # #
#..#.###    #
#..#.#@#$# ##
## $ $ $   #
 ########  #
        ####
Solution: 6-5r3,10-6u2,8-5u2,8-1d1l4,4-5r4,8-4u1,7-2r1,11-3l2,8-5r1,10-6u2,2-1d1,2-5r2,4-2l2,1-1d2,11-3l1,2-2d1,8-4u1,10-3l1,9-1d1l7,1-1d1,8-4u1,10-3l1,9-2l2,7-2l3,4-5r4,8-5r1,8-4u1,4-2l1,2-1d1,9-2l5,2-2r1,4-1d2,10-6u2,11-3l2,8-4u1,9-2l5,2-2r1,4-1d1

;19
#####
#+  #
#$# ###
#  $  #
# $$. #
#..####
####
Solution: d3,2-3d1r1u1,5-4l2,3-1d1,2-3r1,5-3l2,1-4r2,3-3l1,1-4u2

;20
   #####
   #   #
   #.# #####
 ###  $#   #
 # $    $@ #
##.#.#*#####
# $. *   #
#    #   #
##########
Solution: l3u1l2d1r4,1-6r1,4-6r2,2-4r2,4-6l1d1l1u1,8-6l4,6-4d1,5-6r1,6-1d3,2-6r1d1r1u4,8-6l4,6-4d1,5-6r1,8-6l2,4-4r1u1r1d1,10-4l5u1l1d1

;21
  ####
###  #
#    ##
# #.  #
#  .$ #
## * ##
 #$*$#
 #@. #
 #####
Solution: u2,4-7u1l1,2-7u1,3-6u3,5-4l1,3-3d1,3-1d1,1-4r1,2-4r1u1,2-2r1,3-4d2,2-6u1,5-4l1,3-3d1,1-4r1,4-6u2l1d1,1-4r1,3-3d1,5-3l1,4-1d2,5-4l1

;22
#####
#   #####
# #$#   #
# ..  # #
# #..$  #
#  #.  ##
##$ ## #
#@$  # #
# $    #
#####  #
    ####
Solution: d1r4d1r1u4,5-3d1,7-4l3,1-7r1,2-5d2,1-8r4d1r1u4,7-4l1,4-5r1,6-4l1d1l1,6-6u1,4-5u1r1u1l2,3-1d1,7-4l2u1l1d1,3-6d1l1d1r3d1r1u4,7-4l2

;23
 ########
##      ###
# .#$*# $ #
# * $.  $@#
##* #. ####
 #. $.   #
 #       #
 #########
Solution: l2,5-1d3,7-3l1,5-4u1,5-6u1l1,5-3d1,5-1d2,4-5r1,2-5r1,3-3r2d1,1-3r1d1,4-3l1,2-4u1,4-1d1,9-2l1,7-3l1,5-4u1l2,2-6u1,5-6u1l2,7-5l1,7-1d1,8-3l2

;24
  #### ######
  #  # #    #
###$.###    #
# .   .$ #$##
# # $ #. .@#
#   #$* # ##
#####     #
    #######
Solution: u1,11-2l1,8-3l5,1-3r6,8-2d1,5-4l1,3-5u1,2-3r2,3-1d1,4-3l1,4-3r3,5-6u2,6-3l1,4-4u1,9-4l1,7-5u1,8-2d1,9-4l1,8-3l3,10-2l1,8-1d1,8-2d1,7-3d1r1,7-6u1,3-3r2

;25
  ####
  #@ #
###$ #
#   $###
#   .$ #
###. . #
  ######
Solution: r1l1d1r1d1l1d2r1u2,6-4l1,4-3d1l1d1r1,4-1d2l1d1l2u1r1d1u1d1r1u1r1u2l1d3

;26
#########
#     @ #
# # $ $ #
# ##$# ##
# $.*  #
###..# #
#  ..# ##
#  $##  #
#       #
#  ######
####
Solution: d6,7-8l4u1,2-6r1,3-4r1,2-9u1,1-7r1,1-4r1,3-2r1d2r1,6-3d4,7-8l4u2,2-9u1,1-7r1,3-8u1,6-2l1,4-1d2

;27
#######
#     #
# ###$#####
# # ..*@$ #
# # . #$$ #
# #$.   # #
#   . #   #
###########
Solution: l2,5-1d3,3-3r1,5-4u1,5-6u1,9-3l4d1,6-5l1,3-3r2,5-1d2,4-6u1,3-4d1,2-6r1,7-3l2d1,6-5l1,7-5u1,8-3l2,9-4l1,7-5u1,8-3l1

;28
    #####
   ##   #
   # $  #
   # #$##
  ## #  #
 ##  #  #
 #  #*  #
 # #.. ##
## ..$$ #
#  .# $@#
#     ###
#######
Solution: l1u2,4-8r1,5-10u2,7-8l2,6-7u1,6-4d3l1,7-8l1,5-9u1,4-2r1,7-2l1d6,4-2r1,6-1d3,7-9l1,5-8l2,5-10u1,6-8l2,2-7d1,1-9r1,6-4d3,7-8l2

;29
 #########
##   #   #
# .# #.# ##
#         #
## * # .. #
##$#.#$####
#  $  $@#
#   #$# #
##  #   #
 ########
Solution: l1u2,7-3l3,2-3r5,8-2d1,9-4l1,4-6l1d1l2u1r1u3,2-1d1l1d1r6,8-2d1,4-6l1d1l1u4,2-1d1,1-3r1,6-6l3,2-3r3,6-4u1,2-7u3,1-3r2,4-2d2,5-8u1,6-6l3d1l1u4

;30
########
#      #
# *$$  ##
# . **..#
##.$    #
 #*$#$###
 #+   #
 ######
Solution: u2r3u1,3-1d2,1-3r1,2-4r1u1,5-3l1,4-1d1r1,5-4l1u1,2-3r1,5-6u2,4-4l1,2-3d1,5-4u1,7-4l4d1,4-6l1,3-3r3,3-1d1,2-3r1,5-3l2,4-1d1,5-1d1,6-1d1

;31
  #####
  #  @#
###$$$###
# $.*.  #
#  * *# #
#  .*.  #
###   ###
  #   #
  #####
Solution: d1u1l2d1r1d1r1d2l1r1u2l1d1l1d1u1r2l2u1d1r2l2d1l2u1r2u1r2d2l2r1d2r1u2l2u2r1d2r3u2l2d1l1d1r1u1l4d1r2u1r2d3l2u1d1u2d2r2u3l2r2d2l1r1u2l1r1d2l1u1r1u2r2d2l1r1u2l2d2l2u2r2l1u2r1l2d2r2d2l2u1r1u2l1d1r1d2l3u2r2l2d2r3u2d2r3u2l4r1d4u4l1r2l1d2l3u2r3l1u2r1d2l3d2r6u2d2l3u2d4l1u1r1u3l3d2r2l2u2r3d2r3u2l2r2d2l6u2r2u2r2d1u1l2d2l2d2r2d2r2u1d1l1u1l1u1l2u2r1d1l1d1r1u2r1u2r2d1l1u1l1d1

;32
####
#  ######
#     $ #
# .##$  #
# .#@$  #
# . $# ##
##.    #
 ####  #
    ####
Solution: d1,3-6r2,6-7u3,7-2l4,2-1d3,1-5r1,6-4u1,7-2l4,2-1d2,4-4r1u1,6-2l3,2-5r1,2-3d1,2-1d2,1-5r1,6-5u2,7-2l4,2-1d1,4-4d1l1,5-6l2

;33
#########
#  .. ..#
#    .#$#
## # .  #
 # $ # ###
 # $# $  #
 # $@$   #
 #  ######
 ####
Solution: l1,2-7u5,1-1r3,4-4l1d1,2-5u2,3-7u1,4-6r2u1,8-6l5,2-7u3,1-2r3,7-3u1,6-3d2,7-6l4u1,2-4u2,4-1r1d1,1-1r2,4-4l1,2-5u2,1-2r3,2-7u5,1-1r1

;34
 #####
 #   #####
 #$#     ##
 # #####  #
## #   #.$##
# $ .#$#   #
# # @$     #
# ...#######
######
Solution: r4,10-6l6,6-4d1,1-5r2,5-6r3,2-1d3,1-5r1,4-4d1,2-5r1d1,5-6l1,4-7l1u1,4-4d2,2-5r1,10-6l1,9-6l1,8-6l4,3-5d1,9-3d1,10-5l1,8-6u1

;35
##########
#    #   #
# *..**  #
#  $  $@##
#   #####
#####
Solution: l1,6-3l1,6-1d1l2,2-1d1r4,3-4u1,5-3l1,2-2r1,3-4u1,2-4u1,8-2l1,7-3l4,3-1d1r1,1-2r2,3-4u1,2-4u1

;36
 #######
 #     #
##$..* #
# $.*. #
# $*** #
#@$    #
#####  #
    ####
Solution: r3l1u2r1d1u3r2d1l1r1d2l1u1l2d2l2u2r1d1u1d1r2u1r2u2l4d2u2r4d3l1r1d2l1u1r1u4l4d2r1d2u2l1u2r4d4l1u1,3-5r1,5-4l1r2d2l1u1r1u1l1,1-5r1u1l1u1r1d2r2,5-6u1

;37
  #####
  #   #
 ## # #
## $  ###
# ...*. #
#  # $  #
#  $ ####
### $#
  # @#
  ####
Solution: u3r1u2,4-3d1,2-3r1,4-4d2l1,4-8u3,5-4l2,2-3d1,1-6r2,4-5d1,7-5l2,4-6u1,3-4r2,5-1d2l1,3-2d1,2-6u1,4-8u3

;38
 ####  #####
 #  ####   #
 #  $   $# #
 # .###    #
###$###....#
# @*   $$ ##
#   #   ###
#########
Solution: r3d1r2u2r2u1r1u2l2d1l3,3-5r2d1r2u1l4u2l1u2r1d1r4d1r1d1r1d1l2r2u1r1u3l2d2r1l1u2r2d2l1d2l2u2d1r1l1d2l2u1r1d1r1u1l4u2l1u2r1d1r4d1r3l2d2l5d1l2u1r4d1r2u1l3r4u2r2u2l2d2

;39
 #####
 # . ###
## .@$ #
# $*$  #
#  . ###
# $* #
## . #
 #####
Solution: d1,6-2l2,2-2d1r2,3-4d1,4-5u1,1-5r1u1,4-5l1,3-3u1,4-2d1,1-3r1,3-4u1,6-3l3,1-3r1,2-2r2,4-3l1,2-2d1,6-2l2,4-5u1,3-3r1,1-5r1,1-4r1,6-3l2

;40
    ####
  ###  #
### .$ ##
#    .  #
# $.## .###
##* ##*$$ #
 #  .   $@#
 ##  * ####
  #  ###
  ####
Solution: l3u2,7-3l3,3-2d1,6-2l1,7-6u1,9-5l2,6-6u3,3-3d3,4-6r2,1-4r1,3-5u1,6-1d3,4-3l1,1-3r3,3-8u3,6-6r1,9-6l4

;41
 ######
 # .@ #
 #$.$ #
 # * ##
## * ##
# $*  #
#  *  #
#  .  #
#######
Solution: d3l1u1,4-4d2l1,1-6r2u1,5-7l2,1-5r1,2-3d2r1u1,5-5l1,3-6u1,1-6r1,2-1d4,4-7u5,5-1l1,1-7r1u1,1-5r1

;42
#######
#     #
# $#$.####
# $@$... #
##   .$  #
 #########
Solution: r1,5-4r1,8-4l4,4-3r2,1-3r4,4-1d1,3-3r1,5-4u1,2-1d1,1-3r3,2-4r2

;43
#######
# @   ##
# $ $$ ##
## ##   #
#  ..$# #
#  .. # #
#####   #
    #####
Solution: d3,5-3d1,1-5r2,5-1d1l2,2-1d3,5-4u1,6-2l3,5-6u3,3-5r1,1-5r2,6-2l1,2-1d2,5-2l2,5-6u3,3-5r1,6-2l1,5-6u2,1-4r2,2-1d2,1-4r1,5-2l2,2-1d3,1-5r2,5-4u1,6-2l3,2-1d3,1-5r1

;44
  #####
  #   #
###$  ###
#@$ .$$ #
# #. .# #
# *$.   #
###.# ###
  #   #
  #####
Solution: r2,3-4d1,1-5r2,5-4u1l1,3-7u2r1,5-6u1,4-3l1d2,3-1d2,1-3r2d1,4-5l1,4-2d1,7-3l2d1l1u1,6-5l1,4-1d1,5-1d2

;45
#####  #####
#   ####   ####
# #  $ # #$ $ #
# ..*. #@*... #
#   #  # $ #  #
### $ ## #    #
  ##  #  ######
   # $# ##
   ##   #
    #####
Solution: r3,10-1d1r1d1l1,13-2l1d1,10-2r1,8-3r3,13-2l2,10-1d1,11-3l1,8-4r1,10-5u1,13-3l1,12-5u1,5-8u4r1u2l2,5-4u1l2,3-5r1,5-4d1,1-3r3,3-1d1r1d1l1,6-2l2,3-1d1,6-3l1,5-7u3

;46
   #####
 ###.  #
 #  .# #
##$#. $##
# $ .$  #
# $#. # #
#@$ .   #
#########
Solution: r3,5-3d1,6-4u1,1-4r3,2-2d1,1-4r1,6-4l1,4-3d1,6-6l1u2,6-1d2l1,7-4l1,5-5u1,4-4u2,2-4r3,7-4l1,6-3l1,5-5u1,4-4u1,6-3l1,2-6u1,1-4r2

;47
  #######
  #.  . #
###$# # #
# * $$  #
# # #.# #
#@*     #
#########
Solution: r4u2,7-5l4,3-1d2,3-3r2u1,4-1r1,7-3l2,3-3r1,5-2d1,3-5u3

;48
########
#     @#
# ####$#
# #    #
# #$#$ ####
# #  ...$ #
# #$ .$.# #
# $  *..# #
###### ## #
     #    #
     ######
Solution: d2,5-3d2,4-7r2,9-5l3d2,4-5r1,6-6l1,6-9u2,5-6r1,5-5r1,6-3d2,8-5l2,5-4d1,6-7u2,1-7r4,6-8u2,5-5r1,3-5d1,3-3d2,2-7r3,3-5d1,2-7r2u1,3-5r1,6-3d1

;49
##########
#        #
# ######$#
# #  . # #
#@$  . $ #
### #.#$ ###
  # #....$ #
  # #  $ # #
  # # #### #
  # #      #
  #$## #####
  #    #
  ######
Solution: r2u1r2d6r5u3l2d1l2u1l1d1u4l2d1l2u3r7d3,8-6l1,8-4l1d2r1d1l1u1r3d3l5r5l5u3r3l1u2r1d1l1d1l2u2r1u1l1d3r2u1r1u1l2u1l1d1r3u3l7d3r6d1r1u1l1d3r1u1l3d3r5u3l3u2r1d1l1d2r1u1d1l2r1u1r3d3l5u2d1u1r2u3r1d1l1d1r1,8-2d3,3-11u6,2-4r2l1u1r1,8-7u1,10-6l2,8-4d1

;50
######
#    #   ####
#  #.#####  #
#   .*.* $  #
#  #.  $@#  #
#  #.### #$##
# $    $ #  #
## ######## #
 #          #
 ############
Solution: l2u1l3r1u2l3d3r1u1r4d1r2u1l4d1r1l1u3d3r2l2u3l3d2r3d1r2u1l1d1l1u1r1l4d3r1,10-6u2r1u2l1d1l4,10-6u2r1u1l3d1l2u1l2,4-6l1,2-7u1,4-1d3u3d3r2,8-3l3d1l1u1,8-4l3,2-3r4,2-6u2l1u1r4,8-6l5,2-7u3l1u1r3l3u2r1d1l1d1r2

