;1
##########
#        #
# ###### #
# #  .   #
# #$ *#  #
# #  .   #
# ***.  ##
#   # ###
##  # #
 #$##$#
 #   @#
 ######
Solution: u4,3-5d1r2,1-6r2,4-5r1,2-10u3,3-6r1,1-6r2,5-5u1,5-7u2,3-6r1,3-8u1,2-6r1,5-5d1l2,7-6l2,3-3d2,7-5l1,5-8u1

;2
  #####
###  @###
# $$$$$ ##
# ..*..$ #
# ***.*$ #
# ..**.$ #
# *.***$ #
#        #
##########
Solution: d2l2d2,8-3l3,3-1d3,1-3r1d1,3-2d1,5-3l2,1-2r1d1,3-1d1,4-3l1,4-1d1,5-3l1,7-2l2,4-1d1,8-5l1u1,8-3l2,7-7u3,8-3l1

;3
   #####
####   #
#  $ # #
#  ..* ##
# $.*.$ #
## ..*  #
 #$#$$  #
 #  @####
 #####
Solution: u1r1u1,6-5u2l2,5-5u1l1,6-1d3,4-6u2,2-5u1r1,7-5l1,4-2l1d2r2,6-3d1,1-3r1,2-7u3,7-6l2u1,4-7u1,7-5l1,3-2d1,4-2d1,1-2r2,4-1d1,1-3r1

;4
 ######
## ...#####
#  . .  $@#
# #.**### #
# # $   # #
# ##  # # #
# $ $ $ $ #
####   ####
   #####
Solution: l4d2,7-6l1,4-7u1r1u2,7-6l1,5-7u1,5-4u2l1,2-2r1,3-4r2,5-3l1u1,9-6l3,4-6u2,3-4u2,6-6l1u3l1,4-7u1,1-6r3u2,3-4u1,5-3l1,7-4l2,4-5u1,5-7u3

;5
############
#      #   #
# ####$    #
# #.* $$#$##
# #+*      #
# #.*##$#  #
#  ..#  #  #
###    #####
  #  ###
  ####
Solution: r4u1,5-3r1,3-3r1,6-1d1r2,10-2l1d2l5d1,7-6u1,3-3d1,4-5d1,7-2r1,10-2l1,8-4l3,5-7l1,6-2d1l1,5-4l1,9-2l2,6-1d1,7-4l2,5-3l1d2,7-2d1,8-4l3,4-3d1,7-3l2,9-6u1,10-4l5,3-8u1

;6
########
#..##  #
#+*  $ ##
# $ #   #
### $   #
  ###   #
    #####
Solution: r2,3-4r2,5-1d1,6-5u1,3-2r2d1,4-4r1,1-3r1,3-4u1,4-2l2,1-3u1,7-3l1,6-1d1,5-4u1,7-4l1,7-3l1,6-2l3,2-3u1,4-4r1u1,6-2l4,6-5u1,7-3l1,5-4u1,6-2l3

;7
   #####
   #   #
   # # #
####  $#
#@$ ...####
# $ *$.$  #
####.*. $ #
   ###    #
     ######
Solution: r3,6-2d3r1,6-7u4,4-4r1,6-3d2,6-7u1l1u2,3-5r1,6-4d1,6-7u1,5-6u1,7-5l1,6-4l1d1,1-5r1,2-5r1,3-4r1,6-1d2l1,4-2d1,6-3d2,6-7u2,9-5l2,9-6l2

;8
   #######
  ##  #  ##
 ##...*...##
## $$$#$$$ #
#  @  #    #
# #  ### # #
#    # #   #
###### #####
Solution: u1,5-4u1l1,5-1d1r3d2,7-4u1,8-2l1,8-6u2,8-2d1,7-4r1,10-3l2,7-2l2,4-1d3,5-4u1,4-2r1,2-3r1,4-2d1,5-4l1,3-3d1,4-6u1,5-2r2,8-1d2,8-5u1,7-4u1r1,8-2l3,4-1d1,5-4l1,3-3r1,10-3l2,7-4u1,8-2l1,10-4l1,8-5u2,7-2l2,4-1d3,5-4u1,4-2r2,4-6u2,3-3r1,5-4u1,4-2r1,2-4r1,4-5u1,3-3r1,5-4u1,3-6u2,2-3r1,4-4u1

;9
  #####
###   #
#   .$##
# #$.  #
#  $*# #
### .  #
  ### ##
    # #
   ## #
   #  #
#### ##
#    #
# $. ##
## *$ #
 # .# #
 # .$@#
 #  ###
 ####
Solution: l2,3-14u1,5-13l1,2-11d1r1d1,3-15u1,2-14u1r1,2-16u2,1-12r1,3-11d3,2-14u1,3-16u1,5-13l2,4-11d1,3-13d1,3-16u1,5-13l1,1-12r1,2-14u1,4-13l1d1,2-15r1,3-11d2,1-12r1,3-13d1,3-16u1,2-14u1,3-11d1,1-12r1,5-15l1,4-5u1l1u1r1,3-1d1,1-4r2u1,6-3l2,2-2r1,5-1d1,6-3l1,3-2d1,5-3l1d1,4-1d1,2-4r1u1,2-2r1

;10
#######
#  .  #
#  . $##
##$. $@#
 # *## #
## * $ #
#  *  ##
#  .  #
#######
Solution: 6-3l2,2-2d3,2-5d1r2,4-5l1,2-6u4,1-1r1,1-7r1,6-5l2,4-7l1,2-5r2,4-3l1d2,6-5l2,5-1d1,2-1r1,2-4u1,2-6r1u1,6-3l1,5-7u1l1,6-5l2,1-7r1,5-3l1,1-2r1,2-6r2,2-3r2,5-1l2,2-2r1,6-3l1,4-5l1u1,5-7u1,2-7r1,2-4d1,1-6r1,5-7l1,6-5l2,4-7l1,2-6r1,3-2d1,1-1r2,2-5r1u2,5-5l1,3-6u1,1-7r1,3-3d2,3-1d2,4-7u1,5-5l1,5-3l1,5-2l1,5-1l1

;11
#####
#   #######
#    .$ $ #
##$$#*#   #
 #@$ .  ###
 ####... #
    # #  #
    #    #
    ######
Solution: r3,7-2l2d2r1,7-3d2,5-2l2,1-2r4,2-4u1,3-2d1,1-2r1,3-1d1,2-4r3d1,7-2l4d1,2-4r2,5-5u1,5-7u1,7-7u1,8-5l1,5-4r1,7-3d1,1-2r1,3-1d2,2-4r2,9-2l3

;12
#########
#       #
# ##### ##
# #@$... #
# #$$# . #
# # $  . #
# $  #####
###  #
  ####
Solution: d2r3,3-3r1d1,3-5r1,3-7u2,4-3r2,8-3l1,1-6r2,5-3r1,4-7u2,7-2d1,3-3d2,6-5l2u1,3-3r1,8-4l1,2-6r1u1,4-3r2,7-2d1,4-7u2,3-3d2,2-6r1,6-5u1,5-3r1,4-5u1,3-3r2,4-7u3,3-3r1

;13
######
#  . ####
# # .   #
# $ $.# #
## #$   #
 # # *###
 #  *@#
 ######
Solution: u2,5-2d1,3-3r1d1r1,5-6l1u3,4-1d1,5-2d2,4-4u1,5-2l1,5-6u2,7-4l2u1,1-3r3d1,4-6u3,2-6r1,4-1d1r1d2,3-3u1,3-3r1,7-2l2

;14
  ######
  #    #
### # $###
#  ....  #
# $*$ .$ #
###. $.$ #
  ##.*.$ #
   #$#$###
   #  @#
   #####
Solution: u3,4-8u2r1u3,8-5l2,7-3d1,5-4r1,3-3d1r1,6-5d1,4-6u2,6-1d2,8-6l2,6-5u1l1,5-3r1,3-4r1,1-4r1,5-3l1,6-8u2,8-3l2,6-4d1l1,6-3l1d1,4-4d1r1,5-1d1,8-4l1,7-6u2,8-3l1

;15
########
#      #
# ###  ####
# #  ...$@#
# # #.**# #
# #$ *..# #
# #  $### #
# $$    $ #
###   #####
  #####
Solution: l2d1l1d1l1d1l2u1r2l1d3l1u1r1u2r1l1d3r1u1l1u2r1u1r2u1r2d4l4d1l1r1u1d1l1u1r5u4l2d1l2d1l2d1u1r2u1d1u1r2u1r2d4l5d1l1u1r6u4l2d1l2u1r1u2l5d6r2l2u6r5d2r1l2r1u2l5d6r2d1r2u1r4u4l2r2d4l4d1l2u1l2u6r5d2l1d1r1l1d1l2r2u2r4d4l4d1l2u1r2l4u6r5d3l1d1u1d1l2d1,2-7r1u2r2u2l2d2,5-7u3d1l2u2r2,6-2d1l1d5l2u1r1d1r1u3l2u2r6d4l3r3u4l3u2l5d6r3d1r1u1,5-5u1d1l2u2r3l3d3,2-7r1u4r3u2l1d1,4-3r1l2d5r2u4d4l2u1r1d1r1u3d2l2u1r1d1r1u1

;16
  ##########
###   ##   ##
#  $ $#.  $ #
#..*..**$$  #
#     #+$   #
#############
Solution: r2u1d1l2u1l2r3u2r2d1l1r2d2l3r1u1l4d1l3u2r1u1r2d1u1l2d1r1l2d2r2u1l2r6d1r3u2l1u1l2d1u1r2d1l1r2d2l2u1l6u2r2d1l1u1l1d1r1d1r4d1r3u2l1u1l2d1u1r2d1l1r2d2l2u1l4r3d1r3u1l5r4u2l1d1r1d1l3r2u2l1d1r1d1l1

;17
    ####
    #  #
#####  #####
#   #    $ #
# # ## ### #
# #..$. .# #
# #   $$ # #
# # *.* .# #
# ### ## # #
# $@$  #   #
####   #####
   #####
Solution: r1,5-10u3r1u4,6-1d4,10-3l3,6-5l1d2,6-7r1,3-5r4d1,1-9r3,6-9l1u2,6-7u1l1,3-7r1,4-7u1,6-7l1,3-9r1,5-10u2,5-5l1,8-6d1l1,7-5l2,6-4u1,6-1d3,8-9u1

;18
  #########
  #   #   ###
###........ #
#   $ # $$  #
# $ $ #$ # ##
###$#$#    #
  #  @######
  #####
Solution: u3,3-6u3r1,5-4l1,3-3d1,4-2r3,9-2l4,8-4u1,7-2r2,3-1d1r5,7-5u2,8-2l1,10-3l1,8-4u1,7-2l2,3-2r3,5-4u1,4-2r1,3-4u1,1-4r2,3-6u1,3-5u1r1,5-5u2,2-3r1,4-4u1

;19
    #####
  ###   ###
  #  $#   #
### . $ # #
#   *# ## #
# #$* $ # #
#   ..*+  #
###########
Solution: l1u1,6-6l3u1r1u2,3-3d1,1-6r2u1,4-5r1,7-3l2,5-1d1,4-4l1,3-2r1d1,7-5l1,6-3l2d1,3-6r3,6-3d1,4-4d1,6-4d1,3-6r1,6-5l1,4-4d1,1-4r2,3-2d1,4-3d1l1,1-4r2,5-1d1,6-3l1

;20
 #####
 #   ###
 # #   #
##$...$##
#  .**  #
# #**.  #
#  .*.$ #
##$$$$###
 #   @#
 ######
Solution: u2l2u2,2-4u1r2,6-2d2,7-6l2,3-8u4,2-3r1,5-6l1,3-7u3,1-6r2,2-1d2,1-4r1,2-8u1,1-6r1,3-7u1,5-7l1,3-8u1,6-4d1,7-6l1

;21
  #####
  # . #
  # + ###
###$*$$ #
#   . # #
# $ .   #
## #*####
 #   #
 #####
Solution: d2,5-4u1,7-3l2,3-5r1,1-5r1,4-7u2l1,4-5r1,7-5l3,2-6u1r1,3-4r1,3-4u1r1,3-1d2,4-4d1,6-3l1,4-4u1,5-1d1,4-3u1,4-7u4,3-3d1,2-5r1,4-4d1,6-3l1d1,6-5l1,1-4r2

;22
#############
#           #
# ######### #
# # $...*.# #
# # $*$   $ #
# # #.#$  ###
#    .$@###
# # $.###
#   ###
#####
Solution: l4,3-3r2d1r2,7-3r1d1,5-3r1,5-6u2,11-4l5,6-3l1d1,8-3l1,7-6u2,9-5l1,3-4r4,7-6u1,8-5u1l2,3-3r1,3-7r1,1-6r3

;23
         ####
      ####  #
    ### $ $ #
#####.*  #  #
# $@$...    #
#  #$ *.#####
#     ###
#  ####
####
Solution: r1,4-4r1,5-3r2,1-4r3d1,5-6l2,2-7u1,5-5r1u1l2,10-1d2,11-4l4,7-2r2,10-1d1,8-2d1,7-4l1,4-4r1,5-3r2,7-4l1,5-3d1,6-5l1,9-4l2,6-5u1,2-4r3,5-3r1d1,10-2d1,11-4l5,5-3d1,5-6u2,8-2d1l1,9-4l4,3-4r3,4-6u1,3-4r2,2-6u1,1-4r3

;24
  ###########
  #         #
### ####### #
# $   . $@# #
#  $ $.#$$# #
###   *.... #
  ######    #
       ######
Solution: l4,6-4l1,3-5u1r2,5-5r3,10-5l5,8-3d1,3-4u1r2,1-3r2,7-5r2,3-1d2,2-4r1,3-5r2,5-3l1d1,4-3l1,7-3l2,1-3r1,3-2d1,4-4l1,9-3d1,5-5r2,3-5r3,1-4r2,3-3r2,4-3d1,3-5r2

;25
########
#      #
# # $# #
#   *+$#
# **** #
# .*.. ##
###$# $ #
  #     #
  #######
Solution: l2,2-5r1u2,3-5r2u1l1,4-1d3,5-5l2,1-3r2,4-2d2,6-4u1l1,4-4u1,4-1d2,3-7u1,7-6l1,5-7u3,6-4d1,7-6l1,5-7u2,6-3l2,6-1d4,7-6l1,5-7u1,2-3r2,3-1d1,2-3r1

;26
####
#  #####
#      ###
# .### $ ###
## # . $.. #
 # #  $ .# #
 #$###$. # #
 #   # .## #
 ###  $  $ #
   ###.$####
     # @#
     ####
Solution: u3,6-7d1,7-7u1,8-4l1,7-6u1l1u1,4-5r2d1,6-8u2,6-10u2,10-8l2,7-7d1,7-10u2,6-6d2,8-4l1d1,7-4l1d1,4-4r2,6-7u1,7-5l1,6-4r1,4-5r2,6-10u5r1,7-4l1,2-7u4,2-1d1,6-2d3,7-4r1,8-3l1,4-4r3,6-5d3,2-4u1,2-1d1,6-2d1,7-4l1

;27
   ########
####      ###
#   $###  $.#
# ...  # $$.#
# $ *# #..**#
###*   ## $@#
  # $###  ###
  ##     ##
   #######
Solution: u1l2,4-7u1,3-6u1r1,3-5u2,4-3d1,9-4u1,4-1d1l1,1-4r1,3-5u1,4-4u1l1,4-6u1,6-5l2,4-1d1,5-3l1,11-5l1,9-1d1r1d1,8-3r1,9-4r1,10-2d1,4-5u1,9-6u2,1-2r2d1r1,6-3l2,9-4u1,4-1d1,2-4r1,9-1d2

;28
#########
#   #   #
# #   # #
# #$  * #
# #....##
# #$# .#
# #  $ #
#   $#$#
####  @#
   #####
Solution: u2l1,3-4d2,7-3l1,5-6l1,6-6u2,4-8u1l1u1r2,6-7u1,5-2d2,7-3l2,1-7r2,4-8u1,6-6u2,3-6r2,6-7u2,3-4d2,2-7r1,4-8u1,3-6r2,6-7u1,5-6u1,3-2d1,4-2d1

;29
  ########
  #      #
### .# # #
# $ * $$ #
# #.*..###
#@$ . $#
#### # #
   #   #
   #####
Solution: 1-3r1,1-5r2,3-4u1r1,3-1d2,3-5r1u2,6-4u1l2,6-6u1l1,4-4d1,4-3l1,4-1d2,1-3r2d1r1u1,4-7u2l1,1-5r2,8-3l4,3-2d1,6-1d1,7-3l2

;30
   #######
   #     #
####$###.####
#    *  . $@#
#  $ .$.$ * #
###  $#.##.##
  ###   #  #
    ## ## ##
     #    #
     ######
Solution: l3,4-1d3,5-4r1,6-3l1,4-4l1,1-4r4,5-3l1,8-3l3,4-4u1,2-3r1,7-3d1l4,3-3r1,4-1d2r2,9-4l1,11-4l1,5-6u2,6-3r2,8-4l1,4-3r3,8-4u1,10-3l1,3-5r1,8-4r1,11-4l1,5-6u1,8-4r1,10-3d1,5-5u1r4,3-4r3,1-4r3

;31
  #####
  #   #####
  # .   $@#
  ##.#### #
### .  #  #
#  $  $# ##
# .$.#.$ #
#  *   ###
###   $ #
  ### # #
    #   #
    #####
Solution: l4,4-1d6,7-8l1,5-7d1,4-6l1,3-4d1,2-7r1u1,2-5r2,3-8r1u2,6-8l1,5-10u2,6-7l3,6-4d3,7-8l1,5-9u1,6-7l1,8-6l1,4-6u3,6-5l1,4-6u2,3-8r1u3,5-9u1,6-7l1,4-8u1,1-7r1

;32
#####
#   #
#   ###
# .$  #
##.$# #
 #.*. #
##**  #
#@$   #
# #$###
#   #
#####
Solution: r1u4r1,2-5r1u2,2-7r1u2,2-1d4,2-7u1,5-3l2d2,2-4u1,2-1d2,3-1d2,4-6l1,3-5u1,4-3l1,3-9u3,5-7l1,3-6d1,3-9u2

;33
##########
#        #
# ####$  #
# #.*.. ####
# #.$ *$   #
#  * $.  # #
##$**###   #
 #@  #######
 #####
Solution: u1,4-7u1l1u2r1d1r2u1r1,1-5r1,2-5r1,4-4r1,5-3r1,6-5u1,7-4u1,5-3r1,6-1d2,2-7u1,1-5r1,3-4d1,8-2l1,6-5u1,7-4u1l1,6-1d2,8-2l1,6-1d1,7-4l3,5-5l1,7-4r1,8-5l1,10-4l3

;34
 #####
 #@. #
 #$*$#
 # * #
## . #
# $.$##
#  *  #
#  .  #
##  ###
 ####
Solution: d2,4-1d1l1d2,4-4d2l1u1,1-5r1d1,4-4u1,2-3d2,1-6r1,4-5l1,4-1d1,4-2d1,2-4d1,3-5u2,2-1d1,4-5u1,1-7r1u1,1-5r1,4-6l1,3-8u1,5-7l1,3-3u1,4-2d2,2-7u1r1u2,1-5r1,2-2d2,3-4u1,2-4d1,2-7u1,3-6u2,2-4d1,3-8u2,5-6l1,2-5d1,4-4d2l1u1,1-7r1,3-8u1,5-7l1,2-7u1,1-5r1

;35
 ###########
##         #
#  ####### ##
# ##....$ $ #
# #  ##*  $@#
# #$  $.#####
# # #  .#
# $  $ .#
#####  ##
    ####
Solution: l2,9-3l4,11-3l5,7-3d3,5-5r1,5-8u1,7-6u2r1,1-7r4,6-8u1,8-3l1,3-4d2,10-4l2,2-7r1,7-5u1,3-7r2u1,7-6l1,4-5r2,7-6u1,5-7u1,4-5r1,6-8u1,5-5r1,5-6r1

;36
#############
#           #
# ######### #
# #       # #
# # ##### # #
# # #   # # #
# # # # # # #
# # #  .# # #
# # ## .# # #
# #   $.  # #
# ####$.### #
# $    .    #
######$.#####
     #  #
     #$$#
     # @#
     ####
Solution: u8,5-9r2,6-11u2,6-13u2,7-5d6u2l1u1,5-7r1d1r1u1,6-11u2,6-15u4r1u1d3,7-5d6,6-9u1,5-7r1d1r1u1,6-11u2,7-5d4,6-9u1,5-7r1,7-11u2,9-9l1,7-13u2,1-11r5,7-15u2

;37
  ######
  # .  ###
  #   ** #
###$ .   #
# .$.  ###
#   *  #
####$#$#
   #  @#
   #####
Solution: u2,4-4l1u1,1-4r2,5-5l2,3-4r1,4-7u2,6-3d2,6-1d2,8-2l3,6-5u2l1u1r1,6-7u4,5-3d1,1-5r2,3-4r1,3-1d2r1d1l1r1u2,4-6u1,6-5l1u1

;38
  ####
  #  #########
 ##$   ###   #
##   #$  $$# #
#  #...*...$@#
#     ## $ ###
#  #  ###  #
#  #### ####
####
Solution: l2r2u2l2d1l2d1l3,4-3d1r1d1l2,2-4d1,8-5r1u1r1,12-4l7,4-3d1r1,3-5r1,8-3r1,10-2d1,9-4r1,6-2d1r1d1l1,7-3r1,12-4l4,8-3r1,10-2d1,11-4l1,10-6u1,6-4r1,4-4r2,5-6u1l1u1r1,3-1d1,2-7u1l1u1r3d1r1u1,2-3r1u1r1d1

;39
 ####
 #  ######
 #   $@$ #
 #  $#$# #
 ###   # #
#### ### #
#    ..# #
#    *.  #
###$#..  #
  #   ####
  #####
Solution: l2d4,3-9u2,5-6d1,4-6l1,3-7r2,6-6d1,5-9u2,4-6r1,3-1d1,2-3r1,4-2d4,3-7r1,5-6d1,1-6r3,8-2l4,6-4u1,7-2l1,3-1d1,2-3r1,4-2d4,3-7r2,6-2l2,3-1d1,2-3r1,4-2d4,3-7r1

;40
 ###########
##         #
#  #######$#
# ##     # #
# # $$   # ##
# # # ...*. #
# #@$ .$$   #
# ####. #####
#       #
#########
Solution: r2,8-5r1,11-5l3,6-5r1d1r1u1,5-6r1,5-3d1,3-4r1,8-6l2,7-8u3,10-6l2,10-1d1,10-2d1,10-3d1,7-7u1,6-5r2,4-4r1,4-6r1,5-4d1,6-5d1,4-6r1,6-3d1,7-3d1,8-3d1

;41
     ####
   ###  #
####.   #
# ...# $##
# ...$   #
## #$$ # #
 #   $$$ #
 #####@ ##
     ####
Solution: u3l2,7-4u1,6-2d1,7-4l1,6-6l2u3,6-4l1,4-5u1l1,1-4r1,2-6r2,4-4l1,2-5u1,1-3r1,8-6l1,6-7u2,7-4l4,2-5u1,4-6r1u1,6-4l3,6-7u2,7-4l3,7-1d2,8-4l3

;42
   ####
   #@ ##
 ###*$ ##
 # * *  #
## $.$. #
#  . .$ #
# . *$* #
#      ##
########
Solution: d2r1,5-1d1,6-2d1,7-5l3u2r1d1,4-5l1,4-7u1,6-7u1l2,7-4l2d1,4-6l1,3-5r1,4-3d1,6-6l1u1,7-3l1,6-4d1,3-5r1,4-4r1,1-5r1,2-4r1

;43
 #####
 # . #
 #$. #
 # + #
 #$*$#
## . ###
# $.$  #
#  * # #
###    #
  ######
Solution: d2,4-5u2,4-5d1,4-8u3,2-5d1r1,4-5d1,2-3d1,4-3d1,2-1d1,4-1d1,3-8u2,1-7r1,3-6u2,2-4d1,3-4u2,2-2d2,3-8u4,4-4d1,4-2d2,3-4u1,1-6r1,3-7u3,2-4d2,5-6l1,3-7u1,4-4d1,3-6u1,5-6l1,3-7u1,1-7r1,4-8u1,5-6l1

;44
 ########
 #   #  #
 #    $@#
###$##$ #
#  $.# ###
#   .    #
### .  # #
  # .#   #
  ########
Solution: l1d3,4-4l1,6-2l2,2-2r3,3-2d2,6-7u1,7-5l2,6-1d3,4-4d2,7-5l2,3-6u2,4-4d1,1-4r2,3-2d2,2-5r1

;45
   #########
####  ##   #
#   *      #
# $$. ### ##
##@ ## $ $#
 #     #  #
 #  ....$ #
 ###   #  #
   ########
Solution: 7-6r1,2-4u1r1u1r2d1l1u1l1d2,5-2r3,10-2l5,3-4d1l1d1r2,9-5u2,6-4r2d1r1u1,4-1d1r1d1l1u1l1d3,10-2l5u1l1d1r1d1l1u1l1d1,9-4u1,10-2l5,4-6r2,2-6r3,3-3d2l1d1r2,4-1d1r1d1l1u1l1d3l1d1r1,9-7u4,10-2l5u1l1d1,1-2r2

;46
  #####
  #   #
###   ###
# $. *$ #
# .   . #
### * ###
  #*$*#
  #@  #
  #####
Solution: u3,5-4u1,7-3l2,5-7u2l1,4-4r1,3-4d1,7-4l2,3-4u1r2,5-1d2,4-5u2,4-7u2,4-3d1,5-3d2,1-3r2,3-1d2,4-4l1,7-3l1,5-2d1,4-4r1,5-3l1,3-2r1,5-1d1

;47
 ##########
 #   #    #
 #    *@# #
 ##$##. # #
  # $ *## #
###..*.   #
#    $#####
# ##  #
#  ##$#
##    #
 ######
Solution: l3,2-2r1d2,3-4r1,3-6u2,4-5r2u2,8-5l4,5-7u1,5-9u2,3-4d1,4-5r2,8-5l1,6-1d1,5-2l1,2-2r3,3-2d2,4-4r1,5-7u1,2-6r1,4-7u1

;48
##########
#        #
# ###### ##
# # $   $ #
# # ##..* #
# #   * . #
# ##  **. #
#  ##  $ ##
##  ####$#
 ##     @#
  ########
Solution: u3,9-4l1,8-4u1,8-6u1,8-7l1u1l1u1r1,4-6r1,5-7r1u1,7-5l1,3-3r3d2,7-6l1,6-3r1d1,9-4l2,7-4d1,8-7l1,6-6r1,6-3d1,9-3l1,8-1d2,9-5l1d1,8-3d1,7-4d1,8-6u1,8-8u1,4-6r1,5-7r1,6-7r1u2,9-6l1d1,7-7u1,5-6r1u1r1,8-6l1,8-9u1,8-8u1,8-3l1d2,9-4l1,5-3r2,4-5r1,8-2d1

;49
###############
#            @#
# ###########$#
# # .     $ # ##
# # .####*..*  #
#  $*     $$   #
### .  ###   ###
  ###### #####
Solution: d3l2u1l2d1u1r2d1l1r2d2l2u1l4d1l2u1l1u2r1d1l1d2r3u1r4d1r2u2l1u1l6r6d1r1d2l1u1l5d1l3u2r1d1l1d1r1u1r6,1-5r2d1r1u1r2d1l1u1r5d1r2u1l7r7u1r2d1l2d1l2u1r1d1r1u1

;50
##########
#        #
# ######$#
# #    # #
# # #*.*.#
#@$  .$$ ######
#####. $ .    #
    ##.*. #$# #
     # #    # #
     #$###### #
     #        #
     ##########
Solution: r3,8-1d3,8-4d2l2u1r1,8-6u1,8-8u1,6-10u3r2,11-8u1,8-5d1,12-6l4,7-5d1,6-5d1,9-8u1

