;1
  ####
### @#
#    #
# .#.###
# $    #
##*#*# #
# $    #
#   ####
#####
Solution: 1-4r1,1-6r2,2-6u2,5-6l2,2-7u1,4-4d1,5-6l2,2-4r1,4-3d1,2-4u1,1-2r2,4-1d1,1-6r1u2,4-6l1,2-7u1

;2
####
#@ #
#  #####
#  $   #
#****..#
#  $   #
# ## ###
#    #
######
Solution: d4r1u2d2r1l1u2r2l2d2u2r2l2d2r2l2r2d2l3u2r1u2r2d2l2u2l1u2r1d2r2d2l3d2r3l3u2r1u2r2d1r2u1l2r2d2u1l2d1u2d2l3d2r3l3u2r1u2r2d1r2d1l2u2l2d2l1d2r3u2r2u2l2r1d2l1d2l3u2r1u2d2l1d2r3u2r1u2l1r1d2l1d2l3u2r1u2r2d2u2l2d1r2d1r2u2l2d1r1l3d1l1d2r3u2d2u2l1u1l1u1r1l2u2r1d2r1d2r1d2l3u4r2d2r2u2l2d1r1d3l3u4r1l1d4r3u3l1r1d3l3u3r1l1d1u2r1u2l1d1r1d2l1d1r1u3l1d1r1d2l1d2r3u4l1r1d4l3u2r1u1d1u2d2r1l1u2r2d2u2l3u2r1d2r2d2l3d2r3u2

;3
 #####
 # . #
##$. #
# $.$##
# $.$ #
#  .$ #
## . @#
 ######
Solution: undefined

;4
  ####
###@ #
#    #
# $$$###
##$.$  #
 #.....#
##$.   #
# $ ####
#   #
#####
Solution: undefined

;5
  #####
  #   #
###$. #
#  $.###
# #$.  #
#    # #
## @#  #
 ##   ##
  #####
Solution: u1l2u2r1l1d2r3u2l1d2u2r1u2l1d2r1d2l3u2r2l2d2r3u2d2l1u1r1u1l1u2r1d2l1d2l2u2r1l1d2r2u2d2u2d1u1r1u2l1d1r1d1l1d2r1u1r2d2l1d1l2u2r1u2d2l3u2r2u2r2d1l1d1l3d2r2u1d3r2u1r1u2l2u1l1d2l2u2d2r3u4l1d2r1d2l3u2r2u1r1d1l3d2r3u2d2l1u1r1u1l1d1r3d2l1d1l2u2l2u2d2r3u2l1u1d1r1d2l3u2r2d1r1d1l1u4r2d1l1d1l1d1r1l1u1l2d2r1l1u2r1l1d2r1d1r1u1r1u4l1d1r1d3l3u2r2l2d2r3u2d2l1u1d1l2u2r2d4r2u1r1u2l1

;6
 #####
 #   ##
 # #  ##
 #  #@ #
###$.  #
#  .$###
# #$. ##
#   #  #
#    # #
###    #
  ######
Solution: d1l1d1l3d2r2u1d3r3u2l1u1l1u1l1d2u1r2d1r1d2l3r1u1l1u3r1u1r1u2l1u1l2d2r1d4l2u2r2d1r1u1d1r1d1u1l1u1l1u1r1d2r1d1r1d2l3u3d1l2u2r2u1r1d1l1d2l2d1u1r2d2r3u2l1u1l1r1d1r1d2l2u1l1u2r1u1l1d2l2d1r1u1r1u1r2d1r1d2l3u2l2u2r2u1r1d1l3d2r2u1d2r1d1r2u2l1u1l1u1l1u2l1u2r2d1r1d1r1d1u1l1u1l1u1l2d2r1d4l2u2r2d1r2d1r1d2l3u2l2u2r2u1r1d1l3d2r2u1d1l2u2r2u2l1u2r2d1r1d1r1d1l1r1u1l1u1l1u1l2d2r1d5r1d1r2u2l1u1l1r1d1r1d2l3u2l2u2r2u1r1d1l3d2r2u1d2l2u3r2u2d5r1d1r2u2l1u1l1r1d1r1d2l3u1l2u3r2u1r1d1l1d1u1l1r1u2l1u2r2d1r1d1r1d1l1u2l1u1l2d2r1d2l2d3r2u2

;7
 ####
##  ####
# @$$  #
# $ .*.#
##$.   #
 # * ###
 # . #
 #####
Solution: undefined

;8
   #####
 ###   #
 #  .# #
 #  *  #
###$#$##
#   * #
#   . #
### @ #
  #####
Solution: undefined

;9
  #####
 ##   ##
 # .#  ##
 # * #  #
##$@$   #
#  * #  #
#  . ####
###  #
  ####
Solution: undefined

;10
   #####
 ###   #
## $ #$##
# $ ... #
# # @ # #
# ... $ #
##$# $ ##
 #   ###
 #####
Solution: undefined

;11
   #####
 ###   #
##  .# #
#   *  #
#  #*###
##  $ #
 ## @ #
  #   #
  #####
Solution: l1u1l1u2r1u1r1u1r2d2l2u1l2d3r1d1r2u1l1u2r2u2l2d4r1d1l1u4l2d3r1l1u3r2d3l2u2r1l1d2r2u1d1l2u3r2u1r2d2l3u1l1d1r2d2r1d2l1u4r2u2l2d1u1r2d2l2d2l2r2u3l2d1r2d2l2u1l1u1r1d2r2d2l1u1r1u4l2d3r1l1u3r2d3u3l2d1r1l1d2r2l2u3r2d1u2r2d2l2u1l2d3r2u2d2r1d2l1u2l2u2r1

;12
   ####
 ###  #
 # .  #
 # $  #
###*# #
#  $  #
#@ . ##
#  ###
####
Solution: r3u1l1r2u3l3d1r1u1r2d3l2u2l1u1r1d3r2u2l1r1u2l1d1l1r2d3l2u2l1u1r1d4l2u1r1d1r2u1r1u2l1r1u2l1d1l1d1u1r2d3l2u2d2u2l1u1r1d4l2u1r1d1r2u1r1u2l1r1d2l1d1l2u1r1u2r2d2l1r1u2l2d2r1d1l1u3r2u2l1d1r1d3l2u2l1u1r1d3r2u2l1r1u2l1d1l1d3r2u2l1r1d2l2u2d2l2d2r1u1l1u1r2u2r2d2l1d1l1u1l2d1r1

;13
  ####
###  #
#    ###
# ##   #
#  +*# #
#  #   #
## ** ##
 # #  #
 # $* #
 ###  #
   ####
Solution: undefined

;14
   #####
 ###   #
 #  *  #
 # #. ##
## $* #
#  #. #
#  $* #
#  #  #
####@ #
   ####
Solution: undefined

;15
  ####
###  #
# @* ###
# #.   #
# $* # #
# #. # #
# $* # #
# #. # #
# $*   #
###  ###
  ####
Solution: undefined

;16
  ####
###  ##
# @$  #
#.#.  #
# $*  #
# #. ##
# $* #
#.#. #
# $$ #
###  #
  ####
Solution: undefined

;17
   ####
   #  #
####  ##
#  $$  #
# #$.# #
# #..  #
#@   ###
######
Solution: r3u1r2u2l1u1l1d1r2d2l2d1l3u3r2d1u1l2d3r3u1r2u2l2r2d2l2u2d3l3u3r3d2r2u2l3r2u2l1d2r2d2l2u1l1u1r1d3l3u3r2d1r1u1d2r2u2l3r2u2l1d2r2d2l2d1l3u3r3l3d3r3u3d2r2u2l3r2u2l1d2r2d2l2d1l2r2u1r2u2d2l2d1l1u1r3u2l2r2d2l3d1l2u3r2d1u1l2d3r3u1r2u2l2r2d2l2u2d3l1u1r3u2l1u2l1r1d2r1d2l3d1l2u3r3d2u2l1d1r1d1r2u2l2r1u2l1d2r2d2l2d1l3u3r3d1u1l3d3r2u2d2l2u3r2d1r1u1d1l1d2r1u1r2u2l2d1l1d1r1u2r1u2l1d3l1d2l2u3r2d1r1u1r2l3d3r1u1l1u2r3d2l2r2u2l2d1u1r1u2l1d2

;18
  #####
  #   #
### # #
#  $  ##
# .*.  #
###$##@#
  #    #
  ######
Solution: undefined

;19
   ####
 ###  #
##    ##
# $# . #
#@ $.# #
###.$  #
 #. #$##
 #    #
 #   ##
 #####
Solution: undefined

;20
 #####
 #   #
## #$##
#   $ ###
# ..*.. #
### $   #
  ##$# ##
   #@  #
   #####
Solution: undefined

;21
 #####
 # @ #
 # # ##
## *  #
#  .$ #
# $.$##
##$. #
 # * #
 # * #
 # . #
 #####
Solution: undefined

;22
 ####
 #@ #####
 #  $   #
 # *$*  #
##..*..##
#  *$* #
#   $  #
#####  #
    ####
Solution: undefined

;23
  #####
  #   #
  # # #
  #   #
### ####
#   $  #
# #$*.@#
#   .###
###  #
  ####
Solution: undefined

;24
  ####
  #  #
###  #
#  * ##
#@.#$ #
## *  #
#  #  #
#    ##
#  ###
####
Solution: undefined

;25
  #####
 ## @ #
 #  # ##
##.$.  #
# $#$  #
# .$.###
# #   #
#     #
#   ###
#####
Solution: undefined

;26
   ######
  ##    #
  #  #@ #
###$.$  #
#  .#. ##
#  $.$##
## ## #
 #    #
 ######
Solution: undefined

;27
  #####
 ##   #
##.$. #
# $@$##
# .$.#
##   #
 ##  #
  ####
Solution: undefined

;28
 ####
 #  ##
 #   ##
##$.$ #
# .@. #
# $.$##
##   #
 #####
Solution: undefined

;29
#####
#   ##
#    #
## # ##
#  $* #
#  *. #
###  ##
  #@ #
  ####
Solution: undefined

;30
 ######
 #    ##
## ##  #
#@$$ # #
# $ .  #
###.. ##
 #  # #
 #    #
 #  ###
 ####
Solution: undefined

;31
 ######
 #    #
 # #  #
 # *  #
###*# ##
# $.$  #
#  . # #
###@   #
  ######
Solution: undefined

;32
#####
#   ##
#  * ###
## * @ #
 # *   #
 #$.$###
 # . #
 #####
Solution: undefined

;33
  ####
 ##  #
 # * #
 # * #
 #@* #
## * #
# $.$##
#  .  #
#  #  #
####  #
   ####
Solution: undefined

;34
#######
#     #
# #*# #
#     #
###@####
# * .  #
#   $  #
#  #####
#  #
####
Solution: undefined

;35
  #####
 ##   #
 # @#*##
 #   * #
###*#  #
#  .  ##
#   $##
#  # #
##   #
 #####
Solution: undefined

;36
 ####
 #  ####
## *   #
#  *#  #
#@# $.##
# *   #
# #*  #
#   ###
#####
Solution: undefined

;37
    ####
  ###  #
 ##   *#
 # @#* #
##  *  ##
#  *#$  #
# *  .# #
#####   #
    #####
Solution: undefined

;38
  #####
###  @#
#  $# #
# .$. #
##.$. #
## $###
#   #
#   #
#####
Solution: undefined

;39
  #####
  #   #
###$# #
# .$. #
#  * ###
# .$.  ##
###$#   #
 # @    #
 #   ####
 #####
Solution: undefined

;40
   #####
   #   #
 ###$# #
 # .$. #
 # #* ###
##  *   #
#  .$.  #
#  #$#  #
##  @####
 #####
Solution: undefined

;41
  #####
 ##   #
 #  # #
##.$. #
# $*$ #
# .$.##
###  #
  #@ #
  #  #
  ####
Solution: undefined

;42
     ####
 #####  #
##  # @ #
#  $.$  #
#  .*. ##
###$.$##
  #   #
  #  ##
  ####
Solution: undefined

;43
######
#   @##
#   * #
### * ###
 ###$   #
 #  . # #
 #   #  #
 ###   ##
   #####
Solution: undefined

;44
  ####
###  #
# *  #
#@*  #
##*# ##
# $   #
# .## #
#     #
#  ####
####
Solution: undefined

;45
     ####
######  #
#     @ #
# # *   #
#  #*####
##  * #
 ## * ##
  # $  #
  # .  #
  ###  #
    ####
Solution: undefined

;46
   ####
  ##  #
  # * #
  #@* #
  # * #
 ###* ###
##  *   #
#  #$   #
#   . ###
#  #  #
#######
Solution: undefined

;47
   ####
   #  ###
   #    #
   # .# #
####$.$ #
# @ $.$##
# # #. #
#   #  #
########
Solution: undefined

;48
   ####
   #  ###
 ### .  #
 #  $.$ #
##@##*###
#   $.$ #
#    .  #
##   ####
 #####
Solution: undefined

;49
  ####
  #  ##
 ## . #
## $.$###
#  #*   #
# #@* # #
# #$.$  #
#   .####
##   #
 ##  #
  ####
Solution: undefined

;50
#####  ####
#   ####  #
# $    $$ #
##$# ###  #
 # #...  ##
## #.#.# #
#@  ...# #
#  ### #$##
# $$    $ #
#  ####   #
####  #####
Solution: undefined

