;1
###############################
#........             ........#
#.############# ### # #######.#
#.#   #   #   #   # #       #.#
#.# # # # # # # # # # ## ## #.#
#.#   #   #   #   #    # ## #.#
#.$$$$#$###$#$$$$$#$$$ #  $ #.#
#.$     $ $    $   $  $# $ $#.#
#@$$$$   $  ## $ # $$$  $   $ #
#.$     $ $    $   $  $ $$$$$.#
#.$$$$#$###$###$###$  $ $   $.#
#.#   #   #   #  ##  #  # # #.#
#.# # # # # # #      #  # # #.#
#.#   #   #   #  #####  #   #.#
#.######### ####      #######.#
#........             ........#
###############################
Solution: 22-6d1l4,27-6l1d2r1d2u1d1r1,29-9d5,27-8r1,29-9u7,27-9r1d1r1u7,27-6d1l1d1r2d1r1u5,24-7r2u1r1d1l1d1r2d1r1u4,21-7d2r1d1r6u1r1d4,25-10u1r3u1r1d4,27-12u2l1u1r2u1r1d3,24-6r2,27-5d2l1d1r2d1r1u3,23-10u1r5u1r1d2u1l2u2l3d1r4d1r1u2d2l1d1l5u1r5u1r1d1l8u2r1d1r6d1r1u1l8d1r7,21-7u5,20-1r7,20-7u1,19-5r1d1r1u4,20-1r6,22-12u3r1u1l1d1l1u7d3l2u4r6,18-9r2u2l1r2u2l2d1r1d1r1u5d3l2u4r5,18-8r1d1r1u3l1u1r1d1r1u4d3l2u4r4,18-7r2d1r1u6d3l2u4r3,19-11u3l1u1r2d1r1u6d3l2u4r2,16-9l1d2u2l1,10-8l3d1l1,11-9d5,10-15r17,9-9r1u1r1d6,10-15r16,7-9r2,1-9r6,9-9r1u1r1d6,10-15r15,7-9r3u1r1d6,10-15r14,14-9l2,11-8d6,10-15r13,16-7l1u5,16-1l14,15-9u7,16-1l13,15-13u11,16-1l12,18-7l2d1l1u6,16-1l11,17-5d1l1d1l1u5,16-1l10,18-7l2d1l1u6,16-1l9,13-7r1d1r1u6,16-1l8,12-7l1u2r2d1r1d1r1u5,16-1l7,22-9l10,11-8d6,10-15r12,22-10l2d1l1u1r1u1l9u1l2d1r1u1r1d6,10-15r11,11-3d11,12-15l9,14-7l2,11-6d8,12-15l8,9-7r1,11-6d2l4u1r3d1r1d6,12-15l7,11-6d8,12-15l6,3-7l1,1-8u5,3-9d1l1u1l1d5,3-10d1r2u1l3u1l1d4,3-9r7u1r1d6,12-15l5,5-7d1,3-7d1l1d1l1u5,4-9r6u1r1d6,12-15l4,2-9r8u1r1d6,12-15l3,3-13u2r1u1l2u1l1d3,5-8l3u1l1d4,7-8l5u1l1d3,7-9d2r2d2l2u4r1u1l6u1l1d2,7-7u2r2u2l2d5r1d1l6,3-7u1l1d1l1u2d1r2u1r2d1l3d1l1u1r4u3l2d2r1d1l2r1d2r3u1l4

;2
###############################
#............. .##      ......#
#...............       .......#
#.....#######$##$$#######.....#
#....######  $ $  $ #####.....#
#...#######  $ $  $ #####.....#
#..##     #  $ $  $ ########..#
#..#      #  $  $$  #####  #..#
####  #########  #$ #####  ##.#
#   # #  #    #  #          #.#
#   $ # $  $$  $$  $ $$$#$$ ###
## $ $ $ $ $ $ $ $ $ $@  $ $  #
#  $   $$$ $$  $$  $ $$$ $$   #
###$ $ $ $ $ $ $ $ $ $   $ $  #
#   $  $ $ $ $ $ $ $ $$$#$ $###
##  #### ### ## ##### # # # ###
#                           ###
###############################
Solution: r3u2l6u4l2u1l1r1d2l1d1l2u3l1u2d2r1d3r2u1r1u3d3l1d1l2u3l1u2r5l1d2l1u1r1u1l15,16-6u3r1l1r1u1l14,14-4d2r1d1r1u4r1u1l13,14-4d1r1d1u1d1r1u3r1u1l12,14-4r1d1r1u2r1u1l11u1l1d1u1l1d2,14-6l1u3d1r3u2l11u1l1d1u1l1d3,11-4r4d1r1u2r1u1l13u1l1d2,11-6r4d1r1u4r1u1l13u1l1d1u1l1d5,16-9u6r1u1l14u1l1d4,17-12u1l1u8r1u1l14u1l1d3,18-10l1d1l1u8r1u1l14u1l1d2,18-7l1u1l2d2r1u5r1u1l14u1l1d1u1l1d5,19-6l2d1l1u4r1u1l15u1l1d4,12-7r3d1r1u5r1u1l15u1l1d3u3r13,18-9u2r1u1l2d1l1u4r1u1l15u1l1d2,19-4l2d1l1u2r1u1l15u1l1d1,20-10l3d1l1u8r1u1l15,23-11l1u1l5d1l1u8r1u1l14,23-9l4u1l1d1r1d1l2d1l1u8r1u1l13,25-7d1r1d1l7u1l1d1r1d1l2d1l1u8r1u1l12,23-11u1,24-9l5u1l1d1r1d1l2d1l1u8r1u1l11,22-13u2r1u1l6d1l1u8r1u1l10,24-12l1d1l1u2r1u1l6d1l1u8r1u1l9,20-12r1u1r1u1l5d1l1u8r1u1l8,22-13u2r1u1l6d1l1u8r1u1l7,18-12r1u1r1u1l3d1l1u8r1u1l6,21-12l1d1r1u2l3d2r1u2r1u1l3d1l1u8r1u1l5,21-13l1,23-13l1,24-13r1u1r2u1d1l2u1d1r2u1l7d1l1u1r1u1l3d1l1u8r1u1l4,25-11l1r1u2r1u2l1d1r1d1l7u1d2l1u5r1u1l5d1l1u3r1u1l12,26-9d1,27-11l6d1l1u2r1u1l2d1l1u5r1u1l5d1l1u3r1u1l11,28-13u1r1u1l10d1l1u7r1u1l5d1l1u3r1u1l10,27-9d1,28-11l9d1l1u7r1u1l5d1l1u3r1u1l9,18-14l1u1l1u10r1u1l2,18-12l1d1l1u8r1u1l2d1l2u3r1,16-13l1r1u2l1u4r1u3l2d1l1u3r1u1l8,16-6l2d1l1u5r1u1l7,15-13u8r1u1l2d1l1u3r1u1l6,13-12r2u2l2d1r1d1r1u7r1u1l2d1l1u3r1u1l5,10-11r4d1r1u7r1u1l2d1l1u3r1u1l4,15-13d1l1u3l1u1r1d1r1u6r1u1l2d1l1u3r1u1l3,11-9d1r3d1r1u6r1u1l2d1l1u3r1u1l2,10-11r4d1r1u7r1u1l2d1l1u3r1u1l1,16-2l1,20-2l4,9-10l1d2l2d1l1r1u2l1r1d2l1u5l1u1r1d3l2u1l2d1r1d2r1d2l1d2r13u11r1u1l2d1l1u3,12-13u2l1u1r3d1r1u6r1u1l2d1l1u2,12-13r2d1r1u9l1u1r2d1r1u2l1u1r8u1r2d2l1u1r1u1l6,17-14l1,15-15u10l1u1r2d1r1u2l1u1r9d1r1u1r1u1l5,12-12r2d1r1u8l1u1r2d1r1u2l1u1r12,12-14r2l2d2r3u11l1u1r2d1r1u2l1u1r11,20-13l4d1l1u9l1u1r2d1r1u2l1u1r10,20-14l4,15-15u10l1u1r2d1r1u2l1u1r9,22-13l5d1l1u9l1u1r1d1r1u2l1u1r8u1r1d3,21-15u5r1u1l3d1l1u5r1u1l1d1l1u2l1u1r8u1r1d2u2r4d7u7l1d5u5l1d3u3l1d3,23-15u2r1u1l7d1l1u8l1u1r1d1r1u2l1u1r12u1r1d6,23-14l1,21-15u5r1u1l3d1l1u5r1u1l1d1l1u2l1u1r12u1r1d5,25-15u3r1u1l7d1l1u7r1u1l1d1l1u2l1u1r12u1r1d4,26-14u2r1u1l8d1l1u7r1u1l1d1l1u2l1u1r12u1r1d3,28-13l9d1l1u9r1u1l1d1l1u2l1u1r12u1r1d2,27-15u3r1u1l9d1l1u7r1u1l1d1l1u2l1u1r12u1r1d1,10-12r5d1r1u8l1u1r1d1r1u2l1u1r11d1r1u1l1u1r1,10-13r4d1r1u9l1u1r2d1r1u2l1u1r11u1r1d4,10-14r4l2d2r3u11l1u1r2d1r1u2l1u1r11u1r1d3,8-14r6l2d2r3u11l1u1r2d1r1u2l1u1r11u1r1d2,8-11r6d1r1u7l1u1r2d1r1u2l1u1r11u1r1d1,8-12r6d1r1u8l1u1r2d1r1u2l1u1r9d1r1u1l1u1r2,8-14l1u1l1u1r8d1r1u8l1u1r2d1r1u2l1u1r10u1r1d2,8-14u1r7d1r1u8l1u1r1d1r1u3l1u1r10u1r1d1,7-12r6d1u1r1d1r1u8l1u1r2d1r1u2l1u1r9d1r1u1l1u1r1,6-11r8d1r1u7l1u1r2d1r1u2l1u1r8u1r2d2l1u1r1u1l2,5-14r9,15-15u10l1u1r2d1r1u2l1u1r12,3-12r11d1r1u8l1u1r2d1r1u2l1u1r11,2-10r1d1r11d1r1u7l1u1r2d1r1u2l1u1r10,2-12r12d1r1u8l1u1r2d1r1u2l1u1r9u1r1d2,3-13r11d1r1u9l1u1r2d1r1u2l1u1r9u1r1d1,3-16u4l1u1r12d1r1u7l1u1r2d1r1u2l1u1r9l3u1r3,5-14l1u1l1d1l1d2r1u4l1u1r12d1r1u7l1u1r2d1r1u2l1u1r8u1r1d1l5u1r4,7-7l1u1l1d5l1d1r10d1r1u8l1u1r2d1r1u2l1u1r8,7-9d1r1d2l2u1r8d1r1u7l1u1r2d1r1u2l1u1r7l5u1r5,5-10l1d1l2u2r1d1l1d1r12d1r1u7l1u1r2d1r1u2l1u1r6

;3
############################
#..........................#
#.###$$###$$ #$  $###$$###.#
#.# $  $ $  $ $ $ # $  $ #.#
#.#  $   $  $ $$  # $  $ #.#
#.#   $  $  $ $ $   $  $ #.#
#.# $  $ $  $ $  $# $  $ #.#
#.#  $$ # $$  $ # $  $$  #.#
#.##    #  ### ##  #    ##.#
#.#### $$$   $$  $ #$ ####.#
#.#### $  $ $  $ $  $ ####.#
#.#### $ $  $  $ $$ $ ####.#
#.#### $ $# $$$$ $ $$ ####.#
#..####$  $ $  $ $  $####..#
#..... $$$##$ #$#$# $ .....#
#+.........................#
############################
Solution: 22-1d2,21-3u1,20-1r5,22-5u3,21-1r3,19-14r6,26-15u12,16-2d1,19-5r2,22-6u4,21-1r2,24-5l1,22-6u4,21-1r1,17-5d2r1,19-6r1,19-11d1,19-12d1,21-12l1,20-12d1,19-13u1,19-15u1r6,26-15u11,18-13r1,20-12d1,19-14r6,26-15u10,19-10d2,18-13r1,20-12d1,19-14r6,26-15u9,21-10l1d3,19-14r6,26-15u8,20-8d5,19-14r6,26-15u7,18-10r1,20-9d4,19-14r6,26-15u6,22-6l1,20-5d8,19-15r1,19-14r6,26-15u5,22-6d1,23-8l2,20-7d6,19-14r6,26-15u4,22-7l1,20-6d7,19-14r6,26-15u3,18-7r1,20-6d7,19-14r6,26-15u2,24-6l3,20-5d8,19-14r6,26-15u1,24-4l2,21-3d4,22-8l1,20-7d6,19-14r5,25-15u1,19-3r1d10,19-14r6,15-5r4,20-4d10,19-15r6,15-5u1r1,17-3d1,16-5r3,20-4d9,19-14r5,6-1d2,5-3u1,6-1l4,5-3d1,3-3r1,5-4u2,6-1l3,4-7u3,3-3r1,5-4u2,6-1l2,5-6u4,6-1l1,11-1d2,10-3u1,11-1l3,11-5u3,12-1l3,10-5l2,7-4l1,6-6u4,5-5u3,8-3r1,10-4u2,11-1l1,17-3u1,16-1r3,21-4u2,24-3l1,22-4u2,11-4r1u2,11-1r7,11-6r1u4,11-1r6,13-5r3,17-6u4,15-4u2,14-1r1,15-3l1u1,15-1l1,14-5u3,12-4r2,15-5u3,14-3l1,12-4u2,6-3r4,11-4u2,8-4r1,10-5u3,8-6r2,10-8u2,10-11u3,8-13d1l1,7-15r17,7-14l5,1-15u12,9-13d1,8-15r15,11-13l2,8-12d1,9-14l7,1-15u11,6-12r1d1,8-14l6,1-15u10,8-11d2,9-14l7,1-15u9,10-11l1,8-10d3,9-14l7,1-15u8,9-11d1,10-13l2,7-12d1,8-14l6,1-15u7,9-8d2,10-11l1,8-10d3,9-14l7,1-15u6,6-10r1d3,8-14l6,1-15u5,7-8d5,8-14l6,1-15u4,9-9l1d4,9-14l7,1-15u3,7-8d5,8-14l6,1-15u2,8-5l1d8,8-14l6,1-15u1,5-5r1,7-4d9,8-14l5,2-15u1,5-6d1,4-8r2,7-7d6,8-14l6,5-7r1,7-6d7,8-14l5,11-5l3,7-4d9,8-14l4,12-6l4,7-5d8,8-14l3,10-6d4,11-11l3,7-10d3,8-14l2,12-7l2,9-6d8,10-15l8,15-7l5,9-6d8,10-15l7,14-5d1,15-7l5,9-6d8,10-15l6,14-6l6,7-5d9,8-15l3,14-8d1l6,7-8d6,8-15l2,16-13r3,20-12d1,19-14r4,14-13r5,20-12d1,19-14r3,11-13r8,20-12d1,19-14r2,12-13d1,13-15l6,15-13d1,16-15l8,17-13d1,18-15l9,13-11d3,12-15r10,18-10d2,17-13r2,20-12d2,19-15r2,16-11r3,20-10d4,19-15r1,17-11d3,16-15r3,14-11d1,15-13l1,13-12d2,14-15l4,11-11r1d3,14-15l3,12-9d5,13-15l1,13-10d4,12-15r5,16-11d1,16-11l1d3,14-15r1,15-11l1,13-10d4,12-15r1,15-9d5,16-9r1d5,18-8d4,17-13r1,19-12d2,15-10l2,12-9d5,17-7d3,18-11l4,13-10d4

;4
#############################
#......#   #   #............#
#. #####        #### ##### .#
#. #   $$#$$$#$ $ # $    # .#
#. # #$  # $  $ $   $ ## # .#
#. # # $ # $  $ $ # $ ## # .#
#. #    $  $  $ $   $    # .#
#. ###$$ ##$##$#$$$#$$$### .#
#.               #   #     .#
#.      #   # #  #  #      .#
#. ####$ $# $ #$$  $$$## # .#
#. #   $$$ $ $ $ $ $     # .#
#. # # $ $ $ $ $$  $$$## # .#
#. # # $ $ $ $ $ $ $   # # .#
#. #   $ $  $  $ $ $$$   # .#
#. ##### ### ### ### ##### .#
#+..........................#
#############################
Solution: 8-7u1l1d1r1d1l6d1l1,6-6d1r1d1l4d1l1u7l1u1r4,6-3d4r1d1l4d1l1u7l1u1r3,7-4d3r1d1l5d1l1u7l1u1r2,13-10l1d4l2u3r1u2d1r2u2l10d1l1u7l1u1r1,12-13l1u4d1r2u2l10d1l1u7d7l1u7,8-12u1l1u2l1u2r2d1l6d1l1u6,8-11r1u2r1u1l8d1l1u5,9-10d1l2u1r1d1r1u2r1u1l8d1l1u4,8-4d3,9-8l7d1l1u3,9-11r1d1r1u3d1r2u2l11d1l1u2,10-4u1d3u1r2u2l1u1l1u1l2d6l1d3r2u2l7d1l1u1,20-13d2,21-16l19,20-11d2r1u1l1u1r3l2d2r1d1r2u5l1u1r3,10-2l1u1l1d6l1d3r2u2l2u1l1d1r1d1l5u1l1d6,12-6l5u1l1d3r1d1l5u1l1d5,11-2r1,15-6l8u1l1d3r1d1l5u1l1d4,11-3d2r1d1l5u1l1d3r1d1l5u1l1d3,10-2d3r1d1l4u1l1d3r1d1l5u1l1d2,6-3r1,8-2d5,9-8l3,11-6d1,12-8l5u1l1d1r1d1l5u1l1d1,14-2l5u1l1d6,9-8l2u1l1d1r1d1l5r4u1l4,14-13l2,12-12u1,14-11l1,14-12u1l1d1,12-16u2,7-11l1d3r1,8-13d2,9-16l6,6-12r1u1r1d4,9-16l5,4-11r3u1r1d5,9-16l4,10-12l1u1l1d4,9-16l3,10-14l1,8-13d2,9-16l2,10-12d1l1u1l1d3,9-16l1,11-14l2u1l1d2,16-14l6,20-13d2,21-16l5,14-16r7,23-16l13,12-12d3,13-16l2,8-14r3,12-13d2,13-16l1,10-13r1u1r3l2d3,14-13l2,16-13l2,22-14l1,20-13d2,21-16l7,21-9d2l2u1l2d1r6,24-12u3l1u1r2d1r1u7r1u1l10,16-11d4,17-16l2,18-14l1,16-13d2,17-16l1,18-14r1,20-13d2,21-16l4,18-13r1,20-12d3,21-16l3,18-12r1u1r1d4,21-16l2,16-13r3u1r1d3,21-16l1,12-13r7u1r1d3u2r1u1l1u1r3l2d3r3u5r3u2d2l4u1r2d1r2u2l1d8r1d1l5,14-11r9,24-12u3l1u1r2d1r2u2l1d8r1d1l4,11-11r12,24-12u3l1u1r2d1r2u2l1d8r1d1l3,7-14u2l1u1r17l2d3r3u5l1u1r2d1r2u2l1d8r1d1l2,11-14u2l1u1r13l2d3r3u5l1u1r2d1r2u2l1d8r1d1l1,11-10r1,13-9d1l1d1r11l2d3r3u5l1u1r2d1r2u2l1d8,27-5d10,15-13u1l1u1r9l2d3r3u5l1u1r3u1r1d7,17-13u1l1u1r7l2d3r3u5l1u1r3u1r1d6,15-4r2d2r2u3r2d2l1u3,22-6d2,21-9r5u1r1d4,21-1l3,17-4r2,20-5u3,21-1l2,19-6u1,18-4r1d1r1u3,21-1l1,23-3l2d1l1u2,16-9d1r1d2l2u1r8l2d3r3u5l1u1r2d1r1u7r1u1l5,19-8d2l1d1r5l2d3r3u5l1u1r3,21-10l1,19-9d1l1d1r5,24-12u3l1u1r2d1r1u7r1u1l4,15-9d1,14-11r9,24-12u3l1u1r2d1r1u7r1u1l3,15-4l3u1l1d7r1d2l2u1r13l2d3r3u5l1u1r2d1r1u7r1u1l2,14-4d1l2u1l1d6u1l2d2r14l2d3r3u5l1u1r1d1r2u2r1d4u2l3u1r2u1r1d3,15-6l3u1l1d5r1d2l2u1r13l2d3r3u5l1u1r3u1r1d2,14-8u2r1u1l3u1l1d6r1d2l2u1r13l2d3r3u5l1u1r3,17-6l5u1l1d5r1d2l2u1r13l2d3r3u5l1u1r2d1r1u7r1u1l1,17-5l5u1l1d6r1d2l2u1r13l2d3r3u5l1u1r2d1r1u7d7r1u7,16-6d4l1d1r8l2d3r3u5l1u1r3d1r1u6,18-6d4l1d1r6l2d3r3u5l1u1r3d1r1u5,18-7l1u1l1d4l1d1r8l2d3r3u5l1u1r3d1r1u4,14-2d3l1d1r2u1r1d5l1d1r8l2d3r3u5l1u1r3d1r1u3,17-3l2u1l1d3l1d1r2u1r1d5l1d1r8l2d3r3u5l1u1r3d1u1d1r1u2,21-6l4u1l1d5l1d1r8l2d3r3u5l1u1r3d1r1u1,20-8u1r1u1r1d2r2d3l3u2r5l3u1l1u2l5u1l1d5l1d1r8l2d3r3u5l1u1r3

