;1
   ####
####  #
#  #  #
#   $ #
#  $#.#
### @.#
  #####
Solution: 5-3l2,3-5u1,2-2d1r2,5-4u1,1-4r1,3-5u1,5-1d3,4-3l1,1-3r3,5-2d1

;2
 ######
## .. ##
#. #   #
#    $ #
#@$$# ##
###   #
  #####
Solution: u1r2l1u2r3d1l1r2d1l3r3l1d2l2u1d1r2u4l3d1l1d2r1u1r2u1r2d1l4d1l1u1r4d2l2u1l1u1r2l1d2r2u2r1u1l1u1l3d1u1r3d2l1u1r1u1l1d2l1d1l2u1r3l1d2r2u2r1u1l1d1l1u1

;3
 ####
 #  ####
##     #
#  #   #
# ...# #
## $$$ #
 ### @##
   ####
Solution: l1u3d1l2u3r1d1r1d2u1r2d2l1d1l1u2l2d1u3r2d1r2u1l3u1l1d2l1d1r1u2r4d3l2u1d1r2u3l4d3r2u2r1u1l2u1l1d2u1r4d3l1d1l1u1

;4
########
#...   #
#  $$  #
#.. #$##
# $ $ #
#### @#
   ####
Solution: undefined

;5
        ######
        #    #
        #. . #
######### # ##
# $ $ $ $.$.#
# .$.$.$.$. #
# $.$.$.$.$ #
#@.$.$.$.$. #
# $.$.$.$.$ ##
# .$.$.$. *  #
#            #
##############
Solution: undefined

;6
#############
#           #
# .$.$.@.$. #
# $.$#$#$.$ #
# .$. . .$. #
# $.$#$#$.$ #
# .$.$.$.$. #
#           #
######  #####
     ####
Solution: undefined

;7
 #####
 #.  ##
## #$ ###
#   . *@#
#.  # $ #
#   $ ###
####  #
   ####
Solution: undefined

;8
  ####
###. ###
#      ##
# .$.#  #
## #@$$ #
 # $.  ##
 ###  ##
   ####
Solution: undefined

;9
##############
#    #  #    #
# ## $.*$ ## #
#  $..*...$  ###
## .$* $*$. #@ #
 ##$ .$ . $##$ #
 # .*..*.*. #  #
 # * *$ * * #$ #
 # . #  # . #  #
 ###### #####$ #
      # $ $ $  #
      #        #
      ##########
Solution: undefined

;10
   ###########
####         ####
#    #.*$*.#    #
#  # . .#. . #  #
##$$$..*$*..$$$##
 #   # .$  #   #
 #  $ $#*#$ $  #
 #   #  $. #   #
##$$$..*$*..$$$##
#  # . .#. . #  #
#    #.*$*.#    #
####    @    ####
   ###########
Solution: undefined

;11
########
# .    #
#..  $ #
#.#$#  #
#   $$##
####@ #
   ####
Solution: undefined

;12
####
#  ###
#  . ###
# #+*$ #
#  $   #
####   #
   #####
Solution: u1l2d2r3l1u2d2r1d1r2u1l3u2r1d1l1d1r1d1r2u2l1r1l2d2r1u1l1u2l3d2r3l1u1d1r1d1r2u2l2d2r1u1r1u1l1

;13
      ####
   ####  #
   #   $ #
####. #$ #
#@ #. #  #
#  *.*#$ #
#  #*    #
#    #####
#   ##
#####
Solution: undefined

;14
 ####
##. ####
#  $$  #
#   $@ #
# # #$##
# . *  #
##  #. #
 ##  .##
  #####
Solution: undefined

;15
######   ##########
#    #####     #  #
# *$**...*.*#* #  #
# ....**....*.$#  #
### *..*..*.# $  ##
 ## $$ $  $$  ## #
 # $#..$#.. # ## #
 #   $  $ $ $  # ##
 #### .*..# $$$$$ #
    # *  *  $  $@ #
    ##$..$# $ $$$ #
     #    #     ###
     ############
Solution: undefined

;16
 ##########
 #   ##   #
 #$       #
## # ##.###
#@ #$ ...#
# $    $ #
###  #####
  ####
Solution: d1r3u1r3u2l4u1l1d3u3r2d1r3d2l3u1d1r4l1u2l3d2r2l2u3l2d1r5l5d2l1d1r2d1r1u3d1r3u2l3r3d2l1d1l3r2u1r3d1l2u1r1u3r2d1l1u1l1d2u1l3d2r1l1u3l2d1r5l5d2l1d1r2d1r1u3d1r2d1r2l5r5u1l1u2l3d3r3u1l1d1l2u3r3u1r2d1l1u1l1d2u1l3d3r2u1r1l1d1l2u4l2d1r5l5d2l1d1r2d1r1u3d2r3u3l3r3u1r2d1l1u1l1d2u1l3u1l2d1r5u1r2d1l1u1l1d1l3d2r1

;17
  ####
  #  #
### .###
# $ *@ #
# .**  #
##   $ #
 #  ####
 ####
Solution: undefined

;18
 ####
 #  ###
##  @ #
# .$*$##
# . *. #
## $ # #
 ###   #
   #####
Solution: undefined

;19
  #########
  # ..#   #
  #       ###
####$### #  #
#    ##. .  #
# $#.## ##$ #
## $@ $ #  ##
#  $### *   #
#        #. #
######  ##  #
     ########
Solution: undefined

;20
###########################
#                  #      #
# ################ # #### #
# #                  #### #
# # ########## #  #     # #
# # #          #    ##  # #
# #  $ $ $ $ #   . . . .# #
# ##  $ $ $  # #  . . . # #
#  ##$ $ $ $ # # . . . .# #
## #  $ $ $  # #  . . . # #
 # # $ $ $ $ # # . . . .# #
 # #  $ $ $  # #  . . . # #
 #   ## ##  ## # # # # ## #
 ######   #    ## # # # # #
      ### ############### #
        #                @#
        ###################
Solution: undefined

;21
      ####
##### #  #
#   ###  #
#     $  #
##$#.## ##
 #@.*##  #
 #$ .    #
 #  ###  #
 #### ####
Solution: undefined

;22
  #######
  #. #  #
###..$  #
#   .#  #
# ##.  ##
#  $.$ #
### ##$##
#@ $$   #
#   #   #
#########
Solution: undefined

;23
  ####
  #  #
###  #
#  $.#
#  *.#
#  $.###
###$*@ #
  #    #
  ##   #
   #####
Solution: undefined

;24
  #####
  #   #
###@  #
#   $##
# **.###
##  *  #
 # $.# #
 ###   #
   #####
Solution: undefined

;25
#####
#   #################
#  $ $ $ $ $ $ $    #
### . . . . .    # $##
  #$. .#.#. . $###   ##
  # . . . . .  #  $ $ #
  #$. . . . . $#   $  #
  # . .#.#. .  #  $ $ #
 ##$. .#.#. . ###  $  #
 # $. .$.$. . $ # $ $ #
 #  . .$.$. .   #$ $  #
 ##$. .#.#. . $## $ $ #
  # ...$.$...  # $ $  #
  #$ . #.# .  $#  $ $ #
  #  . ... .   # $ $ $#
 ##$#. . . . # ## $ $ ##
 # $  $ $ $  $ ##  $ $ #
 #   ############ $ $  #
 #####           # $ $ #
     #@$ $ $ $ $ $     #
     ################  #
                    ####
Solution: undefined

;26
  #########
###  ##   #
# $       #
# ##$## $ #
#  #. #$###
## .. @ ##
# $#..#$ #
#  .. $  #
#######  #
      ####
Solution: undefined

;27
   ####
 ###  #
##... #
# .*# #
# $@$ ##
## #   #
 # $$  #
 ##    #
  ######
Solution: undefined

;28
########
#  ##  ##
#  $@$  #
#  ## # #
##$.. # #
 #    ..#
 #$# ####
 #   #
 #####
Solution: undefined

;29
    ####
  ###  #
  #    #
### #. #
#. $ .##
# #$# ##
# #@$. #
#  $ # #
### #  #
  #    #
  ######
Solution: undefined

;30
  #######
### ..  ##
# $ # @..#
#  $ * # #
#   $# $ #
####   ###
   #####
Solution: undefined

;31
#####
# @ #
# # ######
# $  .#  #
## #**.  #
#  $. #  #
#  $  # ##
#####   #
    #####
Solution: undefined

;32
  ####
  #  #####
 ## $#   #
##  $ $  #
#...#@$###
# .* #  #
##      #
 #####  #
     ####
Solution: undefined

;33
   #####
   #@  ##
 ### #. #
 # .... #
 # # # ##
##$$ $$ #
#   $   #
#   #####
#####
Solution: undefined

;34
  #############
 ##   # @ #   #
##  # $ #$$$# ##
# $#  # $ #    #
# $ *...*...*#$##
# # .$ $ $ $.$  #
#   . *.*.* .$# #
##$#.$.$ $.$.$  #
#   . * * * .# ##
# # .$.$.$.$.   #
# $ . * *.* . # #
##$#.$.$ $ $. $ #
# $ . *.*.*..#$##
# # .$ $ $ $  $ #
#   *...*...* # #
#####   #   #   #
    # #$$$# #####
    #   #   #
    #########
Solution: undefined

;35
#####
#   ########
#. .  $    #
##$###*   .#
#   # .# ###
#     ##$ #
#  #    $ #
####  ##@ #
   ########
Solution: undefined

;36
  ####
 ##  ###
 # .*  #
## .$. #
#  $.@##
# #$$ #
#   ###
#####
Solution: undefined

;37
  ####
  #. ####
### $.. #
#  .$## #
#  #    #
## $ ## #
 ##$ @  #
  #   ###
  #####
Solution: undefined

;38
      ####
     ##  #
 #####   #
 #  $    #
##@  #$$##
# .## $  #
#..*     #
#. ##  ###
########
Solution: undefined

;39
           #####
     #######   ##
    ##     # #  #
   ##  $    .## #
  ##  $###$#  # #
  #  #      # # ###
 ##$#  # #  *@#   #
 #   #$# # #$####$#
##$    #. $ .   . #
# $ #$$#.# #.## #$#
#      # #$   # # #
# ######   #    # #
#.    ## ###### # #
###$#  # #####. # #
#    # #    ## ## #
# #  *   #  .   # #
# #$#$## # ###  # #
#.   .##.   .  ## ##
#.# #. #.#.#.# ##  #
# #$$ $# # $ #   ..#
#   #  #   # # #####
###### # ###   #
     #.  # #####
     #####
Solution: undefined

;40
#######
#..#  #
#. #  #
#.  $ ###
# .# $  #
#  $ $  #
### $####
  #@ #
  ####
Solution: undefined

;41
  ####
###. #
# .* ###
# #. $@#
#  $ $ #
##   ###
 #  ##
 ####
Solution: undefined

;42
  #######
###@ #  #
#       #
#  # #  #
##*. $ ##
 # .*$ #
 ##  ###
  ####
Solution: undefined

;43
 ######
## @. #
#  .. #
#  #.$##
##$ #  #
#  $   #
#  $  ##
###   #
  #####
Solution: undefined

;44
   ####
####. #
#@*.. #
#  #  ##
##$ #$ #
 #     #
 # $   #
 ###  ##
   ####
Solution: undefined

;45
     ####
     #  #
   ###  #
   # $  #
   # # ###
 ### ....#
 #  # #  #
##  $  # #
# $ $   @#
#   ######
#####
Solution: undefined

;46
#######
#  #.@###
#  $*$  #
#  # *  #
## .*  ##
 #   * #
 ###  ##
   ####
Solution: undefined

;47
   ####
   #  #
#### .###
# $ $$  #
# # . * #
#. $.@###
###   #
  #####
Solution: undefined

;48
 #######
 #  # @#
 # $ *.#
## # #*#
#    #.###
# #  #.  #
# #$     #
#   $ ####
##  ###
 ####
Solution: undefined

;49
######
#  . #
# $# #
##   ###
# $**  #
# #    #
# @. ###
######
Solution: undefined

;50
#########
#   # @ #
#    $* #
## $ #.##
 # ###.##
 #  * * #
 # #    #
 #    ###
 ######
Solution: undefined

;51
   #####
   #   #
####   #
#  $ $ #
#..*#$ #
##. @  #
 #  #  #
 #######
Solution: undefined

;52
########
#.     #
#...$$ #
#.# #@##
#   $$#
##$#  #
 #    #
 ######
Solution: undefined

;53
 #####
 #  .#
##$#.##
# $ . ##
# $#.. #
# $    #
# @$# ##
###   #
  #####
Solution: undefined

;54
    ####
#####  #
#  ##  #
#  ... #
# $$#. #
### #. #
#   ##$##
#@$$    #
#   #   #
#########
Solution: undefined

;55
 ####
 #  ###
 #    #
##    ###
#  #***+#
#   $ # #
#  ##   #
#########
Solution: undefined

;56
#########
#  ##.  ####
# @##.#$#  #
#    $  .  #
## $  # #* #
 ####.$   ##
    #######
Solution: undefined

;57
#########
#  ##.  ####
#@ ## #*#  #
# $     *  #
## *  # #$ #
 ####.    ##
    #######
Solution: undefined

;58
      ########
      #   #  ####
     ## # #     #
     #  #   #$# #####
 ##### *.$  #       #
 #     .. #$ $ $ $$ #
 #$#$$$**$   #####  #
 # . . ..$ $ ########
 # .$.#**$ #$$ $ $ #
 # .$.@..$........ #
 # #$# $$$#...**.. #
 # *.....   ###  ###
 # $# $ $$# # ####
##  #####   #
#  $#   #####
#   #
#####
Solution: undefined

;59
    #####
    #   #
#####$  ##
# $@ $   #
#  #.# # #
##..***# #
 ##      #
  ###  ###
    ####
Solution: undefined

;60
 ######
 #    ####
 #       #
### #### #
#    .*..#
#   # ## #
#####  # ##
  #@$$$   #
  #   #   #
  #########
Solution: undefined

;61
 #######
 #  .  #
##$.*  #
#  $#$##
# #.$ #
#  +  #
###   #
  #####
Solution: undefined

;62
#####
#   ###
# #.  #####
# $*      ##
###.$ # #$ #
  #.#   $ @#
  #.  ######
  #####
Solution: undefined

;63
     ####
  ####  #
  #@$ * #
  # $#  #
###$ #.$#
#.  $#. ##
# #   .  #
#   ## # #
######.  #
     #####
Solution: undefined

;64
   ##########
   #        #
 ### ###### #
## $ #  .   ##
# * . .#.#   #
#@ $# $$$# # #
###    #.    #
  ############
Solution: undefined

;65
     #####
 ##### @ #
## $ **$ #
#  #   $####
#     #. . #
#  ## .    #
#######  ###
      ####
Solution: undefined

;66
 ######
 #    ###
## # .  #
#  ...# #
# $$#*$ #
###  $@##
 #   ###
 #   #
 #####
Solution: undefined

;67
####
#  #######
#  $   $ #
#  #   #.##
## #..... #
# $@$ #$$ #
#   #   ###
#########
Solution: undefined

;68
 ####
##  #####
#  $  $ #
#  #..* #
#  $$ $.#
##  .#@.#
 #####  #
     ####
Solution: undefined

;69
#######
#.# +.#
# $$$$#
#.* * #
# $ $ #
#  . .#
#######
Solution: undefined

;70
#########
#. .#   #
#@ $ $ $#
#  .#$  #
#$#.# # #
#.    $.#
#########
Solution: undefined

;71
####
#  ######
#       #
#  #.*$ ##
##$$*#   #
#  # #  .#
#  ..## ##
# @#$#  #
####   ##
   #####
Solution: undefined

;72
####  ####
#  ####@ #
# $##  $ #
#     #* #
##$   ..##
 # .###  #
 ##.$  . #
  # $##  #
  #  #####
  ####
Solution: undefined

;73
  ####
  #  #
  #@ ##
###$* #
# .. $#
#  $..###
###  $ .#
  # #$# #
  #.$   #
  ##  ###
   #  #
   ####
Solution: undefined

;74
    ####         ####
 ####  #         #  ####
 # $ $ ########### $   #
 # $#  $ $ $ $ $ $  ##$##
 # .$.$...$...$...#. .$ #
 #$. .$.$.$.$.$.$. .$.  #
 # ... ...$...$...$#.$$ #
 #$. .$.$.$.$$$.$# $. $##
 # .#.$.$.$. # . #  .$ #
 #$$   ##$$$$ #  #$$  ##
 # # ...#...$.$.$. # ##
 # # $$. .$.$.$.$.$$ #
 # #$...$.$.$.$... # #
## # .$$$.$. . $$.$# #
#  #$...$...#.#  . # #
#@    $ $ $   ###  $ #
######## ###$   ##$ ##
       #  $   $    ##
       ### $ $$# ###
         #####   #
             #####
Solution: undefined

