;1
  #####
 ## . #
 # . $#
##$#..#
#@$ * #
# $   #
###   #
  #####
Solution: r1,1-5r2,5-5l1,4-3d1,5-1d1,4-6u4,2-2d2r1,4-3d1,4-6u2,5-2d2,3-6u1,1-5r2,4-4u1,5-2l1,4-4l1,4-6u2,5-6u1,5-5u1,1-4r2

;2
 #######
##.    #
# $ $$ #
#.$*.$ #
# @# $ #
# #.$..#
#.  #  #
########
Solution: 3-5r1,1-2r1,4-1d3,2-4u1r1u1,6-2l1,6-4l1u1,5-6u1,4-1l1,3-5r2,6-6u3,5-3l2,4-1d1,6-1d1l1,5-3l1,3-2r1,5-3d1,5-6u1,1-2r2,6-2d1,4-3d1,6-3d1l1,5-5l1u1,5-1d3,3-2r1,2-4u1,1-2r2,5-1d1l1,4-4u1l2,1-2d3,6-3l4,3-1d1,4-1d1

;3
########
#.+* $ #
#*$    #
#.## #.#
# $  $ #
#.$$   #
##  .  #
 #######
Solution: 1-1d1r1,1-2d2r1,2-2r2,4-1l1,6-1l1,4-2r1,6-1d3l1,3-1r1,4-3d1,2-4r1,3-6u1r1u1,2-4r2,4-2d2,2-6u1,1-4r1,6-1l1,4-6u2,6-6u1l2,6-3d1,4-2d3,5-6l1,6-4l1,4-5u1,2-5r2,4-4u1,5-2l2,3-1r1,1-1r1,3-2l1,1-1d1,4-1l2,2-4r1,4-5u2,5-2l3,6-1l3,6-6u1l1,4-6u4,5-1l1,6-5u1,2-6r1

;4
 #######
##.... #
#@##  $#
#$$    #
#.$$ $.#
#  $#  #
#.. $  #
########
Solution: d1r3,1-3d2,2-3d1,4-4l1,6-1d3l1u2,6-1l3,6-6u3,3-4r1,5-5u1,6-3l1,4-4u2,5-1l1,1-4r3,5-5u1,6-3l1,4-4u2,5-6l2u2,2-3r2,6-1d2,5-4u2,1-5r1,3-6u1,4-4l2

;5
 #######
##. #  #
#  .$  #
#..$#  #
# $@$$ #
#.**  $#
#  #  .#
########
Solution: u1,1-4r1,2-6u1r2,6-6u3,6-5l4,2-5u1,2-2d1,3-3d1,1-4r1,1-6u2,2-5r2,6-5l4,3-3d1,2-5r2,3-1d1,5-2l2,3-4u1,2-3u1,6-5l1,5-3d1l2,2-5u1,5-6u1l2,5-3d1,6-5l2,6-1d4

;6
  #####
###...#
#     #
# $  ##
# $ $@#
#  ####
####
Solution: l1,1-3r1,2-5u2,1-2r2,5-2l1,4-4l1,4-2l1,3-4u1,2-5u1,3-1d1,1-2r2,4-3u1,3-1r1,3-4u2,1-3r2,4-4u2

;7
########
#.*..  #
#  $ $ #
#@# ##.#
# $ $  #
###   ##
  #####
Solution: 1-1r3,4-2l1,6-2l2,3-1d1,1-2r1,6-1l4,2-2r2,3-4u2,1-4r1,3-5u1,4-2r1,6-1d1,2-1r2,3-4u2,4-1l1,5-4l1,3-5u3,6-1l1

;8
########
#.*..$@#
# $$ *$#
#*  $$ #
#..$.$ #
###.## #
  ####.#
     ###
Solution: d4,6-4l1r1u2l1r1d2l1u1l2d1r1l3u2d1r1,6-4l4,2-3r1u1,6-1l1d2r1d1l3u2r1,1-2r1,5-3l3,5-1d2r1d1l1,2-2r2

;9
 #######
 #...*.#
###**. #
#   #  #
#  $ $ #
#*$ $ $#
#@$ .  #
########
Solution: r1u2r1,3-5r1,6-6u1l1u2,6-1l3d3,6-3d1,5-1d1,3-2r1,1-3r1,3-4u2,6-2l1,5-4u2,6-1l1,6-6u4,5-4l2,1-4r1,2-6r2,2-4r2,3-6u3,4-6u1,5-5u3,6-6l1,3-4r1,5-5u2

;10
  ######
###..$+#
#  $ $$#
# $$ * #
##..#  #
#. *$  #
#   .* #
########
Solution: d1l1d2,6-6l3,6-1l1,3-6u1,2-4u1r1u1,6-4u1,5-6u1,3-5r1,1-6r1,6-5l4,2-6r2,5-3d1,6-5l2,6-1d2,3-2r1,4-5l1,2-6u1,6-6l1,5-1d4,3-3d1,5-3l1,3-2d1,1-2r3,5-1d1,6-3l1,6-5u3,3-3r1

;11
 #######
##.. $+#
#.$$#$$#
#.  .$ #
#.$# #.#
#  $$  #
#.$   .#
########
Solution: l3,6-1d2l4d1,1-6r3u1,3-1d1l1,2-3r1,4-6r1,2-4d1,2-5r1,6-5u2,5-3l2,2-2d2,1-6r2,3-5l1,1-6u1,5-6l3,5-5l1,6-1d2,5-3u1,6-1l2,6-5u3,4-5u1,3-3r2,6-2d1,2-5r1,4-6u2

;12
      ###
 ######.#
 #+*... #
##$$$$  #
#.   ####
#$$ $ #
# .   #
#######
Solution: r4,7-3u1,2-2d1,4-2d1r1,2-3r1,1-6u1r1u2,3-6u1,5-5l1,5-3l1d2l1,1-5r1,2-4r1,2-3r1,3-6u1,5-6l2,3-3d1,2-5r1,5-3l1,3-2d1,5-5l1u2,2-5r1,4-6u1,4-3d1,5-5l1,1-6r1,2-6r1,7-3l3,4-5l1,1-5r1,2-3r1,3-2r2,5-3l1,4-5l1,1-5r1,2-4r1,3-6u1,4-5u2,5-6l2,2-3r1,3-2r1,3-5u2,4-4u1

;13
########
#... . #
#.$$   #
#$@# #.#
# #.$$ #
# $  $$#
#.#    #
########
Solution: u1,1-2d3,1-1r3,4-2l1,4-3d1,6-6u2l2,5-6u1,3-5r1,6-1l2,3-2l1,1-5r2,4-6u3,3-2r1,6-2d2l1,4-5u1,1-1d1,4-1l1,4-4u2,3-1r1,1-1r1,1-4u1,6-2l3,2-3u1,1-3u1,5-6u1,6-4l1,4-5u2,5-2l3,6-6u2

;14
   ####
####. #
#. .* #
#  $  #
##  #$#
# $$ .#
#+$   #
#######
Solution: r1u2,3-4u1,4-1d1l2,2-6r1u1,5-5u2l1,2-2d2,4-3l1,2-2d1,3-5u2,5-1d2,2-2r1,4-3u1,1-5r1,3-6u3,2-2r1,2-3d1,1-5r1,3-6u3,5-6l3,5-3d1

;15
   #####
####...#
#     .#
# # #  #
#.$  # #
#$$$$  #
#+$    #
########
Solution: r2u2,3-5r2,6-6u3,1-4r1,4-4l1,3-2d1,3-6r1,3-3d1,1-4r1,1-6u2,2-6u1,4-5l1u1,1-4r1,1-5r1,1-2d2,6-6l2,2-5r2,4-4l1,3-2d2,1-4r1,2-6r2,4-5l1u1,6-5l2,3-4u1,2-2r2,6-1d2,5-3u1,6-1l1,6-5u3,3-6u3,2-2r3,2-6u1,1-4r1,3-5u2,2-2r2,5-3u1,1-6u1,6-6l4

;16
#######
#...*.#
#     ##
#.#  $@#
# $ #  #
##$ $$##
 #    #
 ######
Solution: l1u2l2d5r2u3l1r1d3l2u3r1u2r1d1l1d1l1d3r2u2r1u1l1u2l2d1l2u1r2d1r2d4l2u3d3r2u4l2u1l2d3r1l1u3r2d2u1r2d4l2u3r1u1r1d1l2d1l2u3r2d1u1l2d3r2d2r2u2r1u1l1u1l2u1d1r2u1l2r2d5l2u2l2u2r3u1r1d3u3l2d1l2d2r2u1d1l2u2r2d4l1u1r1u3l2d2r1l1u2r2d2u3r2d1l2d2l2u2r2u1r2d1l2d2l2u3r2d2u1r2d1l1u1l1u1l2d3r1d2r3u2r1u1l1u1l2u1d1l1u1l1d1r4d4l3u2r1u1d1l1d2r3u4l2u1l2d1r2d2l1d2r3u5l3r1d3l1d2r3u3l1r1d3l3u2r1u2d1r2u2l2d2r1u1d1l1d1l1d2r1u4d3r1d1r1u4

;17
 #######
 #...  #
 #@# $*#
##  #$.#
# $$   #
# #    #
#.  $  #
########
Solution: 6-1d3,4-2r1d1,6-4l1,6-6u1,3-6r1,3-3d1r1,1-4r2,3-6u1,6-6l1,6-3d1,6-1d1,5-5u3,3-3d1,3-6u1,6-1l3,3-3d1r1,5-5u3,6-1l2,3-6u1,2-4r2,5-5u3,6-1l1,6-4u1,6-6u2,5-6l3

;18
 ########
 #....$ #
 #  # $@#
##  # $##
#.$ $$ .#
#.$#  ###
#  .$ #
#  #  #
#######
Solution: 7-1l4,3-4l1d1,2-7u1,3-6r1,5-5u1l1,5-7u2,4-4r2,2-6u2r1,5-2d3,7-2l1,5-3u1,6-1l2,5-7u5,6-1l1,6-4u2,7-1l1,2-2d3,1-6r1,3-4r1,5-5u1,2-6r1,4-7u1,5-2d1,6-4l3,2-3d2,3-6l1,1-7u1,4-4d1,5-6l1

;19
   ######
####+   #
#   $$$$#
#. $#.$ #
#. $ #..#
# #     #
#   #$###
##..  #
 ######
Solution: 5-1d1l1,7-1d1l1d2,7-5l3,4-4l1d1,4-2l1d1,7-4u1,4-2r1,6-1d2,1-2r3,3-5u2,4-2l1,4-2r1,7-1d1,7-2d1,6-3u1,7-1l2,7-5u2,1-2r2,3-7u3l1,1-3d1,5-2l2d1,4-4l1,5-7u1,6-5l2,3-4d2,4-7l1,6-3d1,7-5l3,3-4d2,1-2r4,6-1d2,7-1d2,1-6u2,3-4l1

;20
#######
#...  #
#. $$ #
#.$#  #
#. $ $##
##*.$$ #
 #    @#
 #######
Solution: l2u1d1r2u1l2r1u2l1d1l2u1l1u2r3d2r1d1l1u3r1d1l1u1l3d2r1u1r1u1r2d1l1d2r1d2l3u3d3r3u3d3l3u2r2u1r1d1l2r1u3r1d2l1d1l2u1l1u2r1d1r2d2l2u1d1r2u2l2u1l1d1r1d4r2u2d1l1d1r3u1l1d1l2u2l1u2r2d1r1d1u1l1u1l2d2r2l1d2l1u3d1r2u2l2r2u1l2d5r2u2d2r2u1l3d1l1u4r2d1r1d1u1l1u1l2d4r4u1l3u1l1u2r2u1r1d3u2l3d2r1d2r3u1l2u3r1u1l1

;21
#######
#.  *+#
# $$$$#
#  .$ #
##. *.#
 # $.##
 #####
Solution: l2d2,2-5r1,5-1d2,3-1l1,1-2r1,5-3l2u1,2-1r2,5-2l1,1-3r2,4-2l1,3-5u3,5-3l1,3-2d1,1-2r1,2-1r1,4-2l1,3-5u1,2-3r1,2-1d2,5-3l1

;22
#######
#.*.  #
#@$$  #
##    #
 ###  #
   ####
Solution: 1-1r2d1,1-2r1,2-3r1,3-1d1,5-1l3,4-4u2,5-1l2,2-3r1,4-4u2,5-1l1

;23
######
#..$ #
# $  #
#*$  #
#+*  #
######
Solution: u2r1,1-4r1u1,4-4l2,4-1l1d1,1-2r1,4-3l2,3-1d2,4-4l1

;24
######
#    #
#.. .#
# $$ #
#$.$ #
#. *$#
#  *@#
######
Solution: undefined

;25
    ######
  ###....#
### *. *##
# $.. $ ##
#@$$# $  #
# $  ##  #
##  $ #  #
 ##    ###
  ##   #
   #####
Solution: 1-3r2,3-2r2,3-3d2,4-5d1,1-5r1,2-6r1,3-7r1,7-1d3,5-3l1,3-2d1,7-3l1u1,5-1r2,7-6u4,4-3r1,5-4r1,7-3d1,7-6u3l1,5-4u2,2-5u1,1-3r4,6-4u2,6-7l1,5-6l1,4-5l1u1,2-3r2,5-4u1,6-2l1,4-8u1,3-7u3,2-3r3,7-3l1,5-4u1,5-6l1,3-7u3,2-3r1,1-5r1,3-6u2

;26
      ###
  #####.#
 ##...$ #
 #. $$$ #
## $   $#
# $*$#* #
#... *@##
########
Solution: l4r4u1r1u3l2d1l1r1u1r2d3l1d1l2u2d2l2u2d2r4u1r1u2l1r1d2l1u1d2l2u2r1u1d1l1d2l2u2d2r4u1r1u1d1l1d1l4u2r1u1r1d1l2d2r4u1r1u1l2r2u2l1d1l1r2d2l1u1d2l4u2r2l2d2r2u1l1u1l1d1r2d1r2u2r1u2l1d1r1d2l1d1l3u3r1d1l1d2r3u1r1u2l2r2d2l1u1d2l3u3r1l1d3r3u2l2u1d2l1d1r1u3l1d2u1r4u2l1d1r1d1l3u1l1d1u1r2d1r2u2l1d2

;27
  #######
  #.#...#
 ##$  $ #
## .$$$ #
# .$  $$#
#. .##@ #
#########
Solution: r1u3l2d1l1d1l1d1l2u1r1u1r1u1r1l1d1l1d2r1u1r1u1r1u1r2d1l1r1d2l1u1l3r4u2l2d1l1d1r1u2r2d1l1u1l1d1l1d1l1d1l2u1r1u1r3l1d1l1u1l1d1r1d1l1u2r3u1r2d1l3d1l2u1r1u1r2d1r1u1d1l2u1l1d2u2r4d3l1u1l3r4u1l3

;28
 ########
 #..    #
## $*$. #
#..  #$##
## # $  #
##* #$$ #
#@$.    #
####.   #
   ######
Solution: r1u4d1r2u1r1l1d2r1d2r1d1l1u3l1u1l2d3r3d1r2u2l1r1d2l2u1l2u1l1u2r2l2d3u3l1r1d3r3d1r2u3l1d1r1d2l2u1l3u3r2u1r1u1r2d1l1d2r1d3l2u1l3u3r2u1r1u1r1d1l2d1l2u1r1u1r2d1l1u1l1d1r1d1l2r2u1r3u1l2d1l1,6-4u1,7-2l2,3-1r2d1l1u1l1d1r1d1u1r3u1l2d1l3d3u3r2d2r1l1u2l2d4r3d1r2u1d1l2u2d2r2u2l1u2d2r1d2l2u1l3u4r2d2r1l1u2l2d4r3d1r1u1l4u4r2d2r1d1u1l1u2l2d4r3u2l1u1l1u1l1d2u2r3u1r2d1u1l2d1l1r1u1r2d1l3d1l2u1r1u1r2d1l1u1l1d1r1d1l1u1r4u1l3d3r1d3r2u2l1u2d1l2u3r3d1l2r1d3r1d2l1u3l1d1r1d1l2r2u3

;29
  ######
  #... #
 ## # $#
 #  $ .#
## # .$#
# $$$  #
#+$   .#
########
Solution: r3u1d1l2u1d1l1r3l2r2u1l1r3d1l1u1l2r2u2r1d2l1u4l2d2r1l1u2r2d2r1d2l1u2l2u2r3d2l1d2l1u1r1u1r1u2l3d2r1d2r2u1l1d1l2d1l2u1r3u2l2d1u1r2d2l1d1l2u1r1u2r2d1r2d1l1d1l3u3r1u2r3d2u2l3r3d2l1u1r1u1l2r1d5l3u3r2l2d3r3u4r1u1l1d5l1u1d1l2u1d1r2u2d2l2u3r2d1r1u2d3r1u1d1l2d1l2u1r2d1r1u1

;30
  ######
###..$@#
#.# *  #
#.# *$ #
#.   # #
# $$$$ #
###.   #
  ######
Solution: d1l1r1d4l3u4r1l1d4r3u5l1r1d5l3u2r1u1l1d3r1u1l1u1l2d1r1u1r1d1r1d1r2u1l3u2r1d1l1d1r1d1r2u3l1r1u2l1d1r1d4l2u1l1u3r1d1l1d2r1d1r2u3l2r2d3u3l2u1l1d1r3u2l1d1r1d4l2u2d1l1r1u2l1u1r1d4r2u1d1l2u1l1u1l2d1r1u1r2u2l1d1r1d1l2d1l1u2d1r3d2r2u3l2u1l1d1r1d1l2d1l1u1r3d2r2u1l1d1l1u2d1r2u2l2u1l1d1r1d1l2d1r2u2r2u1l1r1d3l1d1l1u2

;31
    ###
#####.###
#.##.$*.#
#  $ $ .#
#.***.$ #
#.  $$$$#
####. $@#
   ######
Solution: l2u1l1u2r1u1d1l3r2d2l2u1l1u1d1u1r1d2r2u1l2r2d1r1d1u1l1u2r1u1r1l1d1l1d2r1d1r2u2d1l3u2r1d1l1d1r1d1r2u2l1r1d2l2u1l1u2d2r1d1r2l2u1l1u2r1d1l3d1r1l1u2r1d1r4d2l1u1r1u1l4r2u2r1d2l3u1r2d1r1u1d1r1d2l2u1d1r2u2l2u1l2d2r1l1u2r2d1l1r3d2l1u1r1u1l2r1d2l1u1

;32
  ### ###
###.###.#
#  $  $.#
#$..*** #
#.$$  $$#
## .$$$+#
 ##.*.###
  #####
Solution: u3d3u1l1r1u2d2l2d1r1l1u1r2u2l2d1l2d2u3l2d1u1r2d3u2r2u1r2d2l1d1l1r1u1r1u2l2d1l2d2r1u1r1l2r2u2r2d2l1d1l1u1l2u2r3l1r1l1r1d1u1l3d3r1l1u3r1d1u1r2d1l1u1l4d1u1r2d2u2r3d1r1d1l1d1l1u1r1u2l3d3u1r2l2d1l1r2l1u3r3d1r1d1l2r1d1l1r1u3l3d2r1l1u2l2d1u1r2d3r1u1r1l2u2l2d1u1r5d1u1l2d1u1r2d1l1d1l1r1u2l2d1r1u1l3d1r1u1r2d3l2u1d1r2u3r2d1r1d1l1u2l2d1u1r2d2u2l4d1u1r2d1l1r1d2l1u1r1u2r2d3l1r1u3l2d2r1d1r1u1l2r1l2d1r1u3l1d1u1l2d1r1u1r2d3l2u1r1d1r1u1r2d1l2

;33
   #####
####...#
#. $ $ #
#..$ $##
# *  $+#
#.$.$$$#
##     #
 #######
Solution: l2u2l2r2d1u1l2d1u1r2u1r2d1,1-5r1l1u2r1u1r2u1d2u1l2d1r1l2d2r1d1r2u1l1u1l1r1d2r3u1l1d1l2u2l1u2r2l2d1l1d1u1r1u1r2u1r2d1l1d2u2l1r1d2l1u1l2d1r1d2l1u1d1r3u1d1l2u1r1l1u2r1d1u1l2d1r2u1r1u2l1d1r1d1l1d1l2u2r2d1r1u1l1u1r1d1l3d2r1u1l1u1r2d1r1u1l2d4r1u1d1r2l2u4d4l2u2d2r4u1l3d1l1u1r2u2r1d1l1d2r2u1l2

;34
#######
#+*...#
#$$$$ #
#.$ $ #
#*    #
#.*.$ #
#######
Solution: undefined

;35
  ######
  #. $@#
### #$*#
#  $ $ #
#...   #
# .# $ #
# $  . #
########
Solution: d3,6-1l2,4-3l1,6-3l1,5-1d1,1-6r1,5-4u1,3-3r1,1-3r1,4-3l1,6-3l1,6-6u1l1,6-3d1,3-3r1,1-3r1,4-6u1,5-4l3,1-3d1,2-6r1,4-3l1,6-3l1,6-6u1,3-6r1,6-6l2,6-3d1,5-1d3,6-6u2,6-2d1,6-3d1,3-3r1,5-2d1,1-3r1,1-6u1,6-6u3,2-3r2,6-4l2,2-6r2,6-6l1u1,3-6r1,4-4l1,2-3d1,6-4l3,6-3l1,6-1d2,1-3d1r1,3-3r1,2-6u1,1-6u1,5-4u1,5-1d2,2-3d1,6-5u2,4-4l1,6-4l2

;36
 #######
##.. $.#
#. .$. #
# $#   #
#..# $ #
# $$$$$#
#. #@  #
########
Solution: r2l2r2u1d1l2u2d2r2u1l1u2r1u2l3d1u1r3d3u3l1d1u1l2r1l1d1r1l3r3u1r2d3l2r2u2l1r1d2l1d2r1u4l1d2u3l2d1r1u1r1d1l4d2r1u1l1u1r2u1d1l2d4r1u1l1u2r1u1r1u1r2d1l1r2d2l2u1d1r2d2l1r1u4l1u1l1d1u1d1r2d2l2u2r1u1l1r1d1r1d4l2u1l2u1l1u2r3d2r2d2l1u1l1u3l3d2r1d1r2l2d1l1u2d1r3d1r2u1l4u1l1d1r3u3l3d1u1r1d1u1r2d3r2u3l4r4d2l1d1l1u2d1r2u2l2r2d2l1u1

;37
  ######
###....#
#+$    #
#$#.$$##
# $$ * #
# . $  #
# .$   #
########
Solution: d2u2r3l1d2r1u1l1u1l2d2r1d2r2u1l1u1l2u2r2d1r1d1u1l1r1d1l1u3r1d1l3d2u2r2d4l2u2r1l1d2r2u4l2d2r2u2r1u1r2d1l3d2r1u1l1u1r1d2l1d2r1u2d1r2u1l1d1l2u1r1l1u2r1l1d3r3u1l1d1l2u3r1u1r2d1l1d2u1l1d1r1u3l1d1r1d2r1d2l1u4l1u1r1d3l4u2r3l3d2r4u2d2l1u2d2l1d2l2u3d1r4d2l2r1u1l1u1r1

;38
########
#+$    #
#$$# $ #
#..*  ##
#...$  #
# $$#. #
##.  $ #
 #######
Solution: r1d2r1d1u1r1u2r2d1l1d2u1l3u2r2d1u1l2r2d1r1d2r1d2l3u2d2r3u2l1u2l1u1l2d2l1d2u2r1u2r2d1r1d2l1r1u2l1u1l2d2l1d2r1l1u2r1d1r1l1u3r2d1r1d2l1r2l1u2l1u1l3d1u1r3d1r2u1l4r3d3l1u1r1u2l3d2r2d1r2l1u1l3d1r1u1r2d1r1d2l3u2l1u1r2l1d3r3u2l2u1l2d1l1d1r1u2r2d1l2r4d2l3u1d1r3u2l3u1l1u2r2d2l1d3r3u2l2r2d2l3u2r1u1l1r1u2r2d1l1d1l2d3r3u2l2r1u3l1d1r1d1l1

;39
 #######
##.....#
# $$. .#
#* $ $ #
#  $ $ #
#  ###$#
# $  .@#
########
Solution: u4l2u1l2d3l1d2r3l3u2r1l1d2r1u4r1l2r2l2d2u2r2u1r2d1l1d1l1u1l2d2r1u1l1u1r2d1r1u1r2l4d4l1u2r1u1r2d1l1u1l1d1l1d2r1u2r1u2l2d2r1u1l1u1r1d1r2u1r2d2l1u1l1u1r1d1l3u1r2d1r1u1l3d4l1u2r2u1r2d1l2u1l1d1l1d2r1u2r1u2l2d1r2d1r1u1d1l2d1l1u1

;40
   ####
 ###. #
 #    #
 #**  #
## $ .#
#  $#$#
#.  *@#
#######
Solution: u2l1u2l2r2d2r1d2l3r3u2l1r1d2l3u2r1l1d2r3u3l1u1l2r2d1r1d3u3l1u1l2d2r1u1r2d3l3u1d1r3u3l3d1u1r3d1l1u3r1d1l1d1l2u1d1r2d1r1u1l3d1r1u1r2d3l3u1d1r1u1d1r2u3l3d1u1r3d2u2l2d1u1r2d1l1u3r1d1l1d1l2u1r1d1r1u1d2r1d2l3u2r1l1d2r1u2d2r2u2l1u2l2d1u1r3l3d1r1d2l1d1r1u3d2l1u1r1u2r2d1l1

;41
   #####
####...#
#    . #
#.  #  #
#  #@# #
#  $$$ #
##$  $$#
#.     #
########
Solution: d1l1,6-7u4,6-5l1d1,6-7l4,3-5r1,1-5r1,2-7u3,6-1d2,2-4u1,1-2r3,5-3u1,6-1l1,5-6l2,2-7u2,2-5u2,1-2r3,6-5u3,5-3u1,4-5l1,2-6u3,1-2r3,6-5l3,2-6u2,3-3l1

;42
#######
#.....#
#..$$$#
#   #.#
# $ $ #
#$$$$.#
#@   ##
######
Solution: u3r1u2r3d3u3l3d2l1u1r1d1r1l2d3r2l1r1u1l1d1l1u3r1d1u1r1d1l1u3r1d1u1r2d1l1u1l2d3u2r1l1d2r1u1l2d3r1,5-4l2u1l2d3r2u1d1l2u3r2l1r1d1u1l1u2r1d1u1d1l1d1l1d1u1r1u2r3d3l2u2l1u1r1d3r2u2l2d1l2d3r3l1u2r2u2l2u1l1d1r3d2l2u1d1r2u2l2d4r1u1l1u3r2d2l1r1u2l2d2r1d2l3u3r1l1d3r3u2r1u2l2u1l1d1r3u1d3l2u1d1r1d2l3u3r1l1d3r3l3u3r1u1r1l1d1l1d3r3u2r1u3l1r1d3l1d2l3u3r1u1r2u1r1d1l3r1l1u1r2l2d2l1d3r3u2l1u2l1u1r1d3r1d2l1u4d4l2u1r1u3d2r2d1l1d1l1u3

;43
#######
#...*.#
# #   #
#. *$ #
#*  $ #
#.$$$$#
##   @#
 ######
Solution: l3r3u2l2u1l2d1u1r2d1l1u1l1u2r2l2d2r2d1r2d2l3u1d1r2u1d1l2u1r1u2l1d1u1l1u2r2d1u1l2d2r1d1r1u1d3l1u1r1u2l1d1u1l1u2r2d1r2d2u2l2u1l2d2r1d1r1l1u1l1u2r2d1r2d2l1r1u2l2u1l2d2r1d1r1d2l1r1u2l1u1l1u2r2d1r2d2u2l2u1l2d2r1d1r1d2r2,5-4l1u1l1u2l2d2r1d1r1u1d3l1u2r1u1l1r3u2l3r3d2l1u1r1u1l2r1d2l1u1d4r2u4d3l1u3d4l1u2

;44
 ######
 #..$ #
 #    #
##*.* #
#. .$ #
# $$$*#
# . $@#
#######
Solution: l2u2l1u2r3u1l1r1d3u2l3d2r1d2r2u3d3l2u3d3r2u3l1r1d2l1r1u2l1d1u3r1d1l1d2r1d2u3d1l3u1r1d1r2d2l2r1l1r1l1r2u2l4d2r2u1l1u1d2l1u1r1u2r1d1r2d2l2u1d1r2u3l1u2r1l1d3r1d2l2u1l1u2r1d1r2u1l1u2r1d1l1d2r1u1d3l2u1l1u1r1d2r2u3l1u2d2r1d2l1d1l1u1l2d1r2u1r2u2l1d1r1d1l2r1u4r1d2l1d2l1d1l2u1r1u3r1l1d2r1u1l1d3r1u1r2d1l2u1l1u2r2d1u1r1d1u1l3d1r1u1r2d1l1r1u3l1d2l2u1r1d1r2u2l1d1l2d3r1u1l1u2r3d2l2d1l1u1r2u1d1l1d2r2u1l1u2r1d1l1d2l1u1r1u2r1u2l1d1

;45
#######
#.. $.#
#.*#  #
#.    #
#.$ $ #
##$$$$#
#.  *@#
#######
Solution: l3r3u1d1l2u1d1r2u1d1l2u2d2r2u1l1u2r1u2l3d1l1d2r1l1u2r1u1r3d3u3l1d1r1d2l1d2r1u4l1u1l2d1l1d2r1l1u2r1u1r2d3u3l2d1l1d2r2l2u2r1d1u2r2d2l1r2d3l2u2d2r2u3l1u2l2d1l1d2r1l1u2r1d1u2r2d2l1r2d3l2u2d2r2u1l1r1u2l1d1u3l2d1l1d2r2l2u2r1u1r2d2r1d3l3r3u3l1u2l2d2r1l1u2r2d1r1d4l2u2d2r2u2l1d1r1u3l1d1u2l2d2r1l1u2r2d1r1d3l2r2u2l2r2d2l2u1d1r1u1r1u2l1u1l2d1l1d2r2l1u2d2r1d2l1u3d2r3u1l1r1u2l1d1l2d1l1u1r4d2l1u1r1u1l3r2d1l2

;46
#########
#...#   #
#.      #
# @ #$$ #
#..$  # #
# $ $$$ #
###.. $ #
  #######
Solution: r1d2u1r2u1d1l2u2r2l2r2u1r2d5l2u2d2r2u4l4u1l1d2r1d1r2u1d1l2u2r2d4r2u1l1d1l1u2l2d1r2l2u2l2d2r2u1r2d2r2u4l5u1l1d2r2d1r2u1d1l2u2r2d4r2u4l4d1l1u1l1u1r1d1r5d1l1r1d3l2u3r1u1l3d1l1u1r5d3l1d1l1u3r1u1l4d1l1u1r2d3r1l1u3r3d1r1d3l2u3r1l1r1u1l4

;47
   ####
####@ #
#   $$#
#*. *.#
#.**  #
#   $ #
# *   #
#######
Solution: r1d2l1d1u1r1u2l1d1l2d2r1d2r2u3d3l2u3d3r2u3l1r1d2l1r1u2l1d1l3d2r1l1u2r1u1r1l1d1l1d2r2l2r1l1u2r4u1l1d1r1d2l1r1u2l1u3r1d1l1d2r1d2l2r2u3d1l4d2r1l1u2r1u1r1d1l2d2r2u1d1l2u2r1u1r1d1l2d2r2u1l1d1l1u1r1u2r1d1r2d2l2u1d1r2u3d3l2u1l1u2d2r1d1r2u2l2d1l2d1r2u3l1d1r3u1l1u2d3l1d2l2u1r1u1r3d2l2r1u1d1l1u1r2l1d1u1l3d1r2u1r2u2l1d1r1d1l2d1l2u1r1u2r1l1d2r1l1u2r1d1r2u1l1r1d3l2u1l1u2d2u1d1r1d1u1l1u1d1r1d1r1u1l3d1r2u1r2u2l1d1r1d1l2r1u4r1d2l1d2l1d1l2u1r1u3r1l1d2r1u1d1l1d2r1u1r2d1l2u1l1u2r2d1u1r1d1u1l3d1r1u1l1r3d1l2r2u3l1d1r1d2l2u1l1u1r1d2r2u1l2r2u2l1d1r1d2l2d2r2u2d2l1u1r1u1l1

;48
 ######
 #... #
##  #$#
#  $  #
# *$  #
#*$ $ #
#@#. .#
#######
Solution: u1r1u2r1u2r2d2u2l2d2l1d1u1r1u2r2d2l1d1l1u1d1r1u1l3d1r1u1r2d2r1d1l1u3r1d1u1l3d1r1u1r2u2l2d1u1r2d2l2d1l2u1r2u2r2d3l2r1d2r1u3d1l2u1l2d1u1r1l1d1u1r2u2r2d3l2u1l2d1u1d1r2u3r2d3l2r1d2r1u3d1l2u1l2d1r1d1r1l1u2r1d1r2u1l2r2d3l1u2l2d1r1u1r2d2l1u1l1u4r2d4l3u1l1u1r1d1r1u1d2r2u4l3d1u1r3d4l2u3l1u1r1d3l1u2d3r3u2l1r1d1l2u2

;49
 ######
##... #
#.$ #.#
#   $ #
# $$$*#
# $ *@#
# .  ##
######
Solution: u2l2d2l1d1l1u3d2r2u2r2d2l1d1l1u1l2u2d2u2r2l2d3u1r4u1d1l4r4u2l2r2d2l4u2r2u2l1r1d2l2d2u2r1l1d3u1r4u2l2r2d2l4u2r2l2d2r4u2l2r2l2d1u1r2d2l1d1l1u1l2u2r2l2d2r4u2l2d1u1r2d2l1r1u1d1l1d1l1u1l2u2r2l2d2r4u2l2r2d2l4d1r1l1u3r1d1u1r1u2l1r1d2l2d3r1u1r2d1l1u1r2u2l2d1u1r2d2l1d1l1u1l2u2r2u2r2d2u2d2u2l2d2l1d1u1r1u2r2d2l1d1l1u1d3r1u1l1u2l2d3u3r3l3d3r1l1u3r2d2r1d1l1u3r1l3d3r1l1u2r1l1d2r1u1r2d1l1u1l2u2r3d1u1l3d2r2u1d1l2u2r1d1r2u1r1u2l3d2r1u1l1u1r1d5r1u1r1u2l1r1d2l2u3d2r1l1u1l2d2r2l1u3

;50
#######
#.. $@#
##$$$##
#  $  #
#$ *#.#
#.    #
#.* . #
#######
Solution: l3d2r1d1u1l2d1r1d1r1d1l1u3r1d1l1d2r3u3d3l2u1d1r2u3l2d2u2r2d2l1r1u2l2d1l1d2r1l1u2r1u1r2d2l1r1u2l2d1l2u1r1u2r2l2d2r1l1d3r1u1r2u2l2d1u1r2d2l2u1l2u1r2l1u2r1d1l1d2r1d2l1u4r1d1l1d2r3u2l2d1u3r1d1l1d2l1d1u1l1u1r1d1r1u1l1d3r1u1r2u2l2d1u1r2d3l1r1u3l2d1l1d1r2d1r1u1l3d1r1u3r1u2l1d1l1d3u3r1d1

