;1
   #######
   #     ##
   # $ $  #
   #  $   ######
  ##$###$##  ..#
  #       $..*.#
### #$#$#$#.#..#
#@$       $..*.#
#   #########  #
#####       ####
Solution: 9-5r2,13-6u1,13-8u1,13-5l1,11-4d1,9-7r4,14-8u3,8-5u2l2,4-3d1,3-5r2d1,6-7l1,11-5d1,12-7l1,5-5r6,13-5l1,11-4d1,9-7r4,14-8u1,9-5d1,8-7r5,3-7r9,7-5d1,6-7r5,1-7r9,8-1d3,7-5r6,4-3r3,8-2d2,6-5r6,6-2r1,8-1d3,7-5r4,4-2r3,8-1d3,7-5r3

;2
           ####
  ##########  #
  #  #@   #   ##
  # $$$$# $  $ #
  #     $ # $  #
 #####  $ #$ $ #
##...# $  # $  #
#..* ### ### ###
#.#.        $ #
#..*   ###    #
#.*..### ######
##..##
 ####
Solution: 3-8d2,2-9d1,3-6d2,4-9l2,1-10u1,9-3r2,13-8l9,3-7d2,4-10l2,11-4r1,12-5d2,13-8l9,3-7d2,4-10l1,12-2d5,13-8l9,3-7d2,14-3l1,12-2d5,13-8l8,4-7d2,14-4l1,12-3d4,13-8l8,4-7d1,3-9r1,14-5l1,12-4d3,13-8l9,3-7d1,4-9l2,11-6u2,10-3r1,12-2d5,13-8l9,3-7d1,4-9l1,9-4l1d3,9-8l5,3-9u2,4-6l1,6-6r1,8-5d2,9-8l5,3-9u2,6-4r1,7-2d3,6-6r1,8-5d2,9-8l5,3-9u1,4-7l2,4-2d1,3-4r3,7-3d2,6-6r1,8-5d2,9-8l5,3-9u1,4-7l1,9-4l1,7-3d2,6-6r1,8-5d2,9-8l5,3-9u1,6-9l2,6-2d2,4-3r2,7-2d2,6-6u1r1,8-4d3,9-8l4,4-9u2,5-4r1,7-3d2,6-6r1,8-5d2,9-8l5

;3
     ########
 #####  #  @#
 #        $ #
## ###.##.###
#  . $ $  #
#  # #.## #
## # #  # #
 # # ##.# ####
 # #  $ $ .  #
 # #.##.###$ #
 #   $    $  #
 # # #  ###  #
 #   #### ####
 #####
Solution: 6-4l2,6-10l1,4-11u1,8-4l1,6-3d1,11-10l3,7-11u3,2-4r6,9-5u1,11-2l4,6-1d1,4-8d1,5-10l1,7-8l2,4-9u4,5-4l1,9-8l4,4-7d1,2-10r4,7-11u1,11-10u1,12-8l1

;4
   ###########
####  #..... #
#     # #*#*@#
#  ##....  .##
##   #..# #.#
#  $ #.   # ###
# $ $  # # $  #
#  $$###$#$.$ #
# $ $  $      #
#  $ $   $ ####
######   ###
     #####
Solution: 11-5d1,8-8u2,9-5l1,6-8r1,8-9u1,2-9u1,3-8r3,9-1d1,10-3l2,7-2d1,11-3u1,12-1l4,11-8u6,12-1l3,13-7l1,10-6d1r1,9-8r2,10-9l2,6-8r3,10-9u1,2-5r1,3-6d1,2-8r6,5-6l1,3-5d2,4-8l1,8-5l1,6-6u2,5-3r2,8-8u2,9-5l2,6-6u1,10-8l1,8-9u1,10-6d1,11-8l1,7-3r3,11-2d4,6-5u1,5-3r1,6-3r1,8-8u2,9-5l2,6-6u1,10-8l1,8-9u1,13-8l3,7-3r3,11-2d3,10-6r1,6-5u1,5-3r3,9-4u2,8-8u2,9-5l2,6-6u2,5-3r3,9-4u1,10-8l1,8-9u2,8-7u1,9-5l2,6-6u2,5-3r5,11-4u2,12-1l1,6-9r1,8-10u3,8-7u1,9-5l2,6-6u2,5-3r5,11-4u2,4-9r3,8-10u2,8-8u2,9-5l2,6-6u2,5-3r5,11-4u1,2-9r5,8-10u3,8-7u1,9-5l2,6-6u2,5-3r2,1-8r6,8-9u3,9-5l2,6-6u1,6-5u1,5-3r1,4-6d1,3-8r4,8-9u3,9-5l2,6-6u2,4-4d3,3-8r4,8-9u3,9-5l2,6-6u1,1-7r1u1,2-6u3,1-2r3,5-1d1,3-6d1,2-8r5,8-9u3,9-5l2,11-8u4,13-6l1,11-7u2,13-7l1

;5
 #######
 #     ######
## $ $ $  #.##
# $ $ $#    .#
#  $#  #  $..#
##   #  #$####
 ###@#  $   #
   ##...#   #
    #...  ###
    #######
Solution: u1l2u1l1u1d1r1u1r2u2r2d5r1d2r2u4r2l3u1r2d1r1u1l2d5l2u2r1l1d2r2u4l1u2r1d1l1d1r2l1d2l2d2l2u1r1d1r1u1l1u1r2l1d2r2u4l1u1r3l2d3l3u5l2d2r1l1u2r2d5r1d2l2u1r1d1r1u1l1u1r2l1d2r2u4d2l3u3l2u1r1u1r1d6l1d1r2u2r2u2l1u2l2u1l1d1l1d1r1u1r1d4r1d1l1u3l1u1l3d2r1u1l1u1r3u1r1d5r1d1l1u3d1r3d2u1d1l1r1u4l1u2r1d3u2l1u1l2d3r1d1r2d1r2u1l3r1u3l1u1l2d3r1d1,3-1d1r1d1l1d1l2u1r4u1r1d5u5l1u1l3d1r1d2l2u1r4u1r1d4

;6
#########
#@$.*   #
# $ . # #
# $* *  #
#.$.. $ #
#########
Solution: 1-4u2r2u1r2d1l1d2r1u1l1d1l2u1l1u2r1l1d2r1l1u2r1d1r1d1u1l2d1u1r2d1r4u2l2d1u1r2d2l1r1d1l2u1l2u1l2d1r4d1r2u1l3r3u2l2d1

;7
 ###########
##    #    ##
# $ *...* $ #
#@ $ *#* $  #
# $ *...* $ #
##    #    ##
 ###########
Solution: u1r1u1r3d2l2r2u1r2u1r2d1u1l2d1l2u1l3d1l1d1r3l1d2l1u1l1u2r1u1r1d1u1r2d1l1u1l2d1r1d1u2r2d1l1r3u1d1l3u1l1d1u1d1r4u1r2d1l5r5u1r1d1r1d2l1d1l2u2d2r2u1r1u2l2u1l2d2r1d1l1d1r3u1l2r3u2l2d1u1r2d2l2r2u1l3r1u2l2d1l3u1l2d1r4l5d2r1u1l1u1r4l1d1l1u1l2d2r1u1l1u1r3l2d3r1u2l1u1r1

;8
    ####
    #  #
    #  #
#####.$#####
#@  $. *   #
#   * .$   #
#####$.#####
    #  #
    #  #
    ####
Solution: d1r4u1r3l5r2d2u2r1u1l1d3r1u1d3l1u2r1u1l1u2r1d3u2r2d1l2d1l1u1d3r1u2l1u1r1u2l1u2r1d4l1u2d1r1d2u2r2d1l1r1u1l3d2r1u1r4u1l2d1l3u2r1d1l1d4r1u1l1u4r1u2l1d1r1d2l3d1l2u1r3

;9
#######
#. * .#
# $$  #
#.$@$.#
#  $$ #
#. * .#
#######
Solution: r1l2r2l2d2r2u1l1u1l1d1r3u2l1d1l2r2u2l2d1u1r2d2l1u1d3r1u1l1u1r1d1l3d1r1u1r1u2l1r1d2u2l2d2r2u1l1

;10
 #######
##.   .##
# $* *$ #
#   *   #
# $* *$ #
##. @ .##
 #######
Solution: u2r2u1d2u1l4d1u1d1u1r2u1r1u1l2r1d3l1u1r1u2l1d2l2u1r2d1r1d2l1u2l2d1r1u1r3u2l1d1r1d1r2u1l1

;11
#######
#    .#
# $#$ #
# .$. #
#.$#$.#
# .$. #
# $#$ #
#.   @#
#######
Solution: undefined

;12
 #######
##  .  ##
# .$@$. #
# $.$.$ #
#. $ $ .#
# $.$.$ #
# .$ $. #
##  .  ##
 #######
Solution: d1l2r4l1u1r1u1l1d1l1d1r2d1r1d1u1l1d1l1d1u1r2d1l1d1l2u1r1l1r1u1r1u2l4d1l1d2r1d1r1l1u1l1u2r1l1r1l1d2r1d1r2l2u1l1u2r1d1l1r1u2r4l4u1l1d1r3u1l1r4d1l1d2l1u2l1u1r1l1d1l2d2r1u1r1u1r2d2l1u1d2l1r1u2l2d1r1d1u2r2l2d3l1u1r1u2r2d1r1d1l1d1l1r1u3l2d2r1

;13
 #######
##  . @##
#  .$.  #
# *$$$* #
#.  #  .#
# *$$$* #
#  .$.  #
##  .  ##
 #######
Solution: d1r1d2l2u2d1u1d2u1d1r2d2l1d1l4u1l1u2r1l1u2r3l3d2r2u1l1u1l1r1d2l1d2r1d1r4u1r1u2l2u1l1r1l2r1u2l2d1l1d1u1r1u1r2d2r1d2u2l2d2u2r2d2r1d1r1l1u2l1u1l2d2r1d1r1d1u1l1u1l1u2r2d1r2u2l1u1l1r1d1r1d2l2u1l2d2r1d1r1d1r1u1r1u1d1l3u1l1u2r2d2

;14
  #####
 ##   ##
##. $  ##
#  #$#$ #
# #. .  #
#  .@.# #
# $#$#  #
##  $ .##
 ##   ##
  #####
Solution: undefined

;15
     ####
   ### @###
#### .  . ####
# $ $$  $$ $ #
#.  . ## .  .#
# #*######*# #
#.  . ## .  .#
# $ $$  $$ $ #
#### .  . ####
   ###  ###
     ####
Solution: undefined

;16
 #####
 # . #
## $ ##
# $ $ #
#..*..#
# $ $ #
## $ ##
 #@. #
 #####
Solution: undefined

