;1
#########################
#  .     .       .$.    #
# .$.$$$.$. #.$  $.$  $.#
#.$$$.*.$$$.#$.*** ***.$#
# .$.$$$.$. #.$  $.$  $.#
#  .     .       .$.    #
# ##########@########## #
#  $.   .$    $       . #
#  * .$. *  # .**   **$ #
#  $.$*$.$  # *  ***  * #
#  * .$. *  # $**   **. #
#  $.   .$    .       $ #
#########################
Solution: d1l3r1d4l1r2u4r1u2l11d6r2l1u2r1l2u4r11d2l4d3l1d1l2u2l2r2d2r2u1d1l2u1l2r2d1r2u1l1r2u2l1d1r1u2r4u2l11d6r2u2r1u2r3d2r2l2u2l3d3l1d1l2u6r11d2l2d2l3u2l3d2u2l1r2l1d2r5l3r1u2l2d1r1l2d2l1d1l2u3r3u1r2d2l1r1u2l3d1l2u3r11d2l1d2l4r4d2l1u1r1u1l2r2u2r1u2l11d2r2l2d2r1l1d2r2u2l2d1r1u3l1u2r11d2r1l1u2r3l3d2r5d1r2u1r4d4l4u2d2r4u3d1l1r1u2l1d2r1d2l4u2r2l2d2r4u4l4d1l2u1l5r5d1r2u1r4d4l4u1l2u1d2l4u2r1l1d2r3l2u2d2r3u2l2r2d2l8r4u4r4d1u1r4l8d4r4u1r2d1l4r8u6l6r6d2l4r4u2l9r8u1d1r1d2l4d1l2u1l5u2l1u4r6l6d4r1d2r5d1r2u1r4u3l3d1l2u3r1u1r4d2u2l2d1r1u1l3d1r1l3u1r1d1r2u1d1l1r1u1l7r5d4r2u1l1d1l1u3l1u1r1d1r2d2u3r2d1l1u1l1d1l3u1l2d1r5l2d3l2u1r1d1r2u1r3d1r1d2l4d1l2u1l5u2r1u2d2l1d2r5d1r2u1r4u2l2u1l2d1l4u1l1r4u3l4d1r4u1l8r1d4r5l4d2r5d1r2u1r4u2l2u1l5r5d1l1u1l2u2r2u1r2d1l5u1l2d1r2l3u1l3d4r3u1r3l3d1l2d2r9l9u2l11u4r15l8d3r2d1r1u1l3u3r2d2u2d2u2l2d1r1l1d2r1u2l1u1l7d4r7l6u2d2r2u2l1r4l3d2u2l2r1u1d1r1d1l1u1r3l2d2r4u1r1u2l1r1d1l5r4u2l4d1l1d2r1l1u1r4l3d2r4u2d2l2u1r1l2u1l1u2r4d1r1d1u1l1u1l3r3d1r1d2l2r1u1d2l3u2l1u2r1l1d2r1d1r2l2u1l1u2r3d1u1l2d1u1r2d1l2

;2
#########################
#   .   .         .     #
# $$*$$$*$$ # .$ $$$.$. #
#.....*.....#*$.$...*.$*#
# $$*$$$*$$ # .$.$$$ $. #
#   .   .         .     #
# ##########@########## #
#  .  .  .     . . . .  #
# $$* $$* $ # $.$.$.$.$ #
#.*.* * *.*.#*$$$ * $$$*#
# $ *$$ *$$ # $.$.$.$.$ #
#  .  .  .     . . . .  #
#########################
Solution: undefined

;3
###########################
#  $.   .$      $       . #
#  * .$. *   #  .**   **$ #
#  $.$*$.$   #  *  ***  * #
#  * .$. *   #  $**   **. #
#  $.   .$      .       $ #
# ###########@########### #
#                         #
#$.$  .$.$.$.#**.**$$$*.**#
#.$.$.$.$.$.$#  $. ..$.$  #
#$.$.$.$.$.$.#  $.$.. .$  #
#.$.$.$.  $.$#**.*$$$**.**#
#                         #
###########################
Solution: undefined

;4
###########################
#                         #
#$.$  .$.$.$.#**.**$$$*.**#
#.$.$.$.$.$.$#  $. ..$.$  #
#$.$.$.$.$.$.#  $.$.. .$  #
#.$.$.$.  $.$#**.*$$$**.**#
#                         #
# ###########@########### #
#   ..  ..     . $ .$ . $ #
# $*$*$$$$*$ #  . .$.$ $  #
# *. .. .$.$ #$.$.$  .$.$.#
# $.$. .. .* #.$.$.  $.$.$#
# $*$$$$*$*$ #  $ $.$. .  #
#   ..  ..     $ . $. $ . #
###########################
Solution: undefined

;5
###########################
#   ..  ..     . $ .$ . $ #
# $*$*$$$$*$ #  . .$.$ $  #
# *. .. .$.$ #$.$.$  .$.$.#
# $.$. .. .* #.$.$.  $.$.$#
# $*$$$$*$*$ #  $ $.$. .  #
#   ..  ..     $ . $. $ . #
# ###########@########### #
#   .   .           .     #
# $$*$$$*$$  #  .$ $$$.$. #
#.....*..... # *$.$...*.$*#
# $$*$$$*$$  #  .$.$$$ $. #
#   .   .           .     #
###########################
Solution: undefined

;6
#########################
#  .  .  .     . . . .  #
# $$* $$* $ # $.$.$.$.$ #
#.*.* * *.*.#*$$$ * $$$*#
# $ *$$ *$$ # $.$.$.$.$ #
#  .  .  .     . . . .  #
# ##########@########## #
#  .     .       .$.    #
# .$.$$$.$. #.$  $.$  $.#
#.$$$.*.$$$.#$.*** ***.$#
# .$.$$$.$. #.$  $.$  $.#
#  .     .       .$.    #
#########################
Solution: undefined

;7
###########################
#  .     .         .$.    #
# .$.$$$.$.  # .$  $.$  $.#
#.$$$.*.$$$. # $.*** ***.$#
# .$.$$$.$.  # .$  $.$  $.#
#  .     .         .$.    #
# ###########@########### #
#                         #
#$.$  .$.$.$.#**.**$$$*.**#
#.$.$.$.$.$.$#  $. ..$.$  #
#$.$.$.$.$.$.#  $.$.. .$  #
#.$.$.$.  $.$#**.*$$$**.**#
#                         #
###########################
Solution: undefined

;8
###########################
#  .     .         .$.    #
# .$.$$$.$.  # .$  $.$  $.#
#.$$$.*.$$$. # $.*** ***.$#
# .$.$$$.$.  # .$  $.$  $.#
#  .     .         .$.    #
# ###########@########### #
#   ..  ..     . $ .$ . $ #
# $*$*$$$$*$ #  . .$.$ $  #
# *. .. .$.$ #$.$.$  .$.$.#
# $.$. .. .* #.$.$.  $.$.$#
# $*$$$$*$*$ #  $ $.$. .  #
#   ..  ..     $ . $. $ . #
###########################
Solution: undefined

;9
#########################
#  .     .       .$.    #
# .$.$$$.$. #.$  $.$  $.#
#.$$$.*.$$$.#$.*** ***.$#
# .$.$$$.$. #.$  $.$  $.#
#  .     .       .$.    #
# ##########@########## #
#   .   .         .     #
# $$*$$$*$$ # .$ $$$.$. #
#.....*.....#*$.$...*.$*#
# $$*$$$*$$ # .$.$$$ $. #
#   .   .         .     #
#########################
Solution: undefined

;10
#########################
#  .     .       .$.    #
# .$.$$$.$. #.$  $.$  $.#
#.$$$.*.$$$.#$.*** ***.$#
# .$.$$$.$. #.$  $.$  $.#
#  .     .       .$.    #
# ##########@########## #
#  .  .  .     . . . .  #
# $$* $$* $ # $.$.$.$.$ #
#.*.* * *.*.#*$$$ * $$$*#
# $ *$$ *$$ # $.$.$.$.$ #
#  .  .  .     . . . .  #
#########################
Solution: undefined

;11
###########################
#  $.   .$      $       . #
#  * .$. *  ### .**   **$ #
#  $.$*$.$  ### *  ***  * #
#  * .$. *  ### $**   **. #
#  $.   .$      .       $ #
# ###########@########### #
#   ..  ..     . $ .$ . $ #
# $*$*$$$$*$ #  . .$.$ $  #
# *. .. .$.$ #$.$.$  .$.$.#
# $.$. .. .* #.$.$.  $.$.$#
# $*$$$$*$*$ #  $ $.$. .  #
#   ..  ..     $ . $. $ . #
###########################
Solution: undefined

;12
#########################
#  $.   .$    $       . #
#  * .$. *  # .**   **$ #
#  $.$*$.$  # *  ***  * #
#  * .$. *  # $**   **. #
#  $.   .$    .       $ #
# ##########@########## #
#   .   .         .     #
# $$*$$$*$$ # .$ $$$.$. #
#.....*.....#*$.$...*.$*#
# $$*$$$*$$ # .$.$$$ $. #
#   .   .         .     #
#########################
Solution: undefined

;13
#########################
#  $.   .$    $       . #
#  * .$. *  # .**   **$ #
#  $.$*$.$  # *  ***  * #
#  * .$. *  # $**   **. #
#  $.   .$    .       $ #
# ##########@########## #
#  .  .  .     . . . .  #
# $$* $$* $ # $.$.$.$.$ #
#.*.* * *.*.#*$$$ * $$$*#
# $ *$$ *$$ # $.$.$.$.$ #
#  .  .  .     . . . .  #
#########################
Solution: undefined

;14
###########################
#                         #
#$.$  .$.$.$.#**.**$$$*.**#
#.$.$.$.$.$.$#  $. ..$.$  #
#$.$.$.$.$.$.#  $.$.. .$  #
#.$.$.$.  $.$#**.*$$$**.**#
#                         #
# ###########@########### #
#   .   .           .     #
# $$*$$$*$$  #  .$ $$$.$. #
#.....*..... # *$.$...*.$*#
# $$*$$$*$$  #  .$.$$$ $. #
#   .   .           .     #
###########################
Solution: undefined

;15
###########################
#                         #
#$.$  .$.$.$.#**.**$$$*.**#
#.$.$.$.$.$.$#  $. ..$.$  #
#$.$.$.$.$.$.#  $.$.. .$  #
#.$.$.$.  $.$#**.*$$$**.**#
#                         #
# ###########@########### #
#  .  .  .       . . . .  #
# $$* $$* $  #  $.$.$.$.$ #
#.*.* * *.*. # *$$$ * $$$*#
# $ *$$ *$$  #  $.$.$.$.$ #
#  .  .  .       . . . .  #
###########################
Solution: undefined

;16
###########################
#   ..  ..     . $ .$ . $ #
# $*$*$$$$*$ #  . .$.$ $  #
# *. .. .$.$ #$.$.$  .$.$.#
# $.$. .. .* #.$.$.  $.$.$#
# $*$$$$*$*$ #  $ $.$. .  #
#   ..  ..     $ . $. $ . #
# ###########@########### #
#  .  .  .       . . . .  #
# $$* $$* $  #  $.$.$.$.$ #
#.*.* * *.*. # *$$$ * $$$*#
# $ *$$ *$$  #  $.$.$.$.$ #
#  .  .  .       . . . .  #
###########################
Solution: undefined

;17
#########################
#  $.   .$    $       . #
#  * .$. *  # .**   **$ #
#  $.$*$.$  # *  ***  * #
#  * .$. *  # $**   **. #
#  $.   .$    .       $ #
# ##########@########## #
#  .     .       .$.    #
# .$.$$$.$. #.$  $.$  $.#
#.$$$.*.$$$.#$.*** ***.$#
# .$.$$$.$. #.$  $.$  $.#
#  .     .  #    .$.    #
#########################
Solution: undefined

;18
###########################
#                         #
#$.$  .$.$.$.#**.**$$$*.**#
#.$.$.$.$.$.$#  $. ..$.$  #
#$.$.$.$.$.$.#  $.$.. .$  #
#.$.$.$.  $.$#**.*$$$**.**#
#                         #
# ###########@########### #
#  .     .         .$.    #
# .$.$$$.$.  # .$  $.$  $.#
#.$$$.*.$$$. # $.*** ***.$#
# .$.$$$.$.  # .$  $.$  $.#
#  .     .         .$.    #
###########################
Solution: undefined

;19
###########################
#                         #
#$.$  .$.$.$.#**.**$$$*.**#
#.$.$.$.$.$.$#  $. ..$.$  #
#$.$.$.$.$.$.#  $.$.. .$  #
#.$.$.$.  $.$#**.*$$$**.**#
#                         #
# ###########@########### #
#  $.   .$      $       . #
#  * .$. *  ### .**   **$ #
#  $.$*$.$  ### *  ***  * #
#  * .$. *  ### $**   **. #
#  $.   .$      .       $ #
###########################
Solution: undefined

;20
###########################
#   ..  ..     . $ .$ . $ #
# $*$*$$$$*$ #  . .$.$ $  #
# *. .. .$.$ #$.$.$  .$.$.#
# $.$. .. .* #.$.$.  $.$.$#
# $*$$$$*$*$ #  $ $.$. .  #
#   ..  ..     $ . $. $ . #
#############@########### #
#  .     .         .$.    #
# .$.$$$.$.  # .$  $.$  $.#
#.$$$.*.$$$. # $.*** ***.$#
# .$.$$$.$.  # .$  $.$  $.#
#  .     .         .$.    #
###########################
Solution: undefined

;21
###########################
#   ..  ..     . $ .$ . $ #
# $*$*$$$$*$ #  . .$.$ $  #
# *. .. .$.$ #$.$.$  .$.$.#
# $.$. .. .* #.$.$.  $.$.$#
# $*$$$$*$*$ #  $ $.$. .  #
#   ..  ..     $ . $. $ . #
# ###########@########### #
#  $.   .$      $       . #
#  * .$. *  ### .**   **$ #
#  $.$*$.$  ### *  ***  * #
#  * .$. *  ### $**   **. #
#  $.   .$      .       $ #
###########################
Solution: undefined

;22
###########################
#   ..  ..     . $ .$ . $ #
# $*$*$$$$*$ #  . .$.$ $  #
# *. .. .$.$ #$.$.$  .$.$.#
# $.$. .. .* #.$.$.  $.$.$#
# $*$$$$*$*$ #  $ $.$. .  #
#   ..  ..     $ . $. $ . #
# ###########@########### #
#                         #
#$.$  .$.$.$.#**.**$$$*.**#
#.$.$.$.$.$.$#  $. ..$.$  #
#$.$.$.$.$.$.#  $.$.. .$  #
#.$.$.$.  $.$#**.*$$$**.**#
#                         #
###########################
Solution: undefined

;23
#########################
#   .   .         .     #
# $$*$$$*$$ # .$ $$$.$. #
#.....*.....#*$.$...*.$*#
# $$*$$$*$$ # .$.$$$ $. #
#   .   .         .     #
# ##########@########## #
#  .     .       .$.    #
# .$.$$$.$. #.$  $.$  $.#
#.$$$.*.$$$.#$.*** ***.$#
# .$.$$$.$. #.$  $.$  $.#
#  .     .       .$.    #
#########################
Solution: undefined

;24
#########################
#   .   .         .     #
# $$*$$$*$$ # .$ $$$.$. #
#.....*.....#*$.$...*.$*#
# $$*$$$*$$ # .$.$$$ $. #
#   .   .         .     #
# ##########@########## #
#  $.   .$    $       . #
#  * .$. *  # .**   **$ #
#  $.$*$.$  # *  ***  * #
#  * .$. *  # $**   **. #
#  $.   .$    .       $ #
#########################
Solution: undefined

;25
###########################
#   .   .           .     #
# $$*$$$*$$  #  .$ $$$.$. #
#.....*..... # *$.$...*.$*#
# $$*$$$*$$  #  .$.$$$ $. #
#   .   .           .     #
# ###########@########### #
#                         #
#$.$  .$.$.$.#**.**$$$*.**#
#.$.$.$.$.$.$#  $. ..$.$  #
#$.$.$.$.$.$.#  $.$.. .$  #
#.$.$.$.  $.$#**.*$$$**.**#
#                         #
###########################
Solution: undefined

;26
###########################
#   .   .           .     #
# $$*$$$*$$  #  .$ $$$.$. #
#.....*..... # *$.$...*.$*#
# $$*$$$*$$  #  .$.$$$ $. #
#   .   .           .     #
# ###########@########### #
#   ..  ..     . $ .$ . $ #
# $*$*$$$$*$ #  . .$.$ $  #
# *. .. .$.$ #$.$.$  .$.$.#
# $.$. .. .* #.$.$.  $.$.$#
# $*$$$$*$*$ #  $ $.$. .  #
#   ..  ..     $ . $. $ . #
###########################
Solution: undefined

;27
#########################
#  .  .  .     . . . .  #
# $$* $$* $ # $.$.$.$.$ #
#.*.* * *.*.#*$$$ * $$$*#
# $ *$$ *$$ # $.$.$.$.$ #
#  .  .  .     . . . .  #
# ##########@########## #
#  $.   .$    $       . #
#  * .$. *  # .**   **$ #
#  $.$*$.$  # *  ***  * #
#  * .$. *  # $**   **. #
#  $.   .$    .       $ #
#########################
Solution: undefined

;28
###########################
#  .  .  .       . . . .  #
# $$* $$* $  #  $.$.$.$.$ #
#.*.* * *.*. # *$$$ * $$$*#
# $ *$$ *$$  #  $.$.$.$.$ #
#  .  .  .       . . . .  #
# ###########@########### #
#                         #
#$.$  .$.$.$.#**.**$$$*.**#
#.$.$.$.$.$.$#  $. ..$.$  #
#$.$.$.$.$.$.#  $.$.. .$  #
#.$.$.$.  $.$#**.*$$$**.**#
#                         #
###########################
Solution: undefined

;29
###########################
#  .  .  .       . . . .  #
# $$* $$* $  #  $.$.$.$.$ #
#.*.* * *.*. # *$$$ * $$$*#
# $ *$$ *$$  #  $.$.$.$.$ #
#  .  .  .       . . . .  #
# ###########@########### #
#   ..  ..     . $ .$ . $ #
# $*$*$$$$*$ #  . .$.$ $  #
# *. .. .$.$ #$.$.$  .$.$.#
# $.$. .. .* #.$.$.  $.$.$#
# $*$$$$*$*$ #  $ $.$. .  #
#   ..  ..     $ . $. $ . #
###########################
Solution: undefined

;30
#########################
#  .  .  .     . . . .  #
# $$* $$* $ # $.$.$.$.$ #
#.*.* * *.*.#*$$$ * $$$*#
# $ *$$ *$$ # $.$.$.$.$ #
#  .  .  .     . . . .  #
# ##########@########## #
#   .   .         .     #
# $$*$$$*$$ # .$ $$$.$. #
#.....*.....#*$.$...*.$*#
# $$*$$$*$$ # .$.$$$ $. #
#   .   .         .     #
#########################
Solution: undefined


