;1
   #####
####   #
#    # #
# $*.  #
#  *@###
##$*.#
 #   #
 #####
Solution: 2-4u1r2,2-6u2r1,4-3d1,6-3l2,1-2r2,4-1d1,2-2d1,1-4r1

;2
 ######
 #  * ##
## .$.@#
# *$ $*#
#  .$. #
#   *  #
########
Solution: d1l1,5-2l2,5-4l2,6-5u1,3-5r1,3-2d1r1,5-4u1,1-3r2,4-2d1,6-5l3u1r1,3-2d1,1-5r2,3-5u1,2-1d1,3-4u1,1-4r1

;3
  ####
  #  ###
###@$  ##
#  .*.  #
# # $*$ #
#    .###
#######
Solution: 5-5u2l2,7-4l1,5-3d1l1,4-1d1,3-3r1,6-2l1d1,4-1d1,3-3r1,1-3r2,3-5u1

;4
  #####
###   ###
# $**.  #
#@$  .# #
# $ #.  #
###   ###
  #####
Solution: r3,3-1d1,4-1d1,5-4u1,3-4u1r1u1r1,5-4u1,3-1d2,1-2r2,3-5u1,4-3l1,1-4r1,3-5u1,4-1d1u1r1d1,7-2l2d1,3-2r1,3-4u1r1,2-2r1,2-4u1l1u1r1

;5
   ######
  ## .  #
###  *  #
# $**$  #
#@*  # ##
##.#   #
 #   ###
 #####
Solution: r1,4-4u1r1,6-4u1,4-1d1,2-4r1,3-2d1r1,4-5u2,1-3r1,4-4l1,4-1d1,3-2d1,2-3d1,4-4l1,4-4u1,6-3l2,4-1d1,6-3u1,7-1l1

;6
########
#   #@ #
# .$.$ #
# .$.$ #
##.$.$ #
 #  ####
 #  #
 ####
Solution: 6-2l1,6-4l1u1,4-3l1d1,2-4u1,3-4r1,3-6u1,4-4l1,2-3d1,3-1d1,4-3l1,2-6u1,6-4l1,5-1d1,6-3l1

;7
#####
#   ####
#      #
#.*$*  #
# @#  ##
#.*$* #
#  #  #
#######
Solution: u1,2-6u1,4-4u1,4-6u1l2u1,3-2r1,4-3d1,3-2l1d2,1-1d1,6-2l3,1-2r1,2-3r2,3-1d1,4-3l1,6-3l1

;8
 #####
## .@#
# .*$###
#.*$   #
#*$  # #
#  ### #
#      #
#  #####
####
Solution: 1-3d2,1-4r1,2-2d1,4-3l2d1,1-7u2,2-4d1,4-1d1,3-3u1,2-7u4,5-3l1,4-4l1u1,2-5u1

;9
#####
#   ###
#     #
##**$ ##
#  .*  #
# # ** #
#  @  ##
#######
Solution: 3-4u1r1,5-6u1,4-2l1,5-5l1u1,6-4l3,5-2d2,1-4r2,6-5l1,3-4r1,5-3d1,3-6u1,2-4r1,5-4l1,4-2d1,1-2r1,3-1d1

;10
 #######
 #  *  #
 # *.* #
 #  *  #
## *  ##
# *$*  #
# @*   #
###  ###
  ####
Solution: r2u1,6-6l2,5-1d1,4-2l1,5-2d1,2-4d1r2,3-3r1,3-1r1,3-5u2,3-7u2,1-6r1,2-1d4,6-3l2,4-5u2,4-1d2,2-3r2,6-1l2,2-2r2,6-3l2,2-3r2,3-5u1,3-4u1,3-7u2,1-6r1,4-6l1,4-3d2,6-3l2,2-3r1,4-4u1,4-7u2,4-3d1l1,4-6u1,6-5l1,5-3d2,3-4r1,4-6u1,6-6l1,3-6r1,1-6r1,2-1r2,4-6l1,3-1d4,2-5u2,3-7u2,1-6r2,2-1d4,6-1l2d1,5-3l1,4-5u2,5-1d1l1,4-7u2,2-2r2,6-6l1,4-5u1,4-2d1,4-3l1,6-3l1d2,2-2d1,3-5u2,2-2r1,2-1r1,5-4l1,3-5u2,4-7u1,4-6u1,6-6l1,4-7u1,1-6r1,2-3d1,3-5r1,6-5l1,5-4l1

;11
######
#    ###
#  #.  #
#  $*$ #
# .*.# #
###$ @ #
  #  ###
  ####
Solution: 4-2d1l1,2-4u1,4-5u1l1,3-6u2,4-2d1l1,4-3d1,3-5r1,6-3l1,4-2d1,1-3r3,4-5u1,6-5l1,4-4u1,4-6u1,6-3l1,1-4r1,2-1d2

;12
   ####
####  ##
#  ... #
# $.$. #
##$$$ ##
 # @  #
 ######
Solution: u1r1u1,4-1d1,3-2d1r1,1-3r1,2-5u2r1,4-2d1,6-3l1,5-5u2,3-3r1,4-5u2,1-2r1,3-5u1

;13
   #####
 ###   ##
##  .#  #
#  #* # #
# $*@*$ #
#  #*   #
##  .   #
 ########
Solution: d1,3-6r2,4-2d1,5-3d1,4-5r1,7-4l1,5-3d1,4-5u2,7-6l3,4-1d3,2-5u1r3,2-2d1,1-4r1,4-6u3,7-4l2,4-3d1,4-1d1,2-6r3,2-4r2,4-4r1,7-6l3,7-4l3,2-6r3,4-4l1,2-5u1,4-2d1,2-2d1,2-5u1,3-4r2,2-2d1,1-4r1,4-6u2,7-6l2,4-2d2,4-4l1,7-4l2,5-6u1,3-6r1,4-6r1,5-3d1,2-5u1,3-4r2,2-2d1,4-6u2,7-4l3,5-6u1,4-4r1,4-2d1,7-4l1,5-3d1,4-5u2,7-6l3,5-6u1,6-4l1,4-3d1,4-1d1,2-6r2,4-6r1,4-4u1,4-6u2,7-5l2,2-3d1r3,2-6u1,1-4r1,7-6l2,7-4l1

;14
#####
#   #####
# #  *  #
# # .*@ #
# #**$ ##
#    ###
###  #
  #  #
  ####
Solution: 6-2l2,3-3d1,3-4d1,3-1d2,4-5u1,6-4l1,5-2d1,3-3r2,4-5u2,3-7u1,2-5r1,4-6u1,3-3d2,3-7u1,4-5l1,4-3d2,7-3l1,6-4l1,5-2d1,4-5u1,4-7u2,3-3r2,1-5r1,3-4d1,3-7u2,4-3d2,7-3l1,6-4l1,5-2d1,3-2r2,4-5u1,6-4l1,3-3r1,4-5u1,7-2l1,4-7u2

;15
  ####
  #  ####
###     #
#    ## #
# #.. # #
# ##* # #
#   *$$ #
#### @###
   ####
Solution: u1l1u2,7-6l2,4-7u1,2-6r3,5-4d1,4-6u1,5-4l1,5-7u1,7-6l2,5-6l1,5-4d1,4-4u1,4-1d2,6-6l1,4-7u1,2-6r1

;16
 #####
##   ###
#      ##
# # ##  #
#..*  # #
#  *  # #
###*$$  #
  #@ ####
  ####
Solution: 4-7u1r1,4-6u1l1u2,4-2l1,3-7u3,1-2r1,7-6l2,5-6l1,1-5r2,5-4l3,2-2r1d1,3-3d1,4-6u1,5-4l2,5-2l1,3-1d2

;17
 ####
 #  #
 #  ###
##.   #
#. *# #
# *@$ #
## $ ##
 ##  #
  ####
Solution: u2,1-5r1,2-6r1u1,5-5l2,2-6u1,3-3d1l1,4-5l1,4-7u1,5-5l1,3-4d1,3-1d2,3-5u1,4-3l1,3-7u2

;18
   ####
####  #
#  #$ ###
#   $   #
#  .*.. #
## *$ ###
 ## @##
  ####
Solution: 3-6u1,3-3r2,4-1d1,5-3l1,5-5l1u1l1,3-6u1,2-5u1,4-2d1,7-3l1,5-4u1,2-2d1r1d1r2,5-3l1,5-1d1,5-2d1,3-6u1,2-5u1,2-2d1r1d1,4-4u1,4-1d2,1-4r1

;19
    #####
 ####   #
 #      #
 # # # ##
##.$ $.#
# .$#$.#
# @ #  #
#  #####
####
Solution: 4-4l1,2-3d2,6-4l2,5-6u1,4-4r1,6-5u2,2-4r3,6-5u1,2-7u1r1u1,2-6u2r2,2-2d2,7-2l1d2l3,4-2r1u1r1d2

;20
####
#  ####
#  $. #
#  $. #
#  $. #
###$.##
  #@ #
  ####
Solution: 4-4l1,4-2l1,3-4u1,2-1d1,1-3r2,4-2l1,3-6u3,4-2d2,1-4r2,2-1d1r1,1-3r2

;21
  ####
  #  ###
###    #
#  *.# #
#  $*  #
### @###
  #  #
  ####
Solution: u1l1u1,4-2d2,1-4r3,3-1d1r1d1l1,4-6u2,6-4l1,1-3r1

;22
  #####
  # @ #
###$ $###
#  $ $  #
# #* *# #
#  .#.  #
## . . ##
 ##   ##
  #####
Solution: 4-3r1d2,4-3l1d2,2-6r1,5-7u1,5-6u1,3-6r1d1r1u1,3-1d4l1d1r1,7-3l2,4-4u1,5-1d1,6-3l1,3-6r1,5-3l1,3-2d3,1-3r1,3-2d2u3r2d1l1u1l1d2

;23
#######
#  #  #
#  $  #
# .*. #
# $*$ #
## .@##
 #####
Solution: u2,2-5u2,4-3l1d1,1-3r1,2-1d2r1,5-3l1,4-1d1l1,3-4u1,4-4u1,1-4r2,2-1d1,4-1d1l1,1-3r1,2-1d1,5-4l1

;24
####
#  #####
# $$   #
#@.*$  #
## .*  #
 ###.###
   ###
Solution: 3-4r1,2-1d1r2d2,2-4u1,3-2d1r3d1l1,6-2l2,2-1d1l1d1r3u1l1,2-1d1,6-3l2

;25
  ####
  #  ##
 ##.$.###
## $.$  #
#  .$.  #
#  $+$ ##
###.$ ##
  ##  #
   ####
Solution: l1,3-4r2u1,2-3r1,3-6r1,1-5r1,3-4d1,7-4l1,6-4l2,3-3r2,4-1d2,3-5u2,5-4l1,6-5l2,5-7u2,2-5r1,4-4d1,7-3l2,4-7u1

;26
#######
#  .  #
# $*$ #
#@. .##
# $*$ #
## .  #
 #  ###
 ####
Solution: 4-3u1,3-1d1,4-3l1,4-3d1,5-5l2u1,1-4r2u1,5-1l1,4-3d1,1-3r2,2-6u1,5-5l1,1-4r1,2-1d1

;27
######
#    #
# ## ##
# # . ##
# #$.$@#
#  $.$ #
##  .###
 #   #
 #####
Solution: 6-4l1u1l1d2l1,3-3d2,1-5r1,4-7u3,2-6r1,4-2d1l1d2,4-5u1,4-2d1,6-5l2,3-4r1,4-7u3,6-4l1,2-5r1l1d1r1

;28
 #######
##     #
#@*.*  #
# $ $###
# *.* #
##    #
 #   ##
 #####
Solution: r1,3-1d3,3-2r1,1-4r1u1,4-5l1,2-6u2,1-2r1,4-2l1,3-3d1,5-4l1,1-2r1,4-2d1,6-2l1,2-4u1,4-5l1,2-6u1

;29
 #######
 #  #  #
## *$  ##
# .*@*. #
#  #$*  #
#  #  ###
##    #
 ######
Solution: d1r1u1d3l3u3r1l1u2r1d1l1d4r3u3r1u2l1d1l2u1l1d2l1d2r1d1r3u2l1u1d1r1u1r1u2l1d1l1d2r1u1l1u1r1d1r2d1u1l2d3l1u2r1u1r2d1l1u1l1d1u3r1d1l1d2l1d2u2r2u1d1l2u1d3l2u1l1u2r4l3u2r1d1l1d1l1d2r1d1r2u2r1u2l1d2r3u1l1d1l2u2r1u1r1d1l2d4r1u1d1l3u2

;30
    #####
 ####   #
 #      #
## #$.# #
#   *** #
#   #.$##
#####@ #
    #  #
    ####
Solution: 5-5u2,5-4l2,1-4r1,4-2r1,7-4l1d1,6-7u2,5-5u1,4-4l1,1-4r1,5-2d2,2-4r2,4-2d1,7-2l1,5-1d1


;1
#####
#   ###
#  $@ #
#.**. #
# $  ##
##  ##
 #  #
 ####
Solution: l1u1l2d3r1l1u2r1l1d2r1u1r1d1l2u3r2d1u1l1d1l1d2r3u1r1u1l3u1l1d1r3d2l2u1r1u2l1d1r1d2l1d2r1u2

;2
####
#  # #####
#  ###   #
# $$+$$  #
# ..$.. ##
####  ###
   #  #
   ####
Solution: d1l2u1d1r2u1l1r1d1r3u2l1d1l1d1l2u1r3l3d1l2u1r2l2u2r1d2r1d1r2d2l1u1r1u1l1r1u1r1u1r2d1l1d1l1r1u2l1d1

;3
 #####
##   #
#  . #
# $.$###
##$.$  #
 # .@  #
 #######
Solution: l1u1r1u1l1u1l2d1r1u1r1d1r1d2l2u2l1u1r1d3r1u1d1r3u1l2d1l2u4r2d3r1d1l1

;4
  #####
### @ #
#  $.$##
#  $*$ #
###.*. #
  # .  #
  #  ###
  ####
Solution: d1l1d2r1u1d2r2u2l1r1d2l2u1l1u1r1d2r2u2l1d1l2u3r2d2u2d2u2l2d1r1l1d2r1u1d3l1u1r1u2r2d2l1r1u1l1u1l2u2r1d1u1r1d2u1l2d1l2u1r2

;5
  #####
  #   #
###.*$##
#  .$  #
# #.$@ #
#  .$###
###  #
  #  #
  ####
Solution: u1l2d1r1d1u2r2d1l2d1l3u2r3l1d1r1d1l1u1r3u1l1d1l2d3r1u2l1u4r2d2l1d1l1u1d3r1u1l1u2l2d2r1l1u2r2d2u2r2u2l2d1u1r2d2l2r2u1l1d1l1d2r1u2r2d1l2d1l3u2r1l1d2r3d2l1u1

;6
######
# $ .#
#  *@#
##. $#
#  * ##
# $ . #
###   #
  #####
Solution: d2u1l2u1l1u1r2l1d3r1u1r1u1l1u1l1d1r1d4r2u1l1d1l1u3r1d1l1d2r2u1l1d1l1u2l2d1r2u1r1u2l1d1u2l2d1r1

;7
 ####
 #  ####
 #  #  #
##$.$. #
# .$+$ #
# $.$. #
#    ###
######
Solution: l1d2u2d2r1u1r1u1r1u2l1d1r1d2l1u1d1l2u1r1d2l3u2r1u1r1d1u3l1d2r1d1r1d1r2u1l1r1u2l1d1l1r2d2l2u1d1r1u1l1d2l3u2r3d2l2u1d1r2u2l1u1d1r1d1l1r3u1l1r1u2l1d1r1d2l1u1d1l2u1r1d2l3u1r1d1r2u2l1u1l1d1r2d1r2u1l3r3u2l1d2l2u1r1d3l3u2r2u1l1u2r1d1l1d2l1d2r1u1

;8
  #####
###   #
# $   #
# .* ##
# *.$#
# .*@#
# $ ##
#  ##
#  #
####
Solution: l1u2l2d2r1d1r1u1l2u2r1d1u1r1d1u1r1u2l1d1r1d1l1d1l2d2r2u1r1u2l1u1d1r1d1l1u3r2d1l1u1l1d2r1d2l1d1l2u1r1l1d3r1u2l1u4r2u1r2d1l1u1l1d1

;9
  ####
  #  ##
 ##   #
## ..$##
#  $*$ #
#  $.. #
####@ ##
   #  #
   ####
Solution: u1l1u2r1d2r2u1l2u1l2d1u1r2u1r1d1l1d1u1l2d1l1d1r1u2r2d2r1u1l1u1l2d2r1u1r2d1l2r2d2l1u1r1u2l2d1u1r1d1u3r1d1l1d2r2u1l1d1l1u1r1d3l1u1r1u2l2d1r1u1r1d1u3l1d1r1d2l2u1l1u1r1d2r2l1d2r1l1u2r1u3l1u1l1d2u1r2d3l1d2r1u1l1u1l1u1l2d1r2

;10
  #####
###@  #
# ..$$#
# #.$ ###
# $**.  #
##      #
 ###  ###
   ####
Solution: d3u2l2d2r1d1r1u1d1r2u1d1l3u1l1u2r2u1r2,5-4l1,7-5l1u1l2d2r1u1l1u1r1d1l3u1l1u2r2u1r2d3u2l2r2d2l1u1r1u1l1d4r1u3d2r2u1l2u1l1u2r1d2

;11
####
#  ####
#     #
#  #  #
##. . #
# $.$##
# .$. #
##$ $ #
 #@ ###
 ####
Solution: r1u2l1u2d2r2u2d2l1d2l1u1r1u1r1u2l2d1l1d1r1u2r2d2r1d1l2r1u3l2d2r1d2l1r1u2l1u2r2d1l1u1l1u1l1u1r1d2r1d2l2u1r1d1r1d2l1u5l1u2r1d4u1r3u2l2r2d2l3u1l1u2r1d2u1r2d1

;12
 ####
 #  #####
 #    $ #
 # # *  #
## .*. ##
#  *@# #
# $#   #
#  #####
####
Solution: u1l2d1r1u1l1d1l1d2r1u1l1u1r1u1r4u1r1u1l4u1l1d4u1r4d2l2u1d1r2u4l4d2r1l1r3,6-5u1,2-5r1,2-7u1l1u1r1,4-6u1l1u1l1d1,5-4l1,5-2d1,4-2d1,7-3l1,2-7u1l1u1r1

;13
    #####
   ##   #
   #  # #
####    #
# @$$$$##
# .... #
########
Solution: d1r2u1l1d1r2u2r2u2l2d1l1d2u2r1u1r2d2l2d2r1u1l3d1l2u1r4d1l2r2u3l1d2r1d1l1u3r1u1r2d2l2d2r1u1l1u2l1d2u2r1u1r2d2l1r1u2l2d3

;14
 ######
##    #
#    .####
# #$.*+$ #
#   *$*  #
###  #  ##
  ####  #
     ####
Solution: l1r1d1u1l1u1l4d2r2u1d1l2u2r1u1r3d2l1u2l2d1l1d2r2d1r1u1l3u2r1u1r3d2r1d1l2r3l3u1r1u2l3d1l1d2r2l2u2r1u1r2d1u1l2d1r1l2d1u1r1u1r3d3l2r2u3l2d2r1d1r1u1d1r3u1l2r1d1l3u1r2d1r1d2l1u1r1u1l1u1l2d1r1u1r1d1l1u1l2u2r2d1l1d2r1u1l1d2l1u1r1u3l2d1l1d2r2d1r1u1l3u2r2d1r1d2l1u2d1l2u2r1u1r2l2d1l1d2r5u1l1d1l2u1d1l2u2r1u1r3d1u1l2d1r1l3d2r2u1d1r5u1d1l4u1d1r3d2l1u1r1u1l3d1l1u1r5u1l1d1l6u2r1u1r2d2u2l2d1l1d2r4l4u2r2u1r1d2u1l3d2r2u1d1l2u2r2u1r1d1

;15
####
#  ###
#    ##
# .$* #
## *  #
# *$. #
#@  ###
#  ##
####
Solution: r1u3l1u2r1d1r2d1r1d2u2l1d1u2l2d3u1r1u1r1l2d2l1d2r1u4r3d1l2u1l1d2l1d2r1u1r1u2l1u1l1u2d2u2r1d2r1d1r2u1d1l2d2l2u1r1d1r1l1u3l1u2r1d4u1r3u1l1u1l1r1d2l2u1r1l2u2r1d1r1d2l1d1l1d2r1u1r1u1

;16
#######
#     #
# ### #
# #@# #####
# $$$$$   #
# # # # # #
# .....   #
###  ######
  #  #
  ####
Solution: undefined

;17
  ####
### .#
# $@.#
#  $*##
# #   ##
#  $*  #
# $ .  #
####.###
   ###
Solution: undefined

;18
####
#  ###
# $@ ####
# *.$.  #
# .$.*  #
###  $  #
  ####  #
     ####
Solution: undefined

;19
######
#    #
#    #
## # ####
 #$.$.  #
 #@$.   #
 #$.$.###
 #  ###
 ####
Solution: undefined

;20
   ######
  ##    #
### $#* ###
# $*. .   #
#   . .*$ #
### *#$ ###
  #  @ ##
  ######
Solution: undefined

;21
  #######
  #  #  #
  #  #  #
### * . #
#  *$*$*##
#  @. *  #
#####    #
    ######
Solution: undefined

;22
  ####
  #  #
  #  ####
  # $   #
###*.*  #
#  *+*###
#   $ #
#  #  #
####  #
   ####
Solution: undefined

;23
 ####
 #  ###
## $  #
# $ *.###
#@##..  #
# $ *.  #
## $  ###
 ###  #
   ####
Solution: undefined

;24
   #####
 ###   #
 # .   ##
 # .$$$ #
###.#.  #
# $$$.###
#  @#.#
#######
Solution: undefined

;25
 ####
 #  ####
 #  #  #
##.$#$.###
# .$@$.  #
# .$ $.  #
###  #  ##
  ####  #
     ####
Solution: undefined

;26
    #####
 ####   #
 #@$    #
##$$##.###
# .. ..  #
# . #$$  #
###  $ ###
  ###  #
    ####
Solution: undefined

;27
 ####
 #  #
##  #
#   ###
# *** #
# *@* ###
# #*# $ #
#     . #
###   ###
  #  ##
  ####
Solution: undefined

;28
 ####
 #  #
 #  #
 #  ###
##$$  #
# .*  #
# @*###
##$*  #
 #..  #
 #  ###
 #  #
 ####
Solution: undefined

;29
   #####
 ###   #
 #  $. #
## #.$##
#   $+#
# ##.$#
# # $.#
#   .$#
####  #
   #  #
   ####
Solution: undefined

;30
  #####
  #   ###
###$*.  #
#   *   #
#  @*#####
### *    #
 # .*$   #
 #   #####
 #####
Solution: undefined


;1
   #####
  ##   ##
  #     #
###$#$# #
#  * *  #
# #*@*# #
#  . .  #
#########
Solution: undefined

;2
    #####
#####   #
#@..*$$ #
# $$*.. #
##  # ###
 #     #
 ###   #
   #####
Solution: undefined

;3
####
#  #
#  #####
#  $.$ ##
## .*. @#
#  $.$# #
#  ##   #
#  ######
####
Solution: undefined

;4
  ####
  #  ##
###$. ##
#  .$  #
# #$.  #
# #.$ ##
#@#$.##
# #  #
#    #
######
Solution: undefined

;5
#####
#   #######
# @$      #
## $.#### #
 # $*$  # #
 ## ... # #
  #  # ## #
  ####    #
     ######
Solution: undefined

;6
  ######
  #@#  #
###$$  ##
#  .*$  #
#   .*# #
#### .  #
   #  ###
   ####
Solution: undefined

;7
   ####
   #  #
 ###  ##
 #  $  #
## #$#@#
# ..*..#
#   $  #
####$ ##
   #  #
   ####
Solution: undefined

;8
 ####
 #@ #
##.$###
# .$  ##
# $.#  #
##$.   #
# .$#  #
# .$  ##
#  ####
####
Solution: undefined

;9
   ######
  ##    #
###  ## ##
# ... #  #
# $$$ ##@#
### #  # #
  # $$$# #
  # ...  #
  ###   ##
    #####
Solution: undefined

;10
    ####
  ###  #
###    ##
#  .#.  #
# #*+*  #
#  $$$ ##
## # ###
 #   #
 #####
Solution: undefined

;11
#####
#   ##
#    ##
##.$. #
##.$. #
# $.$ #
#@$.$ #
###  ##
  ####
Solution: undefined

;12
    ####
    #  #
  ###  #
### $. ##
#  .  $ #
# #$ #. #
# # .$@##
# ### ##
#     #
#######
Solution: undefined

;13
     ####
#### #  #
#  ###$.#
#    $. #
#  #$.  #
## $. ###
 #$. @#
 #  ###
 ####
Solution: undefined

;14
  ####
 ##  ###
## $.  ##
# $.$.  #
# #$.$. #
#@# $.  #
# ##  ###
#    ##
######
Solution: undefined

;15
    ####
#####  #
#      #
# $ #. #
##****##
# .@ $ #
#      #
########
Solution: undefined

;16
   ####
 ###  ##
 #  $  #
 #  *# ##
##.*@*. #
#  #*   #
#   $ ###
#  #  #
####  #
   ####
Solution: undefined

;17
 ########
##  @   #
#   ### #
# $.$.$.##
##$.$.$. #
 # ## #  #
 #      ##
 ########
Solution: undefined

;18
  #####
 ##   ###
##  #   #
#  .*$# #
# #*@*  #
#  $*. ##
####  ##
   #  #
   ####
Solution: undefined

;19
     ####
 #####  #
 #      #
## #... ###
# $$$#$$$ #
#  #.+.   #
#    #  ###
#########
Solution: undefined

;20
   ####
 ###  #
 #  . ##
## #.  ###
#@$$*..  #
#   $  # #
####$### #
   #     #
   #######
Solution: undefined

;21
  ######
###@   #
# . .  #
#*$*$*##
# # #  #
#      #
#   ####
#####
Solution: undefined

;22
    #####
#####   #
# $    .##
#  ****  #
##.# @ $ #
 #   #####
 #####
Solution: undefined

;23
 #####
##   ##
#@$*. #
#  *# ###
#  *    #
##$*. # #
 # #  # #
 # #### #
 #      #
 ########
Solution: undefined

;24
    ########
   ##      #
#### @ ### #
#  $ $ $ # #
# #*#*#* # #
#  . . . # #
##  #   ## #
 #  ###    #
 #### ######
Solution: undefined

;25
 #######
##  .. #
#  #.$$#
# @..$ ###
#  #$$   #
##   #   #
 #########
Solution: undefined

;26
   ####
####  ####
#  $ @ $ #
#  .$#$. #
### .$. ##
  # #.  #
  #   ###
  #####
Solution: undefined

;27
 ######
##    #
#  ## #
# ##  ####
# # . . .#
# # $ $ $###
# # .#.#.  #
# # $ $@$  #
# ## #######
#    #
######
Solution: undefined

;28
  #####
 ##   #
 #  # #
 # ...#
##$ #.##
# $  . #
# $$$# #
#@ #   #
########
Solution: undefined

;29
########
#  .$  ##
#@#.$#  #
# #.$   #
# #$.#  #
#  $.# ##
###$.  #
  #  ###
  ####
Solution: undefined

;30
  #########
###       #
#   ##### #
# ###   # #
# #     # #
#  . # ## #
###*****  #
  #  @ $###
  #  #  #
  #  ####
  ####
Solution: undefined

;31
  ####
  #  #
###$.###
# $.   #
#@ $.  #
### $. #
  #$. ##
  #  ##
  ####
Solution: undefined

;32
   ####
   #  #
####. #
#   . ###
# ** ** #
## #$   #
 #  $ ###
 ## @ #
  #  ##
  ####
Solution: undefined

;33
 #########
 #       #
 # ##### #
 # #   # #
 # #   # #
 #.  .## #
##*# *   #
# *  *####
#@$  $ #
####   #
   #####
Solution: undefined

;34
    ####
    #  #
#####  ####
#   $  $  #
# # *# *  #
# # .$$.###
# ###.. #
#    @###
#######
Solution: undefined

;35
#######
#  # @#
#  $$$####
# $#  $  #
##.  #.  #
 ##...  ##
  ####  #
     ####
Solution: undefined

;36
#######
#     #
# ### ####
# #  ... #
# #  #*# #
# #   *  #
# ###$$$ #
#     #  #
##### @ ##
    #####
Solution: undefined

;37
######
#    ####
# ## #  ##
# # .$.$ #
# # .$.$@#
# # .$.$##
# ###   #
#     ###
#######
Solution: undefined

;38
  #####
  #   ####
### #.$  #
#   .$## #
#  .$ @$.##
### ##$.  #
  #  $.   #
  #########
Solution: undefined

;39
  ####
  #  ###
### .. #
#  . #$##
# .   $ #
##.# $  #
 # $$ ###
 ###@ #
   ####
Solution: undefined

;40
    ####
#####  #
#      ###
#  ..#$$ #
## # *   #
 #   *#@##
 # $$ ..#
 ###  ###
   ####
Solution: undefined

;41
       ####
       #@ #
       #  #
     ###  #
   ### .*$##
#### .*$   #
#  .*$ # # #
# #  #   # #
# ##   ### #
#  #####   #
##       ###
 #########
Solution: undefined

;42
    ######
    #    #
 #### ## #
 #   $@# #
## #*$*# #
#   *.*  #
#   #.  ##
##    ###
 ######
Solution: undefined

;43
 ####
 # @#####
 #$$$   #
##...   #
# ...# ##
# $$$# #
###    #
  ######
Solution: undefined

;44
    ####
  ###  #
 ##    #
## .#$ #
# $*$ ##
# #.*.##
# . $ @#
##  #  #
 #  #  #
 #######
Solution: undefined

;45
   ####
 ###  ##
 #     #
## .# .###
# $*$$*$@#
#  .# .  #
##     ###
 #######
Solution: undefined

;46
#####
#   ####
# #$ $ ##
# #.@.  #
#  $#$# #
#  . .  #
##  #####
 ####
Solution: undefined

;47
######
#@   #
# ## ####
# #.$$  #
#  .*.  #
###$$.###
 #  # ##
 #     #
 ###   #
   #####
Solution: undefined

;48
     #####
   ###   #
####. *# #
#  . * # #
# # *@$# ##
# #* $    #
#   ###   #
##### #####
Solution: undefined

;49
############
#      #   #
# ####...# #
# # ...$$$ #
# #  $$$  ##
# ####   ##
#@     ###
########
Solution: undefined

;50
##########
#        #
# ##*### #
# # *    #
# ..*$$ ##
## # #   #
 # #@  # #
 # ##### #
 #       #
 #########
Solution: undefined


