;1
#############
##*#*#      #
#*#*## #### #
###### $  # #
## * $*$# # #
##  ...   # #
### ##  ### #
##  *  ## # #
### # $ $   #
##  * ...  ##
###*#**$# ###
# $ $ # *   #
# . .   ..$ #
###@## # $###
##     #   ##
# *# *# # ###
##      #*###
## .$**. ##*#
#* $$.$*  ###
#### ...  ###
### $ $  ##*#
###*   ##*###
#############
Solution: undefined

;2
############## ##  ##
#. . . . . .#########
# $*$*$*$*$      ####
#         $ ##    # #
#.*$* * * * ### *.  #
#    * * *  #  .**# #
#.*$* *$* * # *  $  #
#    * . *  # *#.#$##
#.*$* * * * #  $@ $ #
#    * * *  ##  # . #
#.*$* * * * *##   # #
#           #########
##############  ## ##
Solution: undefined

;3
################
#*#*#.  . .#####
######$$$###  @#
###  #       $ #
### $##### # $##
## $  ..   $  ##
##   $.**  #  #
## $ #* *#.*###
####  **. ..####
#*##*.$..*# ###
#*.$..**$*   ##
#*### # ..#   ##
### $  $..  $ ##
##. $ ## #$#  #
##  $$#  #  $ #
###   # $*##  ##
####### *.*#####
################
Solution: undefined

;4
###  ##  ####
#############
 #####     #
##      #* ##
##@$  $#** ##
 # #$    # ##
## #   $ # #
## *#*#*#* ##
##   # ..  #
 #*# #.. ####
###  #####*##
##* #   . ###
#.$ #. $ **##
## #*#.#$  #
## * $*  # ##
#* #   * $ ##
##   *# .  #
#############
 # # # # # ##
Solution: u1r3d2r3d1l1u1d2u2l2u2r2u1r3d6l2d1l2u1r1d1u1r1l1u3l2d1r1u1r1d3r1d1l1u3l2u3r1d2l1d1r1u1r1d3u3l2u1l1u1l2r3l3d1r3u1r1d2l1d1r1u1r1d2u2l1u1d2l2u1r1u2l2d1r2u1r1d2l1d1r1u1r1d1u1l1u3r4d6l1r1u6l4d1l4d5r2d2l1d2l1d4r2u1r3d1u2r1d1u3l2r2d3l2u1d1l2u1r1d1r2u1r1u1r2d2l2

;5
## # ## ##  ## ##
#################
###     .#.  . #
##  $$ $ # #$  ##
#   . #### $  .##
# #$#.* *##*$*$#
#  *.#       $.##
#* # @. .#* .  ##
##   $##########
#* $#  #.#.#. ##
## $    $    $ ##
#* $  #.$#$ $# ##
## # $   $ $$..#
##. .#. .    .###
#################
# ### ## ## ## ##
Solution: undefined

;6
## # ### ###
############
 ##       #
##.*.$# # ##
##+$ .. $ ##
##$$ $*$ ###
 #   # ..##
############
### # ##  ##
Solution: r2,2-6u2,4-5l1d1l1u1,6-4l1,4-3d1,9-4l3,7-6u2,7-2d2,4-4r3,4-6u2,9-4l1,6-6u1l1r2u1r1d1,7-2d3,5-4r1d1r1u1,3-5r2,5-2d1,7-2d1,8-4l1

;7
##########
##*#  #*##
#.*   ####
# # $$  ##
#$#.*   ##
#  .*.# ##
# $$  # .#
# * .**  #
#.#  #.# #
#$*##* $ #
#.$    $ #
#. $ $ . #
##$ @# $##
#.   $  .#
# $#$#$$##
#.   $  .#
##.#.#..##
##########
Solution: d3,2-13d2,7-13d2l5,6-13d2,7-11d3l1d1r1,4-13r3,8-9l1,6-10u1,6-10r1d1r1u4,3-10d1,1-10u1,3-10l1,3-13u1r1u1l2d1r1d1l1,4-11r2,6-4l1d1u1l1u1r1l1d1r1d2l1u1l3u2d4r2l1r1u1r1u1d1l1d1l2u2r1d1r3u3l1d1r1u3l1d2r1d1r2u1l1d1l1u1l1u2r1d3

;8
################
#*#***##....  ##
###   #*** #$ .#
#*#$ #   *# $ $#
##  .. #  # $$ #
#   **# #      #
#  $..    #.$$ #
## ### $  #$@. #
#*    ##$#.$$$.#
#**##    ##.. ##
################
Solution: d1l1r2u1r1u2l1d1u1l2d3u3r2d1l1u1l1u2r1u1r1u1l4,12-5u3r1u1l3,14-4u1d1l1d1l1u3r1u1l2,14-3l1d1l1u2r1u1l1,5-6u1l1,8-9u2r1u1l1,2-5r2,6-4l2,4-6l1,2-7u1,6-7r1,8-6l3,8-8u1r1u1l3,1-5r2,2-4r2,3-2d2l1d2r1u1l1u1r1

;9
### # ## #######
##########. $ #
##    #  #.$$ ##
 # $$ ... # # #
##  $ #* #  $ ##
 # $# .*    #.##
### *#.*. #   #
##  $  # ## # ##
 #$  $  $#.@$ #
##.#.#    #.# ##
 #####*#*#.$$$##
###########.#.#
## # ## ########
Solution: undefined

;10
## # # ###
##########
 #.   ..#
##$ $$$ ##
 #. . $ #
###*#*# ##
 #  .$  #
## #.$$ ##
 # $@ ..#
#### .# ##
 # .$$# #
## $ .  ##
##########
## # # ##
Solution: 2-4u1,7-4l4,5-4u1,4-2r2,6-4u1,2-8r2u2r1u2,6-8l2,5-8u2,5-11u3,4-11u1,2-11r2,4-8d1r1d1l1,5-6d2,7-7l2,2-8r3,7-6l2,4-2r1d1,4-4r2,4-2d1,7-3d4

;11
 #### # ####
##  #####..#
##      #$ .#
#  # #  # $$#
#  $...##. $ #
#  #...  #.$ .#
##$ ##$# #$  #
# $    $    #
#   $#$##$##
### @ .**.#
 ###########
# # # # # #
Solution: undefined

;12
############
##...#*#*#.#
### .     $#
#** $#$$$  #
###  *  #$$#
#*#*$#$  ..#
#**.+$  .###
#*##########
### ## # ##
Solution: l1u4r1u1l1d3,10-3u1d2,9-3d1,4-6r3,6-4l2u2,3-5u3,6-4d1r1d1l3,4-4d1,7-2d2,6-4u1r1u1l2,9-3l2u1l1d1,7-4l3u1l1d1,7-6u2,8-3l1u1l1d1r1d1l1

;13
        #
       #.#
      #.$.#
     #.$$ .#
    #. $ $ .#
   #  $ $ $ .#
  #  $. $ . $.#
###@ *#*# *# ##
 #* #    #  ##
###  $ $ $  *##
 #  .*.*... ##
###$.$ $ $.$###
 #  .*.*.*.  #
###$.$ $ $.$###
 #  .* ***.  #
###$.$ $ $.$###
 #  .*.*.*.  #
###$.$ $ $.$###
 #  ...*.*.  #
## $ $ $ $ $ ##
 #*# #    #*##
###############
 # # # # # # #
Solution: undefined

;14
 # # # # # # #
##############
 ##*#*#**.$.# #
## #  ###.$  #
 #   .#  #$ # #
## # * .$#.  #
 # * #    #.# #
## #.# #  #  #
 # $ . #$##.# #
## #$.$  #*  #
 # #   ## $.# #
## .###+$.$  #
 #          # #
###$#$#$#$#$# #
 #           #
### # # # #.#
 # # # # # #
Solution: undefined

;15
# # #### #
 #*#*#*##*#
###.#.#.##
 #. $ $ .##
###$#$#$##
 #. $   ###
#######  #
##   ### ##
 # $   # #
## @*#.* ##
 #$$   $ #
##   **# ##
 # *.#.* #
##.*     ##
#######  #
 ###*######
# # # # # #
Solution: undefined

;16
########################
###### # # # # # # # ###
##    * * * * * * * *  #
## * * * * * * * * * * #
# *                    #
## *  *$#$*@  *$#$*  * #
# *  #. . .# #  . .#  ##
## * $ .$* $   *$* $ * #
# *  #... .# #. ...#  ##
## * $ *$* $ $ *$* $ * #
# *  #. .  # #. . .#  ##
## *  *$#$*   *$#$*  * #
##                     #
## * * * * * * * * * * #
##  * * * * * * * * *  #
#### # # # # # # # # ###
########################
Solution: undefined

;17
############
#   # ### .#
# #   #  $ #
# $$#   *# #
# $ $ # .  #
#.$ $ # #$.#
#.. $ $ @$ #
#..$..#..  #
############
Solution: undefined

;18
    # # # #
   #*#*#*#*#
  #         #
 #  #*#*#*#  #
#* * $ . ..# *#
 # # $ #$# * #
#* * * * * # *#
 # #  $. $ # #
#* * #  *.* $.#
 # $@.#  * $.#
  # #$ ## $.#
   #.    $.#
    #*#*#*#
     # # #
Solution: undefined


