;1
# ######## #
 #    *   #
#  $* #.$  #
# $# .* #$ #
# .  $#  * #
#*#*#.+$.  #
#  .$..#*#*#
# *  #$  . #
# $# *. #$ #
#  $.# *$  #
 #   *    #
# ######## #
Solution: r1,9-5l2,10-5d2,6-8u1,6-10l2,3-6r1,1-6u2,5-3d1,10-4l1,9-2d2,10-5l1,7-4r1,9-2l1,10-9u2,7-10u1,9-9l2,6-10u1,7-7d1,9-9u1,2-10r2,1-7r1,2-9u2,1-6r1,4-7l1,2-9r1,1-2d2,4-1d1,2-2r2,5-1d1,4-4u1,2-2d1

;2
####    ####
#   #  #   #
# *  ## $* #
# $.  .$.  #
 # $.$#.  #
  #.# @$ #
  # $  #.#
 #  .#$.$ #
#  .$.  .$ #
# *$ ##  * #
#   #  #   #
####    ####
Solution: r1,8-4d1,8-1d1,7-2d1,5-5u1,4-3r1,1-3r1,2-4r1,5-6l1,3-7u1,3-10u1,4-9u1,6-6d1,7-8l1,10-8l1,9-7l1

;3
 # #    # #
# #.#  #.# #
 #.$ ## $.#
#.$      $.#
 #  *$#*  #
  # # @$ #
  # $  # #
 #  *#$*  #
#.$      $.#
 #.$ ## $.#
# #.#  #.# #
 # #    # #
Solution: r1u1,8-3u1,8-3r1,7-2d1,8-8r1,7-9r1,8-4d5,3-8d1,2-7d1,6-6d1,7-8l5,3-3l1,4-2l1,5-6l1,3-7u5,5-5u1,4-3r4,9-4u1

;4
     ##
   ##..##
  #. $ $ #
 #  $  $ .#
 #$$##*#$ #
#.  *.+# $.#
#.$ #..*  .#
 # $#*##$$#
 #. $  $  #
  # $ $ .#
   ##..##
     ##
Solution: u3,5-3u1,6-6r3,8-5r1,5-6d3,6-8d1,5-5l3,3-6l1,3-8u1,2-3d4,3-3r1,8-2l4,8-3d1,9-8u4,8-8l1,3-9r4,7-8l1,5-9u2,3-8r1,5-9u1,3-7u1,2-5r2,3-3d1,2-5r1,4-3r1,6-2d2,8-3l1,6-2d1,8-4d1,9-6l2,8-8u1,9-6l1

;5
 ###    ###
#   ####   #
# $ .  . $ #
# #.#  #.# #
 #   #$$  #
 # $#.+$  #
 #  $..#$ #
 #  $$#   #
# #.#  #.# #
# $ .  . $ #
#   ####   #
 ###    ###
Solution: u2,5-6d2,5-2r1,6-9l1,10-9l2,8-5d2,8-5l2,10-2l1,8-1d4,6-4r1,8-5u1,8-7u1,9-5l2,1-2r2,3-6u2,1-9r1,3-10u4r2,5-7l1,3-6d1,3-4d1,2-6r2

;6
   #########
  #    $ .*#
 #  ## #$#.#
#  # $ ..$ #
# #  #$#.#$#
# # #..$   #
# #  #.#$# #
#  #@ #  # #
 #  #   #  #
  #  ###  #
   #     #
    #####
Solution: r1d1r2u1r1u2l2r4u2l2,6-3d2u4r2d1,4-3r1,6-2d2

;7
############
#  * . * ..#
# $#$# #$#.#
#    * .+$ #
# $# #$#.#*#
#  $ ..$   #
#  #$#.#*#.#
# #..$   $ #
#  #.#$# #*#
 #  #  $ $ #
  #        #
   #########
Solution: l2u2r3l3d2r2u1d1l2u2r2d4r2u2d2u2l2,8-5d2l4,4-5d2,10-7l5,2-1r4d4r3l2r1d2r2u2,10-9u2,8-9u5,6-9r1d1r1u5d5u3l2d1u1r2d2r1d1r1u1d1l5u1r2d1r1u3,2-5r3l1u3d1l3u2r3d2l2u1l1u1r1d3l1d1r3

;8
 ##########
##   #    ##
#  # .. #  #
# # . #. # #
#  $*  *$  #
# $ #*   $##
##$   *# $ #
#  $*  *$  #
# # .# . # #
#  # .. #@ #
##    #   ##
 ##########
Solution: 5-6u1,5-5u2,7-5u2,4-6d1,2-7r1,6-5d3,7-9l1,8-8u1l1,6-8u1,4-9r2,7-10u1,6-5d3,7-9l1,8-5d1,9-7l2,6-6d2,10-6l1,8-5d1,9-7l1,8-3d1,9-4d1l2,6-4d1,4-2r1,7-1d1,3-3d1r1,4-4r1,7-2l2,4-1d1,3-6u1,2-4r2,5-5u2,4-2r1,1-5r1,3-6u1,2-4r2,5-5u2,4-4u1,2-7u2,5-4r1,1-4r2,4-1d1,10-6l1,8-7u1,9-5l3

;9
 ##########
##   #    ##
#  #....#  #
# # $$#$ # #
# .$    $. #
# .$# $ $.##
##.$ $@#$. #
# .$    $. #
# # $#$$ # #
#  #....#  #
##    #   ##
 ##########
Solution: u1,7-7r1,7-5r1d1,7-2d1,6-7d1,7-9l1,4-7d1,7-7d1,4-6r1,6-5d3,4-6l1,4-4l1,3-6u1,9-4d1,5-4u1,4-2r1,3-8u1,2-7u1,4-6l1,4-4u1,3-3d3,7-5u2,7-4l1,5-5u2,8-8u2,7-5r1,7-4r1,4-7l1

;10
 ##########
##   #    ##
#  #.  .#  #
# # . #. # #
# $$* . $$ #
#   #* $  ##
##  . *#   #
# $$*$ *$$ #
# # .# . # #
#  #.  .#@ #
##    #   ##
 ##########
Solution: 8-8u1,6-7u1,3-8u1,1-7r1,4-6d1,4-9u2r1,6-6d2,5-6u3,6-2l1,6-4d1,8-5l2d2,5-6u3,5-9r1,6-7d1,8-3d1,10-4l3,5-4r1,7-5u2,9-5l1,8-7u2,9-4l1,6-5r1u1,10-7l1,8-6u1,8-8u1,7-10u1,5-9r1,2-7r1,3-5d1r1d2,2-7r1,4-6d1,3-3d3,2-7r1,1-4r1,3-3d2,4-1d1,6-2l1,2-6r1,5-7u1,8-7u1,9-5l2,6-4d1,9-4l2

;11
 ##########
##   #    ##
#  # .. #  #
# # . #. # #
#  $* $*$  #
# $ #  . $##
##$ .  # $ #
#  $*$ *$  #
# # .# . # #
#  # .. #@ #
##    #   ##
 ##########
Solution: d1l2u2r1u2d1r2u1l1,3-3d2,1-5r1,4-6d1,2-7u2,4-7r1u1r1d2,5-9r1,7-10u1,9-4d1l3,5-4d2l1d1,2-6r2d2l1u1,4-10u1,6-7l1u4,2-6r1,3-4d1,7-3d1,8-5l1,6-2l1d2r1d1,8-7u1,10-6l1,6-5d3,7-9l1,9-5l2u1l1d4,3-4r1u1r1d1l2d1l2u3r1u1r2d1,5-6u3,4-2r1,1-4r3,5-3d1,5-6u3d1l3d3r1u2l1u1r3d1r4l2u1l2r2d1r2u1l1r1d3l1u1r1u1l1

;12
 ##########
##   #    ##
#  # .. #  #
# # . #. # #
#  $*  *$  #
# $ #$*  $##
##$ . .# $ #
# $$*$ *$  #
# # .# . # #
#  #... #@ #
##    #   ##
 ##########
Solution: d1l2u1l1u3l1u3d3r1u1r1u2d2l1d3r2u1d1l2u1r2l2u1l2d2u1r2l1u4l1u2l2d1l1d1u1r1u1r2d2l1d1r1u1r1d2r1d2l2u1l1u1d1r1d2u1r2u2l1u1l2d2r1d2l1u2d2u1r3d2l1d1l3u1l1u2r3l3d2r1d1r3u1r1u2l1r1u2r1u1l2r1d3l1u1l1d1r2u3l1d2r1d1l1r1l3r3d1r2u1l3r2d3r2u1r1u2l3d1l1u1l1u2r3d1u1l3d2r2d3r2u1r1u2l2u2l3d2r2d1r1u1d1l1d1u1l1u1l1u1l2d1r3d2l1d1l3u1l1u2r2u1r2d1u2r1d3u2l3d1l2d2r1d1r3u1r1,7-10u1l1u4d2l1r1d2r1d1r2u1r1u2l3r3d2l1d1l2u1l1u2l1u2r3d1u1l3d2r1d2r1d1r2u1r1u2l2u2l2d3,7-9l1,8-3d1,7-1d3,8-6u1l1u1l1d4u3r2d2u2l1u4r2d1r1d2l3d1r1d2r2u1l1d1l1u2l1u4r2d1r1d2l2d1u1r1d1l1d2r2u1l1u1l2u1d1l2u2l1u1r1d2r2l2u1l2d1r2l1u3l2d1l1d2r2u1r2d1,7-2l2,4-1d1,3-4r1,5-3d2r1d2l1u4,4-2r1,3-6u1,2-4r2,5-5u2,7-4l2,1-5u1r4l4d1r1u1r3d2l2d1l1u1r3u2l2d1u1l2d1r1d1r3l3u2r1d1l1d1r1u2r2d1r2u1l2r1d1r3u1l1r1d3l1u1r1u1l2

;13
 ##########
##   #    ##
#  # .. #  #
# # . #. # #
# $$* $*$  #
#   #$ . $##
##  .*.# $ #
# $$*$ *$  #
# # .# . # #
#  #.  .#@ #
##    #   ##
 ##########
Solution: d1l2u1l1u3l2d2u2r2u1r1u2d2l1d1l1u3d3l1d1u1l1r1d2l1u1r1u1r2d1l1u1l1d1r2d2l1d1l3u1l1u2r3,8-8u1d1l2u1r2l1,10-7l2,4-7r1u1r1d2,5-9r1,8-10l1u1l1u4r1l1d4r1d1r2u1r1u2l4u2r2d1u1l2d4r1d1r2u1r1u2l2u2l3r1d2u1l2d1r1u1r1d2u1l5d2r1d1r3u1r1,3-5d1,2-7r1,2-7u1,3-3d2,2-6r1,1-4r1,3-3d1,3-6r2,5-7l2,8-7l3,8-3d1,6-2l1,4-1d1,7-1d1,7-4l1d1l1u1,7-2d1,8-3d1l1,8-6u1,9-4l1,3-7r3,1-7r2,3-4d1,1-5r1d1r1,5-4u1,4-2r1,3-4r1,5-5u2,3-6r1l2u2r1d1l1d1r1u2r2d1r2u1l2r3d3r2u1,7-2d1,10-6l1u1d2l1r1u2l2r1u1l1u3r2d1r1d2l2d1l1u1d1l2u1r2d1r2d2l1u1r1u1l1r1u1l1

;14
 ##########
##   #    ##
#  #.  .#  #
# # . #. # #
# $$* $*$$ #
#   #* .  ##
##  . *#   #
# $$*$ *$$ #
# # .# . # #
#  #.  .#@ #
##    #   ##
 ##########
Solution: 6-5d1l1u1r1,8-8u1,6-8u1,4-6d2l1u1r1u1l1,6-7l1,4-6d1,1-7r2,6-5d3,5-9r1,8-7u1,9-5l1,8-7l1d1l1u1,10-7l2,7-10u1,6-5d3,5-9r1,8-3d2,10-4l1,5-5u1,8-5l1u2r1d1,5-4r1d1,9-5l3,7-5u1l2u1,6-7r2u1r1u1l1u1l2d1r1u1,3-3d2,6-2l1,4-1d1,3-7l1u1r1,9-5l1,3-4r3,1-4r2,5-6u3,6-2l1,3-6r1,5-7u1,1-5r1u1r1d1l1d1r1,10-7l2


