;1
####   ####
#  #####  #
#  ...##  #
#. ## $ $ #
# $###    #
#    $$$###
# ..#@  #
#########
Solution: 6-6u1l3,5-3r1d1,8-4u1,6-3r1,6-6u1,7-6u1,1-5r4,2-5u1,7-5l4,6-3d1,2-4u1,2-6u1,7-5l4,7-3d1,9-3l2,7-6u1,6-4r1,9-4l2,1-5r1,2-3d1,2-1d1,5-3r1d1,6-3r1,6-6u1,2-4u1,2-6u1r3,1-2r1,2-5u1,7-5l4,6-3d1,5-5r1,9-3l1,2-2d1,4-2l1,8-3l1,7-6u1,6-4r1,9-4l2,8-1d1,1-5r1,2-3d1,2-1d1,5-3r1d1,2-4u1,2-6u1r1,2-3d1,2-1d2,8-4u1,6-3r1,6-6u1,3-5r2,1-5r1,2-5u1,4-5l1,2-4u1,2-6u1,7-5l4,6-3d1,9-3l2,8-1d2,9-4l2,5-5r1,1-5r1,2-3d1,2-1d1,5-3r2,8-4u1,2-4u1,2-6u1r3,2-3d1,2-1d1,7-6u1,5-5r1,6-3d1r1,7-6u1l2,7-3d1,9-4l2,3-5r2,2-4u1,2-6u1,7-6u1l4,1-5r1,2-3d1,2-1d1,6-3d1r1,6-6u1,2-4u1,2-6u1r3,1-2r3,2-5u2,1-2r2,7-5l4,2-6u3,1-2r1,6-3d1,7-5l4,2-6u3,9-4l2,6-3d1,7-5l4,2-1d1,2-4d1,1-6r1,2-4u1,8-1d2,9-4l2,6-3d1,7-5l5,1-6u1,2-1d4,1-5u1

;2
        #####
 ####   #.#.#
 # .#####   #
 #.$##  #$#$#
 #  ##  $ $@#
##$.   $#  ##
# *** #    #
#. .  ######
##  ###
 ####
Solution: undefined

;3
  #######
  #  #  #
###  $  #####
#.# $# $   .#
#.   #$$$ ###
#.. $#@$  #
#... ###  #
###### ####
Solution: undefined

;4
  ###
  #.###
 ## ..#
 #  .###
 #.  . #
##  ## ##
#    #  ###
# # $$ $  ##
#      $$$ #
#  ##### @ #
####   #####
Solution: undefined

;5
########
#.    .#
# ## #$#
#  # # #
#.$ .  #
#  #.# #
# $#.#.#
# $  $ #
#$@$####
#   #
#####
Solution: undefined

;6
        ###
        #.#
      ### ###
    ###    .#
    #     ###
    #  $ ####
###### ##   #
#     $##   #
# @        ##
#  ######  #
####    ####
Solution: undefined

;7
 ###
##.####
# $   #
#@$ $$######
# $ $ ##   #
###      $ #
  ####.$   #
    #  ##$##
#####*# $. #
#.......   #
############
Solution: undefined

;8
     ###
    ##.#
   ##  #
 ###.$$#####
 #.#     $@#
 #.# ## $ $##
##. .  #$$  #
#.$.  $    .#
#############
Solution: undefined

;9
          ###
       ####.#
      ##.## #
     ## .## #
     #@$$#  #
  #### $   $#
 ##.#####$  #
## . #### $ #
# . $     $ #
#... $ ######
########
Solution: undefined

;10
  ###
 ##.#
 # *#
 #$@####
 # $$  #
 #   #.#
#. #*  #
#$$$.. #
#  .  ##
#######
Solution: undefined

;11
####### #####
#..+..###   ####
####.$$     $  #
   # $   $ $  .#
   #########$  #
           #   #
           #####
Solution: undefined

;12
####
#@*#############
#**..  $ .   . #
#.## $ .#  $$  #
########  ##  ##
       #   $ ##
     #####$  #
     #.   $  #
     #########
Solution: undefined

;13
   ########
   #   # @#
   # $ #$$##
   ##  $ $ #
    #  # # ####
    #  #  ....#
###### ###.####
#           #
# # ##  ##  #
#   ##  ##  #
#############
Solution: undefined

;14
################
#            ..#
#  #############
##   #####
 #       # #####
 ##  #   ###@  #
  ####      $  #
     ## $#######
      #  #
      ####
Solution: undefined

;15
     #####
     # ..##
###### .@ #
#    .$ . ##
#   ###  ..#
# $  #   ###
##$#$   ##
#   $$ ##
#  $  ##
###   #
  #####
Solution: undefined

;16
   #####
   #   ####
   #  $   #
   #    $ #
   #####@##
######## .#
#  .... $*#
# $ ###$  #
#   # #   #
##### #####
Solution: undefined

;17
############
#   .*.....#
#   .# #####
 # ##  #
 # $  ####
#  $     ###
#   ## $ $@#
######$$$  #
     #     #
     #######
Solution: undefined

;18
        #####
#########   #
#.* #  # $ $##
# .$.* # #  .#
#   .  . # ###
# # $ # $$.#
# *$#*#   ##
## @  #  ##
 #########
Solution: undefined

;19
##########
#.  .    #####
###  ###$##  #
### .#@$  $  #
# .  . $# $  #
#     $      #
# .###########
####
Solution: undefined

;20
##############
#     @#     #
#    $$#   # #
### $$  #.  .#
  ###   #  ###
######  ## #
#  ####  # ##
#   ###     #
#        #  ##
########  . .#
       #######
Solution: undefined

;21
  #####
  #   #
###$$ ##
#  $@$ #
# $$#  ####
#   #  ...##
# # $ $$...#
#     #...##
############
Solution: undefined

;22
   ########
  ##....*.#
###.*$* # #
# $   $## #
#  $$$  $@#
# .     ###
#########
Solution: undefined

;23
     ####
   ###  # ####
#### $  ###  #
#..+.#  ## $ #
#..###$###   #
#  $        ##
#  $# $###  #
#   #  # #  #
######## ####
Solution: l1d2r4u2d2r4u1r1d1u1r1u2l1d1r1d1l1d1l2r2u1d1l1d2u2r1u2l1d1r1d1l1d2r1u3d2l1r1u1d1l1u1l8u1l1d1r2l1d2r1u1l1u1r8u1r1d1u1r1u2l1d1r1d1l1u1l1d1r1d1l8d1l1u1r8d2r1u3d1l6d2r1u1l1u1r5u1r1d1l5u2r1u2l1d4l3d1l1u1l1u2r3u1r1l1d1l3d2r1u1l1u1r2l1d2r8u1r2u2l1d1r1d1l1u1l1d1r1d1l8d1l1u2l1u1r1d2r8d2r1u2l1u2r2d1l1u1l1d1r1d1l8d1l1u2d1r3d2r1u1l1u1r5d1r1u1l1u2r2d1l1u1l1d1r1d1l8d1l1u1d2l1u3d1r5u2r1u2l1d4l1d2r1u1l1u1r5d1r1u1l1u2r2d1l1u1l1d1r1d1l9d1l1u1

;24
###########
#.. ..#   #
# . #     #
##.##### ##
 #    ## ###
 #  $ ##$$@#
 ###     $ #
   #  $$## #
   ####    #
      ######
Solution: undefined

;25
########
#.  # +#
# # $$$#
#... $ #
#  $ $.#
#.$##  #
# $.#  #
########
Solution: undefined

;26
       ######
       #*##.#
       #. $.#
###########.#
#     ###   ##
# $ $$$ # # .#
#  $#  .     #
#    $  . #  #
######@   ####
     ######
Solution: undefined

;27
###    ####
#@###### .#
#  ## .  .#
# *## ##  #
# $ $ ##. #
# $  **   #
###$  #* ##
  #  ##   #
  #  ##   #
  #########
Solution: undefined

;28
#######
#  #  ######
#  #  ##   #
#  #       #
## #   #####
 # ###   $ #
 # ###$##  #
##  @      #
#   #####  #
#   #..    #
############
Solution: undefined

;29
  ######
  #    #
  #$$  #
  #    #
###$## #
# $  $$#####
# ##   #   #
#.*... $   #
#.@#####. .#
####   #####
Solution: undefined

;30
     ###
    ##.#
    #  #
#####**##
#     $ #
#  .#$  #
###$$   #
#@ .**  #
#### . ##
   #####
Solution: undefined

;31
#####  ####
#   ####  #
#     $@$ #
## #$###$ #
## # ##   #
#  # #  $##
# ...... #
#..### #$##
## $   $  #
 ######   #
      #####
Solution: undefined

;32
###############
#.   ##  ##   #
#.    #  ##   #
#..#    $    ##
#.##  ## ##  #
##### ##$ ####
   # $##  ##
   #@$  $  #
   ###     #
     #######
Solution: undefined

;33
        ####
      ###  ##
      #     #
 ######$$ $ #
##  # $... ##
# $    ##$.#
# # #  ## .#####
# $$$ ###  ....#
#  @ ## ########
######
Solution: undefined

;34
         ###
     #####.#
   ###   ..#
  ##.# .$.$#
  #  #### .#
###     $.##
#  $$###$$#
#    ##   #
#  # $@* ##
##    #  #
 #########
Solution: undefined

;35
        ###
      ###.#
#######...##
#.  ## .$$.#
# #.$      #
# $  $# ####
#$*$    $  #
# @#####   #
####   #####
Solution: undefined

;36
    #########
   ##.....*+#
   # $$*.####
   #   $ #
   # $ $##
####$   #
#    $ ##
#   #  #
########
Solution: undefined

;37
######
#  #.#
#. $ #######
# $ $  ## .#
# $ $ $  *+#
#      *.*.#
############
Solution: undefined

;38
#######
#. .$ ##
##*..*@#
##..#$$#
# *# $ #
#      ###
###$ $   #
  #      #
  ########
Solution: undefined

;39
        ####
   ###  #  #
 ###.####  #
 #    *.#$ #
## $ #### ##
#  $##### ###
# .  $ ## $@#
##.#  $     #
 #.  ####.  #
 #####  #####
Solution: undefined

;40
############
#..*...   .#
##@#### $$##
 ###  #$$  #
      #   $#
      #  $ #
      ###$ #
        #  #
        ##.#
         ###
Solution: undefined

;41
#############
#... ##     #
###.  #$ $  #
  # *   #$  #
  ##.* $# $@#
   ##      ##
    ## .$ ##
     ######
Solution: undefined

;42
####
#..#############
# ..$      $ $ #
# ..  $$# $  $@#
#  ### .   #####
#### #######
Solution: undefined

;43
####   #######
#  #####  . .#
#        #  ##
#   ###     #
#######  # ##
    ##  ## #
  ###   #  ###
### $$  #.  .#
#    $$#   # #
# @    #     #
##############
Solution: undefined

;44
  ###
  #.##
###$ ####
#@ .$   #
#  $.#. #
####$   #
  # ..* #
 ##  $ ##
 # $ ###
 #   #
 #####
Solution: undefined

;45
 #######
## $ ..#
#@$  $ #
###.$ .#
 # .* ##
 #$$ $#
 #. # #
 #  . #
 ######
Solution: undefined

;46
####   ####
#  ### #@ #
#    ####$#
#    #  # ##
##  ## .*  #
 #    $.#  #
 #  $ *.#  #
 ###########
Solution: undefined

;47
######
#    #
#    ### ###
#  # $ ###.#
## # # .# .#
 # #     * ###
 # #.$$ #  +.#
 #$$$  #######
 #     #
 #######
Solution: undefined

;48
############
#   ## .. .#
#      #.  #
##  #$   ###
 #### ## #
  #   ## #
 ##$$ #  ###
 #    #    #
 # $ #@  # #
 #   #     #
 ###########
Solution: undefined

;49
 ###########
 #   ##    #
 #*    $$# #
##..#$ $ # #
#.*.# $    #
##*.#$@$ $ #
#.*.. ######
#######
Solution: undefined

;50
##########
#...+    #
#####$##$#
   ##    #
   #. $#$###
   #   $   #
 ##### #   #
 #      ####
 # ###  #
 #      #
 ########
Solution: r1d3l1d1u1r1u1r1d4r1d2l1u1r1u1l3r2u3l2d1r1u1r1d3u3d1r2d1r2u1l4u2r2d1u1l2d2r2l2d2r1d2l1u5d1r2u2d2l2u1l1u3r3d2l2d1l1u2d1r3u2l6r4l1d3l1d1r1u1r1d3u2r2d1r2u1d1l2u1l2d2r1d2l1u5l1u3r3d2l2d1l1u2d1r3u2l5r2d2r1d2r2d1r2u1l4u1l2d1r1u1r1d3r1d2l1u5l1u3r3d2l2d1l1u2d1r3u2l3d1u1l1r1d2r3d1u1l2d3u1r2d1r2u1l3r1u2l2d4r1d2l1u5d1r2u2l2r2u2l3d2r1d1l1r1d5l4u2r3l3d2r4u5d1r2u2l2d1l1u2d1r3u2l3

;51
  ####
  #  #
 ##  #
 #  $#####
 #   ..$.#
 ##*##$#.##
###       #
#  ###$  +#
#      $  #
#   #  ####
########
Solution: undefined

;52
        ####
      ###+ #
#######....#
#  #   * $*#
#  $$ ###  #
#    $  $  #
##  ##   ###
 #########
Solution: undefined

;53
#### ######
#  ###.   #
#.$$      #
#@$  ###$##
##$$###. #
## $     #
#.  ##.$ #
#####...##
    #####
Solution: undefined

;54
          ###
        ###.#
    #####   #
   ## $  $  #
   #@$ #  $##
   ##   ##  #
  ##### #. .#
###   #$ $  #
#.*     ..###
###########
Solution: undefined

;55
        ###
        #.#
 ########.#
##   ## ..#
# $   $$..#
#@$ $$$ $.#
## $   ..##
 #########
Solution: undefined

;56
     ###
    ##.######
    #   .. .#
    # $#  ###
    # $  ##
    # $ ####
    # #$#  #
    #   #  ##
#####$$##$  #
#+*..       #
#############
Solution: undefined

;57
#############
# $   *.....#
#   $  .#####
#   ## ..#
# $$######
#  $@##
# $$$ #
#     #
#######
Solution: undefined

;58
    ####
#####. ###
#......  #######
#### $#$  ##   #
  ##  #  $$ .  #
   # ### $  ## #
   #*##### $   #
   # .#####$$ ##
   ## $ #   ###
    #@     ##
    ########
Solution: undefined

;59
####
#. #
#. ##
#...#
#.*$#########
#.     $  $ #
## $ $   $$ #
 #########@ #
         #  #
         ####
Solution: undefined

;60
     ######
######.   #
#   ###   #
#     $*.##
## ####  ##
 #$$ $ #$ ####
 #   @   . ..#
 #############
Solution: undefined

;61
      #####
##### #   #
#.$ ### $ #
#      $@ #
#  ########
# $ $ $ #######
#.        ....#
###############
Solution: l5u1l1d1l1d3r2u1d1u1l1u1l1u1r6l5d3r3u1d1l3u2d2l1u1d1r4u1d1l3u3r3l3r5u2r2d2l6u1l1d3l1d1r11l10u3r7u2l1d1r1d1l6u1l1d3l1d1r10l6u1l1d1l2u3l1d1r1d2r2u1l1d1l1u2l1u1r6l5d3l1u1r1u2r5u1r2d1l6u1l1d3l1d1r9l8u3l1d1r1d2r5u1l4d1l1u2l1u1r6u1r2d1u1l2d1l5d3l1u1r1u2r5u1r2d1l6u1l1d3l1d1r8l8r1u3l1d2

;62
  ########
  #....  #####
  # #.   #   #
  #   #    # #
  ##     ##  #
  #*$###     #
### $  ## ## #
#@ $    $$   #
#####     #  #
    ##########
Solution: undefined

;63
####
#  ### #####
#    # #@  ###
#  $$####$  .##
##        $$. #
 #  ######.*..#
 ####    ######
Solution: undefined

;64
#######
# @   #
#  $$$######
# $ $ ##   #
###      $ #
  ####.$   #
   ##  ##$##
#### *# $. #
#.......   #
############
Solution: undefined

;65
  #########
  #  ## $.#
  # . ..*+##
  # $#####.#
  #$ # #   ##
###  ###$$ .#
#  $ $    $##
# .   ##   #
############
Solution: undefined

;66
         ####
######   #..#
#. $ #####.+#
# $       *.#
#   $ $ $ $ #
#  ##########
####
Solution: d1l7u1l2d1u1r2d1r1d1l1u1r3d1l1u1r3d1l1u1r3d1l1u1l6u1l2d1r8d1r1u2d1l10d2r1u1l1u1r9d1r1u1l7d1l1u1r3d1l2u1r4d1l2u1r4d1l2u1l7d2r1u1l1u1r8d1r1u2d1l6d1l1u1l2d2r1u1l1u1r9l4d1l3u1l2d2r1u1l1u1r8d1r1u1d1l7u1l2d2r1u1l1u1r8

;67
       ###
     ###@#
######. $#
#   $ $$ #
#  $ *...#
##### $  #
    # .###
    #   .#
    ######
Solution: undefined

;68
          ###
          #.#
  ###     #.#
###.#     #.#
#   #     #.#
#   ###   #.#
## $  #  ## #
## $ $####  #
# $#   $.$$$##
#     #@$  ..#
##############
Solution: undefined

;69
 ######
 #  #.####
##$ #$@  #
#  $ .##$#
#..$. .*.#
## $  ## #
 ####$ $ #
    #   .#
    ######
Solution: undefined

;70
         ####
         #  ###
#####   ##$ #.#
# $.#####.  $$#
#.$ @$ ####   #
# $#$$  .#.   #
#    $# #  ####
# ..# #   ##
## .. #  ##
 #########
Solution: undefined

;71
###### #####
#    ###  @#
##  .   $#$#
 ###### .* ###
   #### ## $ #
   #..  $    #
   ###  ##$  #
   #.. $     #
   ###########
Solution: undefined

;72
#####  ####
#   ####  #
#  $   $  #
##$# ###  #
## #.   $##
#  #.#.  #
#  ....# #
## ### #$##
 # $@$    #
 ######   #
      #####
Solution: undefined

;73
        #####
        # $.#
        #  ##
 ##### ## $.#
 #.* ###.#  #
## . ..#$#$ #
#.@ #$$     #
#     ### $$#
#   ### #   #
#####   #####
Solution: undefined

;74
######  ####
#    #  #  #
#    ####  #
# #    ##  #
# # #  ## ##
#.#    ##$ #
#.##       #
#.#  #$## ##
#.# $@$  $#
#.#####   #
###   #####
Solution: r2d1u1l1u3d3u2r3l5d1l1d1r1u2r5u3r1u2l1d4r1d1l4d2r1d1r2u6d6l2u1r1d1r1u1d1l1u1l2u3l2d3r3l1u2l1r1d2l2u2r1u3r1d3l1u3l2d2r1d1r1u2r1u1l2r1d2l2u2r1u1l2u1l1d7u6r3d1r2d3r3u3r1u2l1r1d2l1d3l5d2r2u2r3u3r1u2l1d4r1d1l5u2d2r1d2l2u2r1u2r1d2u3l3d2r1d1r1u2r1u1l2r1d2l2u2r1u1l2u1l1d6u5r3d1r1d3l1d2r2u3d3r1d1r2u6r1u2l1d4r1d1l5r1d2l2u2r1u3r1d3u3l3d2r1d1r1u2r1u1l2r1d2l2u2r1u1l2u1l1d5u4r3d1r1d2l1d3r2u1d1l2u2r4l2d2r1d1r2u6r1u2l1d4r1d1l5r1d2l2u2r1u3l2d2r1d1r1u2r1u1l2r1d2l2u2r1u1l2u1l1d4u3r3d1r2d5r2d1r1u6r1u2l1d4r1d1l5r1d2l2u2r1u3l2d2r1d1r1u2r1u1l2r1d2l2u2r1u1l2u1l1d3

;75
    ############
   ##.##.* * $.#
####. ###$.$  .#
# $  $### .#$$$#
#. .         $@#
################
Solution: undefined

;76
######
#.+*.#
##**## ####
## .####  #
#. $$     #
#  $  $#  #
##.##$ $ ##
 ####    #
    ##  ##
     ####
Solution: undefined

;77
######
#. * #####
### .$.$.#
  #$$    #
  #+$$..$#
  #$$   .#
  #.######
  ###
Solution: undefined

;78
#####  ####
#...####  #
##..      #
 # $ $ $  #
 ####### ##
    #### #
    # $  ##
    #   $ #
    #  #@ #
    ####  #
       ####
Solution: undefined

;79
  #####
###  .###
#  $.# @#
#     $ #
###$**$.#
  #   ###
### #$ #
#.  .  #
########
Solution: undefined

;80
#####   ####
#  @#   #  #
#  ## ###  ##
# ##  # $   #
#  #### $$. #
# $ #.*   $##
#  $$  ##$ #
# # # .##  #####
#   ##### .....#
#####   ########
Solution: undefined

;81
 ####
##@ #
# $$# #####
# $ ###.. #
#   #. .. #
#   #    ##
### ## #  #
# $  #    #
# $       #
#      ####
########
Solution: undefined

;82
 #######
 #  #  #
 #     ####
##  # $#@ #
#   #   $ ##
#   # $#  .#
#####  #.  #
    ##### .#
        ####
Solution: undefined

;83
#####
#  .#
# $ ########
##...    $.#
 # $ $ $ $@#
## #########
#  $ ###
#      #
### . .#
  ######
Solution: undefined

;84
##########
#+ # .   #
#$$   $#*##
# $#$  # .#
#    ### .#
#   #### .#
## $  .$*.#
 #   ###  #
 ##### ####
Solution: undefined

;85
    ######
    #    ###
    #  #$#.###
    #  #  ...#
######$#$  ..#
#@$        .##
# $$##$ #   #
#   ##  #  ##
############
Solution: undefined

;86
        ####
        #..##
      ###. .#
      #@$  .#
#######$$#  #
#    ##  ##.#
# $    $ #  ####
# $  $$  #  . .#
####  #  #######
   #######
Solution: undefined

;87
######
#    #######
# $ $##   .###
#      $  .#.##
###### ## ....#
     #$####.  #
     #   #    #
     #   $ # ##
     # $#$##$@#
     #    ##  #
     ##########
Solution: undefined

;88
   #######
   #     ###
   #  $  $ ####
   ##  ##$@##.#
 #### $## ###.#
 #  ## ##  # .#
##    $    # .#
#   ##  #     #
#   ##  ##   .#
###############
Solution: undefined

;89
 ###
 #+#     ####
 # #  ####  #
##.## #..  $###
#.  # ###.#   #
#. $##### #$$ #
#$$           #
#  #####  #   #
#  #   #####$ #
####       #  #
           ####
Solution: undefined

;90
   ####
  ##. #####
###.. ##  ##
#  *$ $    #
#  .*.#    #
###.* ###  #
  # $ # ####
  ##$ #
  # $$#
  # @ #
  #####
Solution: undefined

;91
##########
#...##   #
#.       #
#  #######
## ########
 #   ##   #
 # $ #    #
 ##$ #  ######
 #   $    $@ #
 #   #  ##   #
 #############
Solution: undefined

;92
#####
#@#.#
#...#
#**.#
#..##
#*  ##
# $  ###
# $$   ######
#   $$$ $   #
##          #
 ############
Solution: undefined

;93
  #########
### $  .  #
#@ *  #.  #
### .*. $##
  ## $ $ #
   ###  ##
     ####
Solution: undefined

;94
     #####
 #####   #
 #  ##   #####
##$@###  $ $ #
#  ##  **.*  #
#      ..    #
##############
Solution: undefined

;95
       ### ###
  ######*# #.#
###      ###.#
#@$ $ ##$ ##.#
# $ $     ##.#
# #$####   ..#
# $ .# ####  #
######    ####
Solution: undefined

;96
   #####
  ##   ##
 ##@$.* ##
 # *$$  .#
##  .#####
# $.$ #
#    .#
#######
Solution: undefined

;97
     ####
    ##  ##
    # $@ ###
#####  #$#.###
#  ## $#  ...#
# $### #  ...#
#       $  ###
# $ ##$ #   #
#   ##  #   #
#############
Solution: undefined

;98
   ###
####.######
#.  *##   #
##.$    $ #
##$* ###$##
#@$ .$    #
###.$..   #
  #########
Solution: undefined

;99
###########
#     #.  #
#  $  #.$ #
#    ##.###
## $$$ *.#
 #    .*@#
 #########
Solution: undefined


