;1
    #####
#####  .#
#.    @ #
# $$$   #
### #####
##   ####
#.      #
#  $  . #
#     ###
#######
Solution: 3-2d3,2-7r3,4-6l2,5-3l1,3-2d4,1-3r2,3-8u5,2-2r4,7-3u1,5-3l1,3-2d3,3-7u4,4-2l2

;2
   #####
  ##.  ##
  #   $ ##
 ##$ ##  ##
##@ ###   #
#..$   ## #
###$   #  #
 #   # #  #
 #    .   #
 ##########
Solution: 2-5r1d1,5-5l3,2-7r1,7-2l1,3-2d2,4-5l1,6-2l1,4-3u1,4-6d1,3-8r2

;3
      ####
#######. #
#@$  $ $ #
#  #   . #
#   ##   #
###$ $  ##
  #   #* #
  #.# #  #
  #   . .#
  ########
Solution: 3-4d2,7-7u2,6-5l1,7-3d1,4-2r1,7-4d2,7-1d2,5-2r1,1-2r3,3-8u2,7-6d1,8-8l3,7-3d4,6-8r1,3-8r2,3-4d2,3-5r3,7-4d1,7-1d1,8-3l1,4-2r2,7-3u1,5-3r1

;4
###
#.########
#. #    .#
# .     ##
# ##.   #
#   $  ##
##  $ $###
 ####$$  #
 #.    $@#
 #########
Solution: l5,5-8u5,4-2r3,7-7l1u2,5-8u4,3-6r1u1,6-3l4,1-4u2,5-7u3,6-3l4,1-4u1,6-5u1,7-3l4

;5
       ####
 #######..#
 # $      #
##  #  .  #
#@   ##   #
#### $ $$##
   #$  #  #
   # # #  #
   #. . $.#
   ########
Solution: 2-2r6,9-3u1,4-5d1,8-4d2,9-8l1u6,6-6u1r1,8-4d2,4-5r1,4-8u1,8-8u4,9-3l1,5-5r2,8-4d2,8-8u4,4-7u1,8-8l2,8-2d5,7-8r1,4-8r1,4-4d3

;6
###  ###
#.####.##
#. #    #
# .     #
# ##. $ #
# $ * $##
##@$   ###
 #### $  #
    #    #
    ######
Solution: r1,3-5r1,7-4l1d1,1-5r1,6-5l1,5-5u2,4-2r1,6-3u1,7-7l1,5-8u4,6-7u2,7-4l1,3-6r1u1,6-3l4,1-4u2,4-5u1,5-3l3,1-4u1,2-5r1,4-6u2,5-3l2,5-7u1,6-5l1,6-4l1

;7
      ####
      #. #
#######..#
# $  $   #
#  #    $#
#   ##$  #
###@ $  ##
  #   #$ #
 #### #  #
 #..  .  #
 #########
Solution: 7-8u5,7-1d7,8-9l5,4-3r2,7-4u1,7-1d7,8-9l4,6-6u2,4-3r2,7-4u1,7-1d6,4-6r2,7-7d1,8-9l1u7,8-5u2,1-3r5,7-4u1

;8
##########
#..      #
#  ####. #
#   ##   #
###$$@$ ##
  #.$ #. #
  # #$#  #
  #      #
  ########
Solution: r1u1r1d2r1d2l1u5r1u1l6d2r1d1r3u1r1d2r1d2l1u4d4l2u2d2r2u4r1u2l6d2r1d1r3u1r1d1l4d1u1r4d1u1l4d1r1u1r3d1r1d2l3u2d2l2u1d1r5l3u2l1u1r2u1r1u1r1u1l5r3,7-5u2,7-7u1

;9
      ###
#######.##
#+.      #
#  ####. #
#   ## $ #
### $   ##
  # $ #  #
  # #$#  #
  #   .$ #
  ########
Solution: r7d1l1d3r1d2l1u6l5d2r1d4r3l3u3r3u1r1d2r1d2l1u5r1u1l6r5d6u3l4d3r3l1u2d2l2u3r3u1r1d2r1d2l3u3l2d1r1u1r3d1r1d2l3u2l1u1r2l1d3r3u2l1u3r1u1l5,7-8u4,3-8r2

;10
  ####
### .##
#.    ####
####*   @#
#### $ $ #
#.## #####
#   . $ ##
#$$      #
#. ###   #
#### #####
Solution: l3u1l1d4l2r1d1r3l2u4d4r2d1r2u1l1u1l2d1l1u4r1u1l3r3d1l1d3r3d2l1u1l1u1l1u3r2d1l1u1l1d3l1d1r3d1r2u1l1u1l2d1l1u5d4r3d2l1u1l1u1l1u3r4d1l3u1l1d3l1d1r3d1r2u1l1u1l2d1l1u3d2l1d1u1l2d1r2u1r4d2l1u1r1u1l5d1l1u1r1d1r3u1r2d2l1u1r1u1l2

;11
   ###
   #.##
   #  ####
   #*    #
   # $@$ #
#### #####
#.  .   ##
# $    $ #
#. ###   #
#### #####
Solution: u1l1u1l1d4l1d1r1u1r2d2r2u1l1d1u2l4d1l1u1l1d1r2u1r4d2l1u1r1u1l5d1r3u1r2d2l1u1r1u1l2d1l1u5r1d1r1d1l1u1l1d3l1d1r2l1u3r1u1r3d1l3u1l1d3r3d2l1u1l1u1l1r1l2d1r3d1r2u1l1u1l2d1l1u3d2r3d2l1u1r1u1l2

;12
##########
#...  .  #
#  #     #
# $  ##  #
#$$$#  ###
#@$  . #
########
Solution: r3l3r2l2u1d1r2u1d1l2u1r1u2l1u1r5d1l2d1u2l3d2r1d2l1u2r1u2r3d1l1d1l1r1u2l2d2l1d2r2u1d1l2u1r1l1u1r1u2l1d2u2r4d1l1u1l2d1l1r1d3l1u2r1u2r2d2l1r1u2l2d2l1d2r2u1d1l2u2r1u2r2d2l1d2l1r1u2r1u2l3d1r1u1r2d2l1d2l2u1r1u2l1u1r3d2l2d2r1l2r1u3l1d1r1d2r1u1l1d1l1u3r1u1r2d2l1d1l1u2d1r2u1r2u1l2r1d1r3u1l1

;13
     ####
     #  #
######$.#
#  # .  #
#   $  .#
#   $ #.#
###$  ###
  # #$$@#
  #.#.  #
  #######
Solution: d1l2u3l2d2u1r2u1d3u3l2u1d1r2u1r1l1d2l2u2r3u1r1d1u3l1d1r1l1d1r1d1l2d1l2u1r1u1r2d1r1u1l3d1r2l1d4r2u1l1d1l1u4l4d1r3u1r1d3

;14
      #####
    ###  .#
    #    ##
    #.$   #
 #### $   #
 #.##*#####
 #     $ ##
##  @ $   #
#.  ###   #
##### #####
Solution: r3d1r2u1l6u1l1d1r1d1l1r1u1r5u1l5d1l1u1r1d1r2u3r2u2l2d4l1d1r2l1u3r1u1l1u1r2d1r1u1l1u1r1l1d2l2d2u2d3r3l3u1d2r1u1r2d2l1u1l1u1l1u3r4d1l3u1l1d3l1d1u1r2d1l2u1l2d2r1u1l1u1r2d1r1u3d3r3u1l2d1l1u1

;15
      #####
 ######.$ #
 #@$      #
 #####$   #
##. ## #  #
#. $   $ ##
##   .#  #
 ####.####
    ###
Solution: r5d1r2u2l1d1r1d2l1d1l3d1u1r3u2r1u2l1d1r1d1l1d2l3d1l3u2r1d1l1d1r2l1u1r2d1u1r2d1r1u2r1u2l3d2u2r3d2l1d1l4d1l2u2r1d1l1d1r2u1r4u1r1u2l1d1u1l2d3r2u2r1l2u1l1d2u1r2d2l5d1l1u1,8-1d1r1d1l2u1l1d2u1r2d2l6

;16
       ####
      ##..#
 ######   #
 #   ##.$ #
 #    $   #
 # $ #  # #
#### #   $#
#  $*#.. @#
#        ##
##########
Solution: l2u3l3u1l2d1r4d3r3u5d2l1u2l1d4r1d1l1d1l3u3d3r3u2l1u2l2u1l2d1r4d1r1d2r2u4l2d3r1d2l7u1r1d1r2u4l2d1r1,4-6u1l1u1r3d1r1u1,2-7r1

;17
       ####
      ## +#
 ###### . #
 #   ##.  #
 #     $  #
 ##*$ $ $ #
 #  #######
##   #
#.   #
######
Solution: d2l1d1l4u1l2d1r5l4d3r1d1l2r1u4r2d1l1u1l1d2l1d2r1u3r1u1r3d1l1r1u2r2d2l1r1u2l2d1r1d1r1u3d1l2d1l3u1l2d1r5l1d1l2u1l1d2l1d2r1u3r2u1r2u1r2d2l5u2l2d1r4d1r1u1d1r1u2

;18
 ######
 #.. @#
 ###$ #
  #  ##
###$ .#
#. $  #
# #$ ##
#   $ #
###   #
  #. ##
  ####
Solution: d1u1l1d2l1r1d2l1d3r2u1l1u5r1u1l2r1d7l1u1l2u2r2l2d2r3u5r1u1l1r1d1l1d3u2l1d1r1d3l3u2r2l2d2r2u1r1u1l1u1d1l1r1u1r1

;19
######
#.##.###
#.##   ###
#. #  .  #
#        #
#.$   # ##
####. $ #
#  #$# ###
# $ $ $$ #
#    @   #
##########
Solution: l2u1r1u6d3r1u1r2d2l1r1u2l3d5r2u1l1d1l1u4r1u1d1l2u1r1d1r1u1l1u1r1d1l4d1r1u1r1l1r2d1l1r1u1r3d2u2l3d5r4u1l3d1l1u5l3d1r1u1r3u2l1d1r1d1l3d1l1u3d2r6d2l1d1u1r1u2l3d5r3u1l2d1l1u4r1u1l3d1l1u2d1r3d1u1r3d2l2r1d3l2u4r1u1l3d1l1u1r3d1l2r2d4l3u1r2d1r1u2

;20
      #####
##### #   #
#  @###$  #
#.$  ##   #
#   .#  $ #
####..$$ ##
  ##. $  #
  #.  #* #
  #     ##
  #######
Solution: d2r1d3u2r1d3r2l2u2r2u1l1r2u1d1l2,3-3l1,6-5l1,4-6u1,8-2d1l1d1,9-4l1d1l1r1u2l1r1d2l1d1l2d2r2u1r1u3d1l1d1u1r1u1r1u2l1d1l1d1l1d1u1r1u1r2d1l1d1l1d1l2u1l1d1r1d1l1r1u1r3u3l1d1l1d1u1r2d2l3r3u1l3r3u4l1d3r1d1l2

;21
    ######
  ###.$. #
 ##.*  # #
 #  $$ * #
 #.    $ #
 #####   #
######*###
#.$ #.$@#
###     #
  #######
Solution: undefined

;22
  #######
 ##.*.. #
##. $   #
#.$ #  ###
### ##   #
# $$# $$ #
# $    * #
# @###. ##
##.# ####
 ###
Solution: undefined

;23
   #######
  ##..* .#
###. $   #
# .$ #  ###
# ## ## $ #
#   .#  $@#
##    $ $ #
 ###  .#$ #
   ###   ##
     #####
Solution: undefined

;24
#########
#. #  . ##
# *    $ #
#.$ $ #.$#
# ###. # #
# # # $$ #
#$# # $ .#
#@# ###..#
###   ####
Solution: u5r2d1l1u1r1d1u1d1u1r1u1r3d1r1d3u3l2u1l2d1r1d4u5r2d1r1d4u4l1u1l2d5r2l2u2r1d1l1u4r2d1r1d3l1r1u3d3u3l1u1l2d5r1,7-5d1u1r1u3l1u1l3d1l1d1r1u2r3d1l4,5-4u2l1u1r1,7-5l1d1l1u1

;25
 ######
 #.##.#
 #.##.#
##..$$##
#.$$#@ ###
### ##$$ #
#   # $  #
#        #
###  .#$ #
  #####  #
      ####
Solution: u2d2r1l1u1l2d2u1l1u2d2r1d2l1d1r1d1r2u2r1d1l1d1l2u5r2d1r1d1u1l1u1l2d5r2u2d1l2r5d2l1u1r1u1l3,6-7u1,8-6u1,6-4l1r1d1,8-5l1d2,5-6r1,7-7u1,6-4d1,5-6r1,5-7l1d1l1u4,2-3r2,5-4u1,1-7r1,3-8u4,4-3l1,2-4u1,8-6l1,6-5d1,7-7l3,3-8u4,4-3l1,8-5l1,6-4d2,7-7l3,3-8u4,7-9u1r1u1l2u1l1d1

;26
  ########
  #+*....#
  ##*#$**#
   #     #
   ### $ #
   ##    #
#### $#$##
#      $ #
#        #
##########
Solution: r3d2r2d2l3d1l1d2r2u1l3r1d1r4u1l2d1l2u2r1u1r3u2l4r4l2u2r1l1d2r2d2l1d1u1r1u2l1d2u2l1u2r1d2r1d2l2u3r1u1l3r2d1r1d1r1d1l1d1l1u3r1u1l2r2d3l1d1l1d1l1d2r2u1l1r1d1r2u1l1u3r1u1l1d1l1u2r1u1l1r1d7l2u1r1d1r1u4r1u1l1d1l1u2d3l1d3l2u1r3d1r1u6d6l6u1r5d1r1u5

;27
 ########
 #....* #
 #####. ###
   #.**$  #
   #  $   #
   # #  # #
####$ # $ #
# $     $##
# @###   #
#### #####
Solution: undefined

;28
   ###
   #.###
 ###*#.#
##...*.#
#. $$# #
# $$ $ #
#    $ #
##### $#
  #@   #
  ######
Solution: undefined

;29
     ####
######  ##
#.*.*. $ #
##*.###  #
 # .# #$ #
 #$.###@ #
 #   . $ #
 ## $  $ #
  #####$ #
      #  #
      ####
Solution: r1d2u4l1r1d2l1r1d2l1r1u2l1r1l1u1d1r1d2l1u1l4u4l1r1d2l1u1r1d3l1u2d1r1d1r5u4l2r2d3u1d2l1r1u2d3l1u1l2d1r1u1l3d1r1u1r4u2l1d1r1d1l4d1l1u4d3r5u4l1d3r1d1l4d1l1u3d2r5l2d1l1r1u1r2d1l1r1d2l1u5d2l2d1r1u1r2d2l1u2d1l1u1l3d1r3u1r2d2l1u1r1u1l4d1l1u2d1r5u2l1d1r1d1l4d1l1u1r5u4l1d3r1d1l2

;30
     ###
###  #.###
#.#  #.$ #
# ####*..#
# .   $ .#
# $##$ $ #
## @  $# #
 ### #  $#
   #     #
   #######
Solution: undefined

;31
        ###
      ###.#
      #.#.#
     ## #.#
######  . #
#. $  $ $ #
##$ #   ###
 #.$ #$$  #
 #+$      #
 ##########
Solution: r5u5,4-5l2d1,3-8u2,6-4d1,9-8l6,2-5r4,7-4d1,7-5d1,5-6r1,6-8u1r1,7-5d1,6-7u1,7-5l2,9-5l1,7-6u1,6-4r2,9-5u3,7-8u3,6-4r2,9-5u2,9-7l1,7-8u3,6-4r2,9-5u1,3-5r3,7-6u1,6-4r1

;32
    ###
 ####.#
 #..*.#
##* $$#
#..*$@#
# $  ##
#  $###
##$   #
 #  # #
 ##   #
  #####
Solution: u2l2,3-3d1,2-4d1,5-4l1u1,3-2r1,4-5l1u2,3-5d1,3-6d1,3-9u4,3-3d1,1-6r1u1,1-4r2,5-4l1,4-5l2,2-4r1,4-5u2,1-6u1,3-5d2,3-9u4,2-8u3

;33
###########
# ....##  #
#  $.$    #
####  $   #
   ###  ###
     ##$$@#
      #   #
      #####
Solution: 7-6u2,6-4u1,5-1d1r2,4-2l1,7-4u1,8-1d1,9-3l2,8-2l3,3-2r4,6-4u1,7-2l2,3-2r1,4-3r2,1-2r1,6-2l1,4-3u1l1,1-2r3,6-2l1,5-1l2,4-3u1,5-1l1,7-4u1,8-1d1l3,4-3u1,9-3l2,6-4u1,7-2l1,5-3u1,9-5l1,7-6u3,8-2l3

;34
  #####
  #...##
  #..*.#
  # $$ #
### $ $#
# $    ##
#  ## $ #
# ###   #
#  @##  #
#########
Solution: 1-5r2,4-2r1d3,6-5d1,6-8u1,5-7u5,3-5r1,5-4l1,3-5u3,4-4u2,5-4d1,6-5d1,6-8u1,5-7u4,7-6l1,5-7u2,6-3d1l1,4-5u2,6-4d1,7-6l1,5-7u3,6-3l2,3-4u1

;35
       ####
       #..#
    ####* #
   ##.. .*#
   #.$.#  #
   ##  #$##
  ####$   #
###  # $$@#
# $   $  ##
#     #  #
##########
Solution: 8-6u2,9-4u1l3,6-4l1,7-6d1,6-7u2,9-7l2,7-9u1l2,8-3u1,9-3u1,3-8r4,8-9u5,6-6d1,7-8l2,8-2d1,6-3d3,8-5u1,7-3r1,6-8u1r1,6-5d1,8-8u5,3-8r4,8-9u5,6-8u4,1-8r5,7-9u1,8-7l1,6-8u3

;36
       ####
       #..#
    ####..#
    #.  $ #
    ##.#  #
 #####$   #
 #@$.    ##
##$  $$ ##
#  $ #  #
#   #####
#####
Solution: r1,4-8l1,3-6r1,1-8r1,3-9u1,2-6d1,4-6r2u2,8-4u1,7-3l1,4-7l1,1-8r1,3-9u1,2-6d1,3-8u1,8-6l2,6-8u1l2,8-3u1,6-7u2,4-6r2,7-7u1,6-3d2r1,8-6u3,5-6r1,7-7u1,6-5r1,8-6u2,7-3r1,9-4u2,1-8r1,2-6r4,7-7u1,6-5r1,8-6u2,7-3r1,9-4u1,2-7r1,3-9u1,4-8u1,3-6r2,6-7u2,3-8u1,2-6r1

;37
####
#..#
# *###
#.*..###
#..#.*.####
# $#$   $ #
#$$ $$#$$ #
# @       #
###########
Solution: 9-5l2,5-7u1,1-7u4r1u1,1-3u1,3-6l1u3,5-6l1u2r1d1,4-6l1,2-7u3,1-7u3,7-5l2,4-4d1,5-7u1l2,2-7u2,6-5l1,4-4d1,5-6l3,1-7u2,7-7u1,8-5l2,5-6u1,8-7u1,9-5l4,4-6u1

;38
 ######
 #.*..#
 ##.$*#
## .*@#
# $  ###
#  $$$ #
#      #
########
Solution: u1l1,4-1l1,3-1d2,2-3d1,4-6u1,2-6u1,4-5l1u3,5-3l1d1,4-6u4,3-2d2,6-5l1,4-6u3,3-2r1,3-6u3,1-4r1,3-5u1,1-5r2,4-6u2

;39
   ####
 ###..###
 #.**.*.#
 ###  *###
#####  $ #
#@$    # #
#### $$$ #
   #     #
   #######
Solution: r3,8-4l2,6-7u2,4-5r1u3,4-3u1l1,5-2r1,5-4r1d1,6-2d1,5-7u4,6-2l2,6-5u1,6-7u1,8-6l2,6-4d1,6-2d1,5-7u4,6-2l1,6-5u2,6-7u3,8-4l2,5-5u2

;40
    ###
  ###+#
 ##.**#
 #.** ##
 #  $. #
##$**  #
#  $ ###
# $  #
#    #
######
Solution: d2,5-3d1l1d1,4-5d1l1,5-2l1,4-4u1,1-6r1u2,2-5r1d1,4-6u2,6-5l2,2-4r2,5-5u3,2-5r1,4-6u1,3-4r1,5-5u2,4-8u3,3-4r1,2-8u1,1-6r2,4-7u1,3-8u2

;41
                 #################
                 #        @      ####
             ##### ####### ##### #  #
             #                      #
             #  ########## ######## #
             ## #                 # #
              # #  . . . . . . .  # #
  ############# # . . . . . . . . # #############
  #           # #  . . . . . . .  # #           #
  # . . . . . # # . . . . . . . . #   $ $ $ $ $ #
###  . . . .  # #                 # #  $ $ $ $  #
#   . . . . . # ################### # $ $ $ $ $ #
# #  . . . .                        #  $ $ $ $  #
#   . . . . . # ########## ######## # $ $ $ $ $ #
###  . . . .  # #                 # #  $ $ $ $  #
  # . . . . . # # $ $ $ $ $ $ $ $ #   $ $ $ $ $ #
  #           # #  $ $ $ $ $ $ $  # #           #
  ############# # $ $ $ $ $ $ $ $ # #############
              # #  $ $ $ $ $ $ $  # #
              # #                 # ##
              # ########## ########  #
              #                      #
              #  #####################
              ####
Solution: 39-9l3,35-7d13,36-21l20,15-22u9,17-12l12,4-13u3,39-15l3,35-14d6,36-21l20,15-22u9,17-12l10,6-13u3,41-15l5,35-14d6,36-21l20,15-22u9,17-12l8,8-13u3r5,20-18l1,22-18l1,21-17l1,20-16l1d1,24-18l1,23-17l1,22-16l1,21-16d1,26-18l1,25-17l1,24-16l1d1,28-18l1,27-17l1,26-16u3,27-12l11,15-13u9,14-3r11,26-2d6,27-9l8,26-19u6,27-12l11,15-13u9,14-3r11,26-2d3,27-6l8,18-5d1,24-17r1,26-18u5,27-12l11,15-13u9,14-3r11,26-2d6,27-9l6,24-16r1,26-17u4,27-12l11,15-13u9,14-3r11,26-2d6,27-9l4,23-15r2,26-16u3,28-12l12,15-13u9,14-3r11,26-2d6,27-9l2,21-16r4,26-17u4,28-12l12,15-13u9,14-3r11,26-2d6,25-9r6,22-16u1,21-14r4,26-15u2,28-12l12,15-13u9,14-3r11,26-2d6,25-9r4,23-19u4,22-14r3,26-15u2,27-12l11,15-13u9,14-3r11,26-2d6,25-9r2,24-19u4,23-14r2,26-15u2,27-12l11,15-13u9,14-3r11,26-2d4,27-7l6,19-16r6,26-17u4,28-12l12,15-13u9,14-3r11,26-2d4,27-7l4,19-15r6,26-16u3,27-12l11,15-13u9,14-3r11,26-2d4,27-7l2,21-19u4,20-14r5,26-15u2,27-12l11,15-13u9,14-3r11,26-2d4,25-7r6,19-19u4,18-14r7,26-15u2,27-12l11,15-13u9,14-3r11,26-1d5,25-7r4,22-19u4,21-14r4,26-15u2,27-12l11,15-13u9,14-3r11,26-2d4,25-7r2,20-19u4,19-14r6,26-15u2,28-12l12,15-13u9,14-3r11,26-1d6,25-8r6,17-18r1,19-19u4,17-14r8,26-15u2,28-12l12,15-14u10,14-3r11,26-2d5,25-8r4,17-16r8,26-17u4,27-12l11,15-13u9,14-3r11,26-2d5,25-8r2,18-18u1,17-16r8,26-17u4,27-12l11,15-13u9,14-3r11,26-2d5,27-8l8,17-15r8,26-16u3,27-12l11,15-13u9,14-3r11,26-2d5,27-8l6,29-15l2,26-16u3,27-12l11,15-14u10,14-3r11,26-2d5,27-8l4,28-16l1,26-17u4,28-12l12,15-14u10,14-3r11,26-2d5,27-8l2,28-18u3,29-14l2,26-15u2,28-12l12,15-14u10,14-3r11,26-2d3,27-6l8,31-15l4,26-16u3,28-12l12,15-13u9,14-3r11,26-2d3,27-6l6,30-16l3,26-17u4,27-12l11,15-13u9,14-3r11,26-1d4,27-6l4,29-19u4,30-14l3,26-16u3,28-12l12,15-13u9,14-3r11,26-2d3,24-6r6,33-15l6,26-16u3,28-12l12,15-13u9,14-3r11,26-2d3,24-6r4,32-16l4,27-17u2,28-14l1,26-15u2,28-12l12,15-13u9,14-3r11,26-2d3,27-6l2,31-17l4,26-19u6,28-12l12,15-13u9,14-3r11,26-2d3,25-6r1,29-8l1,31-8l1,33-8l1,23-8r1,23-6r1,21-6r1,21-8r1,19-6r1,19-8r1,17-8r1,17-6r1,32-18l5,26-19u6,27-12l10,17-12l1,15-14u10,14-3r11,26-1d7,33-17l6,26-18u5,27-12l11,15-13u9,14-3r11,26-2d4,40-14l2,37-13d1,39-15l3,35-14d6,36-21l20,15-22u9,16-12l5,10-13u3,43-15l7,35-14d6,36-21l20,15-22u9,17-12l4,12-13u3,38-12d2,40-15l4,35-14d6,36-21l20,15-22u9,16-12l4,11-13u2,38-10d4,39-15l3,35-14d6,36-21l20,15-22u9,17-12l7,9-13u2,39-11d3,41-15l5,35-14d6,36-21l20,15-22u9,16-12l8,7-13u2,40-12d2,41-15l5,35-14d6,36-21l20,15-22u9,16-12l10,5-13u2,39-9d5,40-15l4,35-14d6,36-21l20,15-22u9,16-12l3,12-13u1,41-9l5,35-8d12,36-21l20,15-22u9,17-12l6,10-13u1,43-9l7,35-8d12,36-21l20,15-22u9,16-12l7,8-13u1,45-9l9,35-7d13,36-21l20,15-22u9,17-12l10,6-13u1,47-9l11,35-8d12,36-21l20,15-22u9,17-12l12,4-13u1,42-10l4,37-9d5,39-15l3,35-13d7,36-21l20,15-22u9,17-12l13,3-11d1,2-13r9,12-12d2,40-9d5,41-15l5,35-14d6,36-21l20,15-22u9,16-12l12,3-11d1,2-13r7,10-12d2,44-10l6,37-9d5,38-15l2,35-14d6,36-21l20,15-22u9,17-12l13,3-11d1,2-13r5,8-12d2,47-10l9,37-9d5,38-15l2,35-14d6,36-21l20,15-22u9,16-12l12,3-11d1,2-13r3,6-12d2,43-11l5,37-10d4,39-15l3,35-14d6,36-21l20,15-22u9,16-12l12,3-11d1,2-13r2,5-12d1,45-11l7,37-10d4,38-15l2,35-14d6,36-21l20,15-22u9,17-12l13,3-11d1,2-13r1,4-12d2,47-11l9,37-10d4,39-15l3,35-13d7,36-21l20,15-22u9,16-12l12,3-11d1,2-13r4,7-12d1,42-12l4,37-11d3,38-15l2,35-14d6,36-21l20,15-22u9,17-12l13,3-11d1,2-13r6,9-12d1,44-12l6,37-11d3,38-15l2,35-14d6,36-21l20,15-22u9,16-12l12,3-11d1,1-13r9,11-12d1,46-12l8,37-11d3,38-15l2,35-14d6,36-21l20,15-22u9,16-12l12,3-11d1,2-13r9,43-13l5,37-12d2,39-15l3,35-14d6,36-21l20,15-22u9,17-12l13,3-11d1,1-13r8,45-13l7,37-12d2,38-15l2,35-14d6,36-21l20,15-22u8,15-14u1,16-12l12,3-11d1,2-13r5,47-13l9,37-12d2,38-15l2,35-14d6,36-21l20,15-22u9,16-12l12,3-11d1,2-13r3,41-13d1,43-15l7,35-14d6,36-21l20,15-22u9,16-12l12,3-11d1,2-13r1,44-14l6,37-13d1,38-15l2,35-14d6,36-21l20,15-22u9,16-12l10,46-14l8,37-13d1,39-15l3,35-14d6,36-21l20,15-22u9,17-12l9,45-15l9,35-14d6,36-21l20,15-22u9,16-12l6,47-15l11,35-14d6,36-21l20,15-22u9,17-12l5

;42
        ####
    #####  #
    #   # .#
    # $ .  ##
    #  #$#  ##
    ##@ $    #
     #.###.  #
######  *  ..#
#   #  .###  #
#   $$$ # ####
# #   $##
#####  #
    #  #
    ####
Solution: r4,8-5u1,7-3r2,10-4u1,11-4d2,10-7r1,7-7r3,10-1d4,5-3r4,10-4u1,5-8d1l2,7-9l1d1l1,6-12u8,5-3r2,5-8d2,1-9r4,6-10u1,5-8r1,7-9u1,6-7r1,5-12u2,6-9l3,3-10r2,6-11u2,5-8r1,1-9r4,6-10u3

;43
##########
#  .#.  .##
#    .    ##
# .  # .#  #####
#### $ ##$  $ @#
   #        .###
   ##$#.  ####
    #   #.#
    ##$   #
     #  #.#    #####
     ## $ # ####   #
      # #####  $   #
      #    *   $ $ #
      #  # $### ## #
      #  #  # #    #
      ##############
Solution: 13-4l1,12-4l1,10-3d1,9-5r2,4-4r1,6-5u2,5-2r1,7-1d1,5-7u2,4-4r1,6-5u3,5-1r2,6-9u1,5-7r1,7-8u2,8-5l2,5-6u1,6-4l1,4-5u2,5-2l1,3-1d1,4-3l1,10-12r3,14-11r1d1l7,7-13u7,8-5l2,5-6u1,6-4l1,4-5u2,5-2l1,3-3u1,15-11r1,18-12l10,7-13u7,8-5l2,5-6u1,4-4r1,6-5u2,7-2l1,17-10d1,18-12l10,7-13u7,8-5l2,5-6u1,4-4r1,6-5u3,7-1l1,15-14u1,17-12l9,7-13u6,11-14u1,9-10l1,7-9d3,7-5d2,6-8r2,9-7d1,7-14u7,9-3d3

;44
#####
#   #######
# $ ##    #######
# $$ # # ##... @#
#    $ $  #...  #
#   #  #$ #    #########
######    #### $       #
    # $#######  ####...#
    #  $ #  ########...#
    #      $#    $     #
    #  ##$      ##    ##
    #####  #   #########
        ########
Solution: 14-6r6,22-6l7,14-7u2,15-4l3,18-9l3,13-9r6,20-10u3,21-6l6,14-7u2,15-4l2,11-8d1,10-10r3,14-11u1,13-9r6,20-10u3,21-6l6,14-7u2,15-4l1,6-8u2,6-4d4,5-9r5,11-8d1,10-10r3,14-11u1,13-9r6,20-10u3,21-6l6,14-7u3,15-3l3,8-8l1,6-7d1,5-9r5,11-8d1,10-10r3,14-11u1,13-9r6,20-10u3,21-6l6,14-7u3,15-3l2,9-11u1,10-9l2,6-9r4,11-8d1,10-10r3,14-11u1,13-9r6,20-10u3,21-6l6,14-7u3,15-3l1,8-4d1,9-6l2,6-5d3,5-9r5,11-8d1,10-10r3,14-11u1,13-9r7,21-10u1,20-8r1,8-4l1,6-3d5,5-9r5,11-8d1,10-10r3,14-11u1,13-9r7,21-10u2,20-7r1,6-4l3,1-4r4,6-3d5,5-9r5,11-8d1,10-10r3,14-11u1,13-9r7,21-10u2,3-2d1,2-4r3,6-3d5,5-9r5,11-8d1,10-10r3,14-11u1,13-9r7,21-10u1,1-3r1,3-2d1,2-4r3,6-3d5,5-9r5,11-8d1,10-10r3,14-11u1,13-9r6,20-10u2,2-1d2,1-4r4,6-3d5,5-9r5,11-8d1,10-10r3,14-11u1,13-9r6,20-10u1

;45
#############
#           #
# #$$#$#$#$ #
# $ $       #
# # #$#$#$# #
#           #
### #############
#   #  #####    #
#      #####    #
#### #  $       #
   #    # #.# # #
   ###  # #.# # #
     ####   # # #
        #       #
        #...#####
        #...#
        #.+.#
        #####
Solution: 9-9l2,6-8d1,5-10r1,7-11u1,6-9r6,13-8d4,14-13l2,11-14u3,3-1d6,2-8r3,6-7d2,5-10r1,7-11u1,6-9r6,13-8d4,14-13l2,11-14u2,1-3r1,3-2d5,2-8r3,6-7d2,5-10r1,7-11u1,6-9r6,13-8d4,14-13l2,11-12d3,5-3l1,3-2d5,2-8r3,6-7d2,5-10r1,7-11u1,6-9r6,13-8d4,14-13l3,10-12d3,4-1d1,5-3l1,3-2d5,2-8r3,6-7d2,5-10r1,7-11u1,6-9r6,13-8d4,14-13l4,9-12d3,5-3d1,6-5l2,3-4d3,2-8r3,6-7d2,5-10r1,7-11u1,6-9r6,13-8d4,14-13l2,11-12d2,6-1d1,7-3l3,3-2d5,2-8r3,6-7d2,5-10r1,7-11u1,6-9r6,13-8d4,14-13l3,10-12d2,7-3d1,8-5l4,3-4d3,2-8r3,6-7d2,5-10r1,7-11u1,6-9r6,13-8d4,14-13l4,9-12d2,8-1d1,9-3l5,3-2d5,2-8r3,6-7d2,5-10r1,7-11u1,6-9r6,13-8d4,14-13l2,11-12d1,9-3d1,10-5l6,3-4d3,2-8r3,6-7d2,5-10r1,7-11u1,6-9r6,13-8d4,14-13l3,10-12d1,10-1d1,11-3l7,3-2d5,2-8r3,6-7d2,5-10r1,7-11u1,6-9r6,13-8d4,14-13l4,9-12d1

;46
  #####
###   ################
#   #                #
#      ####### # # # #
# # #$$  ####  # $ $ #
#     #   $   ###  ###
# #  #  # $ $ $  $ #
# ...   #########  #
##...####       ####
 #.+.#
 #####
Solution: 5-5u1,7-4l1,6-3l2,3-2d6,4-9l1,5-5u1,6-3l2,3-2d6,11-5l3,7-6u1,8-4l2,5-5u1,6-3l2,3-2d5,2-8r1,4-7d1,16-4r1,18-5u1,20-4l2u1,19-2l13,5-1d1,6-3l2,3-2d5,4-8l1,16-4r1,18-5u2,19-2l13,5-1d1,6-3l2,3-2d4,2-7r1,4-6d1,17-7u2,16-4r1,18-5u2,20-2l14,5-1d1,6-3l2,3-2d5,13-6r4,18-7u4,19-2l13,5-1d1,6-3l2,3-2d4,2-7r2,11-6r6,18-7u4,20-2l14,5-1d1,6-3l2,3-2d4,4-7l1,6-7l1,9-6r8,18-7u4,19-2l13,5-1d1,6-3l2,3-2d4

;47
 #####
 #   ####
 # ..   ##
 ##      #
  ##$  $ ###
   #  # $..#
   #####   ####
       #.*@ $ #
     ###..$   #
     #.   #####
    ##  $  $ #
    #.  #$   #
    # ##   ###
##### ##  ##
#..   ## $ #
#### #     #
   #    ####
   # $$ #
   ###  #
     ####
Solution: 8-6u1,7-5u1,4-5u2,5-2l1,7-2d1,8-3d1l3,4-5u2,7-5r1,13-7l2,11-8l2,10-8u2,8-9u1,6-18u1,4-17r1,7-16l2,4-17u2,5-14l3,6-18u1,7-16l2,4-17u2,5-14l2,9-10l1,7-11u1,6-9r1,8-10u1,12-10l5,6-9d1,7-11l1,9-12u1,10-10l3,6-11u1,9-15u6

;48
  #####
  #   #  ######
  # # ####@   ###
 ##  .   $ #$ $ #
##. $ #. $$   # #
#... ##$. ###   #
#######  ## #####
      ####
Solution: 10-3l4,6-3l1,5-4l2,5-3l1,3-2d2,4-5l2,7-6u2,8-3l4,3-2d2,4-5l1,9-5u1r1,10-3l6,3-2d2,12-4l4,7-5u1,8-3l2,12-2d1,13-4l5,15-3l2,12-2d1,13-4l4,8-3d1

;49
           #######
          ##     ##
       #### $$ #$ #
       #       #  #
       # $ $ $##$ #
       #####      #
       ###### # ###
     ########     #
   ###  #####     #
   #          #  ##
   # #  # #   $  #####
####      #   #      #
#..  ####  # ## # $  #
#..        #      ####
#..     #  #      ###
######  #..### $    #
    ## ##..### ##$# ##
    #  ######     #  #
    #   ..    ###  $ #
    ### @  #### #  ###
      ######    ####
Solution: 15-10l3,11-11u1,12-9l4,7-8d2,6-11r2,9-10d5,19-12l1,17-13u1,18-11l2,15-12u1,16-10l4,11-11u1,12-9l4,7-8d2,6-11r2,9-10d4,17-17u5,18-11l2,15-12u1,16-10l4,11-11u1,12-9l4,7-8d2,6-11r2,9-10d2,8-13r1,10-12d3,20-18l2,17-19u7,18-11l2,15-12u1,16-10l4,11-11u1,12-9l4,7-8d2,6-11r2,9-10d2,8-13r1,10-12d2u1,16-15l1,14-16u2,15-13l2,12-14u4,13-9l6,6-8d2,7-11l2,4-10d2,5-13l3,1-14u1,13-3d6,14-10l2,11-11u1,12-9l5,6-8d2,7-11l2,4-10d3,3-14r2,6-13d4,5-18r3,13-1d8,14-10l1,12-11u1,13-9l6,6-8d2,7-11l2,4-10d3,3-14r2,6-13d4,5-18r2,11-2r1,13-1d8,14-10l2,11-11u1,12-9l5,6-8d2,7-11l2,4-10d2,5-13l1,3-14u1,4-12l1,10-4r2,13-3d6,14-10l1,12-11u1,13-9l6,6-8d2,7-11l2,4-10d2,5-13l3,8-4r4,13-3d6,14-10l1,12-11u1,13-9l6,6-8d2,7-11l2,4-10d2,5-13l2,16-3d1,17-5l2,16-1d2,15-5l1,13-4d5,14-10l2,11-11u1,12-9l5,6-8d2,7-11l2,4-10d3,5-14l3,16-3d1,17-5l3,13-4d5,14-10l2,11-11u1,12-9l5,6-8d2,7-11l2,4-10d3,5-14l2

;50
###################
####        ##   ##
#### $  $ $ ## # ##
###### $##  #  #  #
##       #$ # ### #
#   ##   #     #  #
# #$##$######### ##
# $ ## ##         #
#   #  ##   ### # #
### #  ###      # #
### ## ### #### # #
###        #### # #
##########      # #
############### # #
########    ### # #
#...      # ### # #
#...      # ### # #
###.# #####       #
###.          #####
####  ##@     #####
###################
Solution: 6-5d5,5-11r4,10-12u3,9-8r1,11-7d1,10-9r4,15-8d8,16-17l4,11-16d1,13-18l7,5-19u2,6-16l4,7-2d2,8-5l1,6-4d6,5-11r4,10-12u3,9-8r1,11-7d1,10-9r4,15-8d8,16-17l4,11-16d1,12-18l6,5-19u2,7-16l4,4-2r1,6-1d9,5-11r4,10-12u3,9-8r1,11-7d1,10-9r4,15-8d8,16-17l4,11-16d1,12-18l6,5-19u3,6-15l4,9-2l2,6-1d9,5-11r4,10-12u3,9-8r1,11-7d1,10-9r4,15-8d8,16-17l4,11-16d1,12-18l6,5-19u2,7-16l3,3-17u1,4-15l1,11-2l4,6-1d9,5-11r4,10-12u3,9-8r1,11-7d1,10-9r4,15-8d8,16-17l4,11-16d1,12-18l6,5-19u3,10-5u2,11-2l4,6-1d9,5-11r4,10-12u2,10-10u1,9-8r1,11-7d1,10-9r4,15-8d8,16-17l4,11-16d1,12-18l6,5-19u2,4-16r2,3-7u2,2-4r3,6-3d7,5-11r4,10-12u3,9-8r1,11-7d1,10-9r4,15-8d8,16-17l4,11-16d1,12-18l6,5-19u2,6-16l2,3-15d1,8-16l4,6-15l2,1-7r1,3-8u3,2-4r3,6-3d7,5-11r4,10-12u3,9-8r1,11-7d1,10-9r4,15-7d9,16-17l4,11-16d1,12-18l8

;51
       ##########
       #      ###
       # ###$ ###
       #@     ###
    #### # # $  #
    #    # # #$ #
    # ## # # $  #
#####      #    #
#     # ####  $ #
# # # # ####$$# #
# #     ####  $ #
# # ## #####    #
#       #########
## ### ###..#.###
 #            ###
 ########     .##
        # ##  .##
        #. . .###
        #########
Solution: 12-1d1,13-3l4,8-2d4,9-7l3,5-6d3,6-10l2,3-9d2,2-12r2,4-12r1,6-10d3,4-14r6,11-13d1,10-15r3,14-4l1,12-5u1,13-3l4,8-2d4,9-7l3,5-6d3,6-10l2,3-9d2,2-12r3,6-11d2,5-14r5,11-13d1,10-15r2,13-14d1,12-16r1,14-6u1,15-4l2,12-5u1,13-3l4,8-2d4,9-7l3,5-5d4,6-10l2,3-8d3,2-12r3,6-11d2,5-14r4,10-13d1,11-15l1,9-14d2,14-6l1,12-7u3,13-3l4,8-2d4,9-7l3,5-6d3,6-10l2,3-9d2,2-12r3,6-11d2,5-14r5,11-13d1,10-15r1,12-14d2,13-17l1,12-10u6,13-3l4,8-2d4,9-7l3,5-6d3,6-10l2,3-8d3,2-12r3,6-11d2,5-14r7,13-15u1,15-8l2,12-9u5,13-3l4,8-2d4,10-7l4,5-6d3,6-10l2,3-9d2,2-12r3,6-11d2,5-14r4,10-13d1,9-15r3,13-14d2,13-10u3,14-6l1,12-7u3,13-3l4,8-2d4,9-7l3,5-6d3,6-10l2,3-9d2,2-12r3,6-11d2,5-14r4,10-15u1,15-10l2,12-11u7,13-3l4,8-2d4,9-7l3,5-6d3,6-10l2,3-9d2,2-12r3,6-11d2,5-14r5,11-15u1

;52
  ###############
  ########     @##
########       ..##
#         ###.....#
# # ####  ###.....#
#   ###############
###      #    #######
  # # ## #$$$ ##    #
  # # ##            #
  #   ##### #####$$ #
  ### ##### # ##    #
    #         # $ $ #
    # #### ## #   ###
    # $    ##  #$##
    ######     #  #
         #  $  ## ###
         ### ####   #
           # #   ## #
           # $ $    #
           #    #####
           ######
Solution: 5-13r4,10-14u2,11-11l5,5-12u5,7-6l3,3-7u3,2-3r6,9-4u1,8-2r5,14-1d2,13-4r3,11-6d4,12-11l6,5-12u5,6-6l2,3-7u3,2-3r6,9-4u1,8-2r5,14-1d1,13-3r3,10-6d1,9-8r1,11-7d3,12-11l6,5-12u5,6-6l2,3-7u3,2-3r6,9-4u1,8-2r5,14-1d2,13-4r2,13-7l1,11-6d4,12-11l6,5-12u5,6-6l2,3-7u3,2-3r6,9-4u1,8-2r5,14-1d1,13-3r2,13-15l1,14-18l1,12-19u4,10-15r1,13-14l2,10-15u3,11-11l5,5-12u5,6-6l2,3-7u3,2-3r6,9-4u1,8-2r5,14-1d2,13-4r1,13-15l1,16-18l3,12-19u4,10-15r1,13-14l2,10-15u3,11-11l5,5-12u5,6-6l2,3-7u3,2-3r6,9-4u1,8-2r6,15-1d1,13-15l1,17-10u1,18-8l6,11-7d3,12-11l6,5-13u6,6-6l2,3-7u3,2-3r6,9-4u1,8-2r5,14-1d2,15-11r1,17-12u3,18-8l6,11-7d3,12-11l6,5-12u5,6-6l2,3-7u3,2-3r6,9-4u1,8-2r5,14-1d1,16-14u2,15-11r1,17-12u3,18-8l6,11-7d3,12-11l6,5-12u5,6-6l2,3-8u4,2-3r6,9-4u1,8-2r4,13-1d2,10-15r1,12-16u1,13-14l2,10-15u3,11-11l5,5-12u5,6-6l2,3-8u4,2-3r6,9-4u1,8-2r4,13-1d1,19-11l1,17-12u3,18-8l6,11-7d3,12-11l6,5-12u5,6-6l2,3-7u3,2-3r6,9-4u1,8-2r7,18-10u1,19-8l7,11-7d3,12-11l6,5-12u5,6-6l2,3-7u3,1-3r7,9-4u1,8-2r6

;53
    #####
    #   #
    # $ #########
    # $ ##     ##
#####  ### ### ##
#  $  ####  #   #
#    $          #
# $ # # ##....# #
### # # ##....# #
  # # # ####### #
  # #       $ #$##
  #   ######$    #
  #####    #  @  #
           #######
Solution: 13-10l6,6-6l1,4-5l1,3-6r7,11-5d1,10-7r1,7-10l1,5-11u4,4-6r6,11-5d2,10-8r1,15-9d1,16-11l1,12-12u1,13-10l7,5-11u4,4-6r8,13-5d2,15-11l2,12-12u1,13-10l7,5-11u4,4-6r7,11-6r1,13-5d1,7-2l1,5-1d4,4-6r5,10-5d2,7-3l1,5-2d3,4-6r5,10-5d1,1-5r3,5-6u2,5-2d3,4-6r6,11-5d2,1-7r1,3-8u1,2-6r8,11-5d1

;54
         #######
     #####..  .#
    ##   #  # @#
    # $$ ##    #
#####$    $  #.#
# $    # ##  ..#
#. $ # $ ###  ##
##     ### ####
 #######
Solution: 11-4l3,6-2d3,6-4r5,12-5u1,13-3l1,11-4u2,12-1l1,7-2d1,6-4r5,12-5u1,13-3l1,11-4u2,6-7u3,6-2d1,5-3d1r6,12-5u1,11-3r2,14-4u2,4-5r1,6-6u1,5-4r6,12-5u1,11-3r2,14-2d1,8-6l1,6-7u2,5-4r6,12-3d1,11-5r2,1-5r4,6-6u1,5-4r6,12-3d1,11-5r1,4-6l2

;55
    #######
#####.    #
#   #  #$$#
#   ##  $ #
#  .  $.# #
# #  #  $+#
#.  ###  ##
###      #
  ########
Solution: l1,5-4r1,9-1d2l1u1,9-1l3,9-5u2,8-3l1,6-4u1,6-5r1,7-3d2,6-1d2,7-4l5,1-5u1,7-7u2,7-5u1,8-3l1,6-2d1,1-2d3,7-4l3,9-5l1,7-6u1,9-1d3

;56
     ####
   ###  ##
####     #
# ..    $#
#   ###. #
#####   $#####
#####$     $+#
#    $ #$ ####
#    #. .##
##     ###
 #######
Solution: l4,8-6l1,8-4d1,7-6r4,6-5d2l3,6-9u1,8-8u1,9-6l1,5-5d1,6-8u2,6-7l1,8-6l1,8-2d2,5-5r1,7-6u2,8-3l5,6-7u1,5-5r1,7-6u2,8-3l4,8-3d4,3-7r2,6-8u2,5-5r1,7-6u1,1-7r4,6-6d1

;57
        ####
        #  #
        #  #
     #### $#
   ###  ## #
#### $   # ####
# ..   .   .  #
#   ###$$#$## #
####  $ .# *  #
   # #  ##.  @#
   # . $   ####
   #  ######
   ####
Solution: 4-5r1,6-4d1,7-6l4,10-8u1,11-6l7,7-6d2l1,8-6d1,6-10r1u3,6-6r4,4-8r2,7-9u2,9-10l3,10-4u1,10-1d7

;58
   ######
####    #
#.# ... #
# #. #.###
#        #
# $ #    #
###  #####
#     #
#     ###
####    #
  ##$$#$##
  #    $ #
  #  $## #
  ###    #
    ###@ #
      ####
Solution: 8-11l3u2,1-5r1,3-4d2,3-8u3,2-4r1,5-4l3,1-5u2,5-13u2,3-11r1u3,4-11r1,5-9d1,4-6d1,5-7d1l2,5-10u1,5-12u1,7-11l2,4-12u4,5-9d1,4-11r1,4-6d1,5-7d2,4-9u1,5-7l1,3-8u3,2-4r3,6-5u2,7-2l2,1-8r2,4-9u1,5-7l1,4-1d1,3-8u3,2-4r3,6-5u2,7-2l1,4-4u1,7-11l2,4-12u4,5-7l1,3-8u3,2-4r3,6-5u2,7-9d1,8-11l3,4-12u4,5-7l1,3-8u3,2-4r3,6-5u1,5-11u1,6-9l1,4-10u2,5-7l1,3-8u4

;59
   ######
  ##    #
### ... #
#.#. #$###
#   $    #
#  $#  $ #
###+$ #  #
  #####$ #
      #  #
      ####
Solution: u2r1,6-2d2l4,1-5u1,3-2d1,4-4l1,7-6u1,8-4l3,5-5r1,3-4r2,6-5u2,7-2l2,4-1d1,1-4r4,6-5u2,7-2l1,4-4u1,7-6u1,8-4l5,1-4r1,3-5u1,7-8u3,8-4l1,6-5u2,5-6l1

;60
              ####
          #####.+#
          #   ...#
          #   ...#
      #####   ...#
      #   ## #####
      #    # #
      #      #
 #### ### #  ####
 #  ##### ####  #
 #$  #### ####  #
##   #    ####  #
# $ ##    ####$ #
#       ###  $  #
####### ###$ # ##
# $ $           #
#   $ #$$ ###$# #
###             #
  ###############
Solution: 7-17u5,6-11r2,9-12u5,9-5d1,8-7r3,12-8u5,11-2r3,15-3u1,2-11d1,1-13r5,7-12d3,7-17u5,6-11r2,9-12u5,9-5d1,8-7r3,12-8u5,11-2r4,16-3u1,2-9d3,1-13r5,7-12d3,7-17u5,6-11r2,9-12u5,9-5d1,8-7r3,12-8u4,12-2d1,11-4r4,3-15r3,7-16u4,6-11r2,9-12u5,9-5d1,7-7r4,12-8u4,11-3r4,1-15r5,7-16u4,6-11r2,9-12u5,9-5d1,8-7r3,12-8u5,11-2r4,4-17u1,3-15r3,7-16u4,6-11r2,9-12u5,9-5d1,8-7r3,12-8u4,12-2d1,11-4r3,9-16l1,7-17u5,6-11r2,9-12u5,9-5d1,8-7r3,12-8u4,11-3r3,11-13d1,12-15l4,7-16u4,6-11r2,9-12u5,9-5d1,8-7r3,12-8u5,11-2r3,13-17u1,14-15l6,7-16u4,6-11r2,9-12u5,9-5d1,8-7r3,12-8u4,12-2d1,11-4r2,14-13u2,12-13r1,14-14u1,14-11d3,15-15l7,7-16u4,6-11r2,9-12u5,9-5d1,8-7r3,12-8u4,11-3r2,14-9d5,15-15l7,7-16u4,6-11r2,9-12u5,9-5d1,8-7r3,12-8u5,11-2r2

;61
       ######
     ###    #
     #   $ $#####
   ###   ##.    #
#### $  ## $    #
# $        #    #####
#   $ #  $##...##  @##
#####     ###.#.    .#
 #    # ### ### .# ..#
 #  ##  #######  #####
 ##  $  #    ### #
  #  #         # #
  # #    ##      #
  # $  #         #
  #### ###########
     # $ #
     #   #
     #   #
     #####
Solution: 4-10r2,7-9d1,6-11r5,12-10d1,11-12r4,16-13u5,15-7r3,19-6d1,18-8r1,8-15l1,6-16u5,5-10r1,7-9d1,6-11r5,12-10d1,11-12r4,16-13u5,15-7r4,3-13r2,6-12d3,6-17u6,5-10r1,7-9d1,6-11r5,12-10d1,11-12r4,16-13u5,15-7r3,19-6d1,1-5r5,7-4d6,6-11r5,12-10d1,11-12r4,16-13u5,15-7r2,19-7l3,3-6r1,5-7u1,4-5r2,7-4d6,6-11r5,12-10d1,11-12r4,16-13u4,10-4r2,13-3d3,11-1d2,10-4r1,12-3d2,8-2r2,11-1d2,10-4r2,13-3d2,9-7u1,10-5l2,7-6u3,6-2r4,11-1d2,10-4r3,14-3d2,4-4r2,7-5u2,6-2r4,11-1d1


