;1
#####
#   ##
#  $@#
##$ .#
 #  .#
 #####
Solution: l1,1-2r1,3-1d1,2-4u1r1,1-2r1,3-1d2,2-4r1

;2
 #####
##@..#
# $$##
#    #
##   #
 #####
Solution: d1,1-3r1,4-3l1u1,2-1r1,1-3r1,3-4u2

;3
########
# @#   #
# *$   #
#  #  ##
#. #  #
#######
Solution: d1r2,5-1d1,2-4u1,1-2r3,6-2l4,1-1d2,5-4u1,6-2l3

;4
      ####
 ######  #
 #@$   $ #
 #.#     #
##    ####
# .  ##
#   ##
#####
Solution: r3,7-1d1,8-3l3,5-2r1,7-1d1,8-3l1,4-2d1,5-4l2,2-3d1,7-3l2,4-2d1,5-4l2,1-5r1u1,4-5l1

;5
#####
# . ####
#  $@  #
##*    #
 #  ####
 ####
Solution: l1,1-2r3,2-4u1,1-2r1,3-1d1,6-2l3,1-2r1,2-3r2,4-2l1,2-3u1,6-3l3

;6
 ######
 # .  ##
##$  $@#
#  .#  #
#   #  #
########
Solution: l1,3-2r1,5-1d1,2-1d1,1-3r1,3-4u2,2-1r1,5-4u1,6-2l3,2-1d1,1-3r1,5-1l1

;7
#######
#     #
# @   #
##$#  #
## .* #
#  ####
#    #
#    #
######
Solution: d3,1-6r1,5-4l2,2-3d2,2-7u4,1-2r2,4-6l1,2-7u4,1-2r1,4-1d2,5-4l1,2-2r1,4-1d2

;8
   ####
####..#
#     #
# $$ @#
##  ###
 #  #
 ####
Solution: 2-2d1r1,2-5u2,5-3l1,3-2d1,1-2r3,5-3u1,3-5u2,2-2r1,4-3u1

;9
 #####
 #   #
 # $ #
## ####
#.@   #
## #  #
 # $. #
 ###  #
   ####
Solution: 2-6r1,4-7u1,4-2l1,2-1d3,2-6u1,3-4l1,4-4d1

;10
#####
#   ##
#    #
## .@#
## .$##
#  #  #
#  $  #
#  #  #
#######
Solution: d2,4-7u3,4-6l1,2-7u4,4-2d3,5-6l2,1-2r1,3-1d2,2-7u4,1-2r1,3-1d1

;11
######
#  #.#
#    #
#. # #
## $ #
# $ ##
# @ #
#####
Solution: u3,2-1d3,4-4l1,1-5r1u2,1-2r2,4-3u1,3-6u1,4-4l1,2-5u2,3-2l1,1-1d1

;12
########
#   #  #
#      #
####   #
 # $$###
 #  +.#
 ######
Solution: u2,5-2l2,1-2r3,2-4r1,4-5u2,5-1d1l2,6-3l1,4-2d2,3-5r1,1-2r3,5-1d1,6-3l1,4-2d2

;13
 ######
 #    #
 #$   #
 #@. ##
##$. ##
#     #
#  #  #
#  #  #
#######
Solution: d2,2-7u1,1-5r2,4-4d1,2-1d4,4-7u4,5-2l1,2-7u1,1-5r2,4-4d1,4-7u4,3-1d2,5-2l1,3-1d1

;14
 ######
 # . .#
##$#  #
#     #
# $#  #
# @#  #
#######
Solution: u1,1-3r3,2-1d2,5-4u1,2-5u1,1-3r2,4-2d1,4-5u2,5-1d1,4-3u1,5-1l1,5-4u2

;15
  #########
  #   ##  #
  #       ##
 ### ###   ##
 #@$   ##   #
 ###  $ # # #
##### ..#   #
#     ### ###
#       # #
#  ###  # ###
#### #      #
     #  #   #
     ########
Solution: r2,7-5l1,6-4l1,5-6u1,4-5u2,3-2r5,9-1d8,6-10r3,11-10l4,6-11u2,7-8l4,6-4l1,4-5u2,3-2r5,9-1d8,8-10r1,11-10l4,2-9u1,1-7r3,5-8u2,4-5r1,6-4d1,5-6r1,6-11u2,7-8l4,2-9u1,1-7r3,5-8u2,4-5r1,6-4d1

;16
####
#..#
#$$##
#@$.#
#####
Solution: u1d1r1u1

;17
 ###
##+#######
#  ..    #
# $  $$  #
######   #
     #####
Solution: 6-4u1l1,3-3r3,1-3r3,5-2r1,8-2l5,2-3u1,4-3r1,7-4u1,8-2l4,6-4u1,7-2l2

;18
########
#   .*@#
#  $.$ #
#   ####
#####
Solution: l3,4-2l1,6-2l1,1-1r2,2-3u1,3-1r1,1-1r2

;19
 ######
##+#  #
# $   #
#   $ #
#### ##
#     #
#  * .#
#  #  #
#######
Solution: d1,1-3r1,4-2d3,4-7u1l1,4-6u3,4-1d4,5-6l1,2-3r1,4-2d3,4-7u4,5-2l2,2-3u1,2-7u1r1,4-7u4,5-2l1,1-5r2,4-6u3,4-1d4,5-6l2,2-2r1,4-1d4,3-6r1,1-6r1

;20
######
#.#  #
#.#  #
#.  $#
#  #@#
#   $##
## $  #
 ##   #
  #####
Solution: u1l2d3r1d1r2u1l1d1l1u1l1u3r2d2l1d1l1u2d1r2u2l2d1l1u2d2r1d2r1d1r2u1l1d1l1u1r1u1l1d1l1u2d1r2u2l2d1l1u1r2u2r1d4l1d2r2u1l1d1l1u1r1u1l1d1l1u2d1r2u2l2

;21
#####
#...##
#    #
#  # #
##  $##
#@$   #
###$  #
  #   #
  #####
Solution: r1,4-3d2,4-7u3,2-5r1,4-4d1,3-7u2,4-4l1,2-5u3,1-1r1,4-2d2,5-5l1,3-6u1,4-4l1,2-5u2,3-2l1,1-3u1,5-6l1,3-7u2,4-4l1,2-5u3

;22
######
#    ###
#  $ $ #
# # $+ #
#   #..#
########
Solution: l1,4-2l1,3-4u1,6-2l1,4-1d1,3-3r1,5-2d1,3-1d1,1-2r2,3-4u1,4-1d1,3-3r2,6-2d1,2-2r1,4-1d1,3-3r1

;23
#######
#...  #
# $@$ ##
## ##  #
 #  $  #
 #  #  #
 #######
Solution: r1,5-1d2,1-2r2,5-5u1l2,2-5u3,5-2d1,6-4l1,3-2r1,5-1d2,1-1r1,2-1r1,5-5u1l2,2-5u3,3-1l1,5-2d1,6-4l3,2-5u3,5-1l1

;24
##### ####
#   ###  #
#     $@ #
## $#$   #
#...#   ##
#########
Solution: l4u1l2d1r5d1r2u2l1d1r1d1l1d1l2u1d1r2u2l4u1l2d1r5l4d2r1u1l1u1r3d2r2u1r1u2l1d1l4u1l1d2r1d1l1u2r3d2r2u1r1u1l5u1l1d2u1r3d2r1u1r1u1l4u1l2d1r1u1r1d2

;25
#####
#.  ###
#.#   #
#.    #
# # ###
# $ $@#
##  $ #
 ###  #
   ####
Solution: l1r1d2l1u1l1u3l2u2r2d1u1l2d2r2d3r2u1l1d1l1u3l2u2r2d4u2l2d2r1d1r1l1u1l1u2r2d2u3r2d1l3r1d2l2u3,4-7u1r1u1l2u2l2d2r1d1r1u2d1l2u2r2u1r2d1l3r1d2l2u2d2r4d2l1u1r1u1l1d1l1u2d1l2u2r2u1r2d1l3

;26
      ####
      #  #
####### .##
#  ##   ..#
#@$   $$  #
####   ####
   #####
Solution: r3d1r2u1r1l1d1l2u1r1u1r1l1d2r1u1r1u1r2d1l3d1l2u1r1u1r3u2l1d1r1d2l2u1r1d1r1u1l2d2l2u1r1d1r1u1l1u1r2

;27
 #######
##  #  ###
#    $ $ #
#  # ..*@#
#  #  #  #
##########
Solution: l2u1l3u1l1d1r4d1l1r3u1l1d1l2u2r1d1l1d1r1u1l5d2r1u1l1u1r4u1r1d1l1d2l1u1r1u1l1r4d2l1u1r1u1l2u1l1d1l1d2r1u1r1u2l1d1l2u1l1d1l1d2r1u1l1u1r4u1r1d1

;28
  #####
  #   #
### # ##
#  ... #
# $$ $ #
# @#####
####
Solution: u1l1u1r2u2r2d2l1d1l1u1r3d1l2,2-5u1l1u1r3d1l1,6-3l1,3-1d2r1d1r1u1l4d2r1u1l1u1r3d1l1,6-3l1,5-1d1,2-5u1l1u1r1

;29
 ####
##  #
# $+##
#  $.#
# $  #
#. ###
#  #
####
Solution: d1l1d1u1r2d1l1u3l1d1l1r1l1d2r1l1u2r2d1l1d1l1d2r1u3r1u2l1d1l1d2r1u1l1u1r1d4l1u2r1u1r2d1l1u1l1d1l1r2u1l1u2r1d1l1d1r1l1d1l1d2r1u2r1u2l2d2r1u1l1u1r1

;30
#####  ###
#   ####.#
# $ #  #.#
#  $#$  .#
#     $@.#
#####  ###
    ####
Solution: l4u1l2d1r5u2l1d1r1d1l1r1u1r2d1l1u1l2d2r1u1l1u1r2d1r1u2d2l5u1l2d1r4d1r1u1l1u1r2d1r1u1,2-1d2l1d1r4d1r1u1l1u1r2,3-1d2l1d1r5

;31
######
# ..@#
# .*$##
#  $  #
## $  #
 ###  #
   ####
Solution: d1l1r1d1r1d2l1u2l1u2l2d2r1d1r1u1r2d2l1u1r1u1l1d1l2u1l1u2r3d2u1d1r1d1l1u3l3d2r2u1r1u1l1r1d2r1l4u1r1d1r1u1r1d1r1d2l1u1r1u1l1u1l2d2r1u1r1u1l1r1d1r1d2l1u1r1u1l1d1l1u1

;32
######
#.. +##
# #$$ #
#  $  #
#   * #
#######
Solution: l1r1d1r1d2l2r2u2l1u1l1r1d1r1d2l1r1u2l1u1l3d3r2l1u1l1u2r3d1r1d2l1r1u1d1l1u1l1u1d1l1r3u1l1d1l2d1l1u2d1r2l1r2d1l1u1l2d1r2u1r1u2l1r1l1d1r1d1l1d1l2u1r2u1r2d2l1u2l1d1l1d1r1

;33
#######
#. . .#
# $# ##
#  $$ #
#.  $@#
#######
Solution: l1u1d1u1d1u1l2u1l1u1r3l2d3l1r1u3r2l2d3r1u1r2d1l1u1l2d1l1u1r3d1l1u1l1u2r2d1u1l2d2r1d1r2u1l1u2l2d2l1d1r2l1u3l1d1u1r3d2l1d1l1u2l1u1r1d3l1u2r1d1r3d1l3

;34
######
#... #
# #. ##
#   $ #
#$$$  #
#@ #  #
#######
Solution: r1l1u2r2u1r1d1l3d2r1l1u2r4d2l1u2l3d2r1u1r1u3l2d2u2r2d1u1d2r2d1l1u1l1u2r1l1d2r1l1u2l2d2r1d1r1u1l2r4d2u1l1u1l3r1l1u2r3d2l1u1r1u1l1d1r1l1d1l1d2l1u3d3r1u2r3d2l1u1r1u1d1l2u1l2d2r1u1r1u3r1d2l1d1l2u1r1d1r1u2r1d1r1d2l1u1r1u1l1d1l1u1

;35
##########
#   ##   #
#  $#  . #
#   # $.##
##   $ *@#
 #  ## .##
 ########
Solution: l1d1l1r1u3l2d1u1r2d1l1r1d2l1u1l3d1l1u2d1r5u2l1d1r1d2l1u1l1r2u2l2r2d2l5r1u1l2u2r2d2l1d1r4u1r1u2l1d1l1d1u1r2d1l1d2r1u2d1l4u3l2d1r1d1r1d2l1u2d1r4u1d1l4u1l1u2r2d2l1d1r4u2l1d1r1d1l3u3l2d1r1d1r1d2l1u2d1r3u2r1u1r2d1l1u1l1d1l1d2r1d1r1u2d1l4u1l2u2r2d2l1d1r4l1u2r1u1r2d1l1d2l2u2r1l1d1r1l1d1l3u1l1u1r1u1r1d2l1d1r4

;36
 ######
 #.   ##
#### $.#
#@$  #.#
# $$   #
#. #   #
########
Solution: d1u1r2l2d2r1u1r2l3u1r1d1r2d1r2u1l4r4l2u2d2r2u2l1u1l2r1d1r2d3l2u1l2u1l1d1r2l1r4u2l2d1u1d1l1d1r1l3u1r2d1r1d1r2u3l1r1d2l3r3u2l2d1l1d1r2d1r1u2d1l3u1l2d1r4d1r1u1

;37
#########
#  ..#  #
# #..$  #
#  $ #  #
##  ## ##
 # $@$  #
 ####   #
    #####
Solution: undefined

;38
########
# .... #
#  $@$ #
##### ####
 ###     #
 #     $ #
 #   ##$ #
 ######  #
      ####
Solution: u1r1l1d1l1u1r3d1l1u1l2d1r1u1r2d1l1u1l2r2d3r3d1l4r4d2l1u2l3d1l2u1r2u1r2d1r1l3r4u1l1d1l1r1u1l1d1l2d1l2u1r4u1r1d1l3u1r2l1u3l2d1r1u1r1d3r1d1l2u1r1u3l4d1r2u1r2d4r3u1l2d1l1u3r1u1l3r2d3r3d3l1u1r1u2l3u3l2d1u1r3d1l1d2u2d2l1d1r2u1r1d1l2u4l2d1u1r2d4r3d2l1u2r1u1l2d1l2d1l2u1r4u1r1d1l3u1r2l1u3l2d1r1u1r1d3r1d1l2r4u1l2d1l1u3r1u1l2r1d4r3d2l1u2r1u1l2d1l1u3r1u1l1d4l1d1l2u1r3u1d1r1u1r2d2l1u1r1u1l2d1l1u3

;39
####
#  #
#@ ###
#* $ #
#.*  #
# * ##
#   #
#  ##
####
Solution: undefined

;40
######
#@#  #
#$#  #
# $  #
#.*  #
# * ##
# .  #
##   #
 #####
Solution: d3r1d1r1l1u1d1r1u1d3u4d1l2u1r1d2u2l1r1d1r1d3l1u1l1u1d1r2u2l1d1l1d1r1u3l1d1r3u1l1r1u2l1d3l2u1r1d1r2u1l1d1l2u1r1d1r1u1d1l1d2l1u1d1r1d1r2u1l1u1l1u2r2d1l1u1l1d1r2u3l1d2r1d1l1

;41
########
#  ##  ###
#   ..   #
#  $#.$$ #
###  .$@##
  #######
Solution: undefined

;42
 #######
 # .   ##
 #  $   #
####$ *.#
#@$ .   #
#########
Solution: undefined

;43
######
#..$@#
# .**#
#$$  #
#    #
######
Solution: d1l1d2l2u2d2r2u2r1u1l1d3r1u1d1l3u2r1l1d2r1u1

;44
    #####
#####@  #
#   $$$ #
#..**. ##
#      #
########
Solution: undefined

;45
########
#  #   #
#  $$# #
#@$    #
###$  ##
# $ #  #
#..... #
########
Solution: undefined

;46
###########
#.. @#    #
##  $$  $ #
###  $$ # #
#...  #   #
###########
Solution: undefined

;47
#######
#. $. #
##    #
#.  ###
### * #
#@$ $ #
# $ . #
#  ####
#  #
####
Solution: undefined

;48
  #######
  #  .*@#
###  $$ #
#  $ # ####
#    # $ .#
####..  ###
   ######
Solution: undefined

;49
#######
# .$  #
#.    #
#.  ###
#.# ###
#.# $@#
#  $$ #
##$#  #
 #    #
 ######
Solution: undefined

;50
    ######
    #@#  #
  ###$   #
###   $$ #
#.   $  ##
#.. $#  #
#.#  ####
#.####
###
Solution: undefined

;51
   ####
####  #
# $.*.#
# ## .#
#    .####
### $$   #
  #$     #
  #@###  #
  ### ####
Solution: undefined


