;1
######
#... #
#... #####
#        #
#  ##    #
##   $$$##
 ## #   #
 #@ #   #####
 #  ###$ $  #
 #      $#  #
 ###   #    #
   #       ##
   #########
Solution: 6-4d1l1,6-7u3,7-3l4,2-4u2,1-1r1,3-5r1,5-6u2,6-3l4,1-4u2,7-6u2,8-3l5,2-4u2,7-9u5,8-3l5,2-4u1,1-2r1,10-8l2,7-9u5,8-3l6,1-4u1,8-10u1,9-8l1,7-9u5,8-3l5,2-4u1

;2
##########
#        #
#  $ ### #
# # $#   #
#  # ### ##
##  $  #  #
 #  $ $ $ #
 # # # #  #
 # #   ####
 #     #
#####  #
#...   #
#...  @#
########
Solution: 8-7u1l2u1l2d3u2l2d3r2u1r1d2r1d1l4,6-6l1u1l1d3u2l2d3r2u1r1d3r1d1l4,4-2d6,3-9r1u1r1d2r1d1l3,2-5r1,4-4d4,3-9r1u1r1d3r1d1l3,2-2r1u1r1d7,3-9r1u1r1d2r1d1l2,8-4d1r1d1l4,4-5d3,3-9r1,5-8d3,6-12l2

;3
      ###
     ##.##
     #...#
    ##...###
    # ...  #
    # $ $  #
####### ####
# $ $  $##
#  $ $$$ ###
#          #
## #### ## #
 #      $  #
 #####  ####
     #@ #
     ####
Solution: 4-8l1,6-9u1l1,8-8l1u6,5-5r1,7-4d5,7-11u8,8-2l1,9-5l1,7-4d5,7-11u7,6-3r1,8-4u1,9-11l1,7-12u9,5-8r1,7-9u4,6-4r2,3-8r3,7-9u5,8-3l1,1-8r5,7-9u5,5-7r1,7-8u3,6-4r1,8-5u1,3-7r3,7-8u3,8-4l1,10-4l1,1-7r5,7-8u3

;4
#######
#  #..##
#  #...###
#        #
## #    .#
 # #### ###
 # $   $  ##
 # ## #$#  #
 #  # $  $ #
 #  #  #$  #
 #  #     ##
 ########@#
        ###
Solution: 8-6l1,9-9u1,7-8u4,8-3l3,4-4u2,4-6l1,2-5d3,7-6l2,3-6r3,7-7u3,8-3l2,5-4u2,7-8l1,5-9u2,4-6r2,7-7u3,8-3l3,4-4u1,2-10u7,2-1d1,1-3r3,5-4u1,9-6d1,10-8l4,5-9u2,4-6r2,7-7u3,8-3l1,6-4u1,8-10u1,9-8l3,5-9u2,4-6r2,7-7u2,6-4r1

;5
         #####
        ##   ##
  ###  ##.    #
 ## # ##...#$ #
 #  ###...##  #
 #        #   #
 # $####  # # #
### $ ##### $ #
#      $ $  # #
#   ## $      #
#########@ ####
        ####
Solution: 8-8l5,3-7u1,2-5r5,8-6u1,9-4l1,5-7l1,3-8u2,2-5r6,9-6u2,8-3r1,1-8r1,3-9u3,2-5r5,8-6u2,10-8l7,1-8r1,3-9u3,2-5r5,8-6u1,12-4u1,13-2l3,6-9r2,9-10u1,10-8l7,1-8r1,3-9u3,2-5r6,9-6u2,13-7l1,11-6d2,12-9l2,9-10u1,10-8l7,1-8r1,3-9u3,2-5r6,9-6u1

;6
   #####
 ###   ###
 # $     #
 # #$#$$$#
 #       #
 # $$#$# ##
 #$  $ $  #
 #  $     #
 #  #######
##@  #
#....#
#....#
#....#
######
Solution: 3-6u1,2-2r2,8-2d2,4-4l1,2-5d5,1-11r2,4-10d1,2-3d8,3-12l1,6-4d2r1,6-6l3,2-5d6,5-7l1,3-6d5,7-7l4,2-6d4,3-11l1,9-6l5,3-5d5,2-11r1,8-4d2,9-7l6,2-6d4,4-4d2,5-7l2,2-6d3,3-10l1,4-2d4,5-7l1,3-6d4,6-2d4,7-7l3,3-6d3,2-10r1,8-3l1,6-2d4,7-7l4,2-6d3,6-2l1,4-1d5,5-7l1,3-6d3

;7
  ######
  #....#
###....###
#   $ #  #
# $#     #
#   $#$  #
### @$ ###
  # #  #
 ## #  #
## $ $$#
#   #  #
# # # ##
#     #
#######
Solution: 4-4u2,3-1r2,4-6u3,3-2r2,2-5u1,1-3r2,4-4u2,5-1l1,3-8d2,3-12u6,2-5r1,4-6u3,5-2l1,5-10u2,6-6l2,3-7u1,2-5r1,4-6u4,6-6u1,7-4l2,4-5u1,3-3r1,5-4u2,5-8u1,4-6r1,6-7u2,7-4l2,4-5u1,3-3r1,5-4u1,6-10u5,7-4u1d1l2,4-5u2

;8
   #########
   #...    #
####...#$# #
#   ...#   #
#  ##  # ###
## ##### #
 #$##  # #####
##   $  $ $  #
#  # ##  $$$ #
#    ## $    #
######## @####
       ####
Solution: 11-7l1d1l2u1l4,2-7u3,1-3r3,5-4u1,6-2l1,8-3u1,9-1l4,8-7u4,4-7l1,2-8u4,1-3r3,5-4u1,8-3u1,9-1l3,10-7l7,2-8u4,1-3r4,6-4u2,8-10u2,9-7l6,2-8u4,1-3r4,6-4u1,7-9u1,8-7l5,2-8u4,1-3r4,12-8l4,7-9u1,8-7l5,2-8u4,1-3r3,11-9l2,8-10u2,9-7l6,2-8u4,1-3r2

;9
  #####
  #   ######
  # $  $   #
  # #  #   #
  #   $ $###
  ## #   #
   # #$ @#
  ##$#   #
  #   $ ##
  # $  ##
### # ##
# .... #
# .... #
###  ###
  ####
Solution: 7-8l1,7-4l1,5-9l1,3-8d2,2-11r2,5-10d1,4-6d2,5-9l1,3-8d2,4-11l1,6-12l3,6-8l1,4-7d1,3-9r1,5-8d2,6-11l1,6-5d2,7-8l2,4-7d1,3-9r1,5-8d3,6-12l1,4-4r1,6-3d4,7-8l2,4-7d1,5-9l1,3-8d3,3-2r1,5-1d2,4-4r1,6-3d4,7-8l2,4-7d1,5-9l1,3-8d2,6-2r2,10-2l4,5-1d2,4-4r1,6-3d4,7-8l2,4-7d1,3-9r1,5-8d3,8-5u2,9-2l3,5-1d2,4-4r1,6-3d4,7-8l2,4-7d1,3-9r1,5-8d2

;10
#########
#       ####
# ##  $ #  #
#   $# $  ###
### $ $#    #
  #  # #   #####
  # $ $  ###   #
  #            #
  ######  ## ###
       ####@   #
          #    #
          #..#.#
          #....#
          ######
Solution: r1u2l9u2r1d1l1d1r9u1r2d1l1u1l1d5l1d1r1,7-2l1u1l5d2r2d3r4d1r1u2r1u2l1d3l1d1r5u1r2d1l1u1l1d3l1d1r2u1r1d2,6-3d3l1d1r7u1r2d1l1u1l1d3l1d1r2u1r1d1,8-3l1,6-2d4l1d1r7u1r2d1l1u1l1d3r1d1l1u2d1l1d2,4-2r1u1r1d5l1d1r7u1r2d1l1u1l1d3r1d1l1u1l1d1,3-4r2,6-3d3l1d1r7u1r2d1l1u1l1d5,4-2d4l1d1r9u1r2d1l1u1l1d4

;11
   #######
  ##     ###
  # $   $ @##
### $# # #  #####
#   $  # #$$    #
## $ ###$#   #  #
 #   #  $   ### #
 ###$  ####$ ...#
   # # # #   #..#
   # $ # #  ....#
   # # # ## ...##
   #   #  ######
   #####
Solution: d2r1d3r1d2u2l1d1l1d1r3d1r1u1l2u1l1u1r4u3l2,11-4r1,10-6u1,9-2l1u1l2d3l2d3r2u1r4u1r1d2,10-8r1,12-9u1l1u1r2,10-3d2,9-6r1u1r1d2,10-8r1,14-4l2,13-7r1,15-6d2,12-9u1,11-7r3,15-6d1,11-3d5,10-9u1r1l1d1r1u1r1d1l1d1r2,8-4d1,7-6r3,11-5d3,10-9r1u1r1d1l1d1r1,6-2r1u1r1d4,7-6r3,11-5d3,10-9r1u1r1d1,2-4r2l1u2r4u1r1d4,7-6r3,11-5d2,10-8r1d1r1u1l1u1r3,4-4u1,3-2r4u1r1d4,7-6r3,11-5d2,10-8r1d1r1u1l1u1r2,2-5r1d1r1u3l1u1r4u1r1d4,7-6r3,11-5d2,11-9l1u1r1d1r1u1l1u1r1,6-4l1,4-5u2,3-2r4,8-1d4,7-6r3u1r1d3,10-9r3,4-9u6,3-2r4u1r1d4,7-6r3u1r1d3l1d1r2,6-9l1,4-10u7l1u1r4u1r1d4,7-6r3u1r1d3l1d1r1

;12
   ####
  ##  #
  #   # #####
 ## $ ### ..#
##  #     ..#
#   # # # ..#
# $$ $  #   #
## $#   #@  #
 #  ##$######
 # ##  #
 #     #
 ####  #
    ####
Solution: u3l2d3l1d2u3d1l1u1d1r1d2l1d1l3u4r4d1r1u2,6-4r3u1r1d2u1l5d1u1r2d3l1d2l1d1l3u4r4d1r1u2d1l2u2r5u1r1d2u1l6u2l2d1r1u1r1d3u3l2d4r3d1r1u2d1l2u2r4d1r1u1l1u1r1l1d1l4d3r1d2l1d2r1u4l1u1r1d1r1u2d1l2u3d1r4d1r1u1l5d2l3d2r1u1l1u1r4d1r1u2d1l2u2r5l1d3r1u1d1r1u1l2u2l4u1l2d1l1d1l1d1r5d1r1u2d1l2u2r4

;13
          ####
          #  #
###########  ####
#            ...#
#  ######## #...#
# ## $ $ $  #...#
#     $@$   # . #
####   $ ####   #
   #  $ $       #
   #   $ $ #    #
   #### #### ####
      #      #
      #      #
      ########
Solution: l1d1l1d2u2r1d1r1d1u1r7d1r1u4d3l9u2r1d1l1d1r7d1r1u4d3l6r4d3l5u2r1u2l2d1r6d1r1u4d3l3d1l2r1u1r3d3l5u2r1u2l2d1r8d1r1u3d2l10d1r1u1r6d3l5u2l1u1r7d1r1u3d2l8u1l2u1l3u3r10d3l3u1r2d1r1u2d2l3d1l4u1l3u3r13l13d3r3d1r2u2r4d1r1u2d2l3d1l4u1l3u3r12l12d3r3u1r6d1r1u2d1l7d1l3u3r11l1d2l4d2l1d1r6d1r1u3d2l9u3r1d2l1d1r9d1r1u2

;14
   #######
   #     #
 ###     ##
 #        ##
 #### #    #
  ###$ #   #
  #   $ #  ######
  #    $        #
#########$#   # ###
#           $##   #
# #########       #
# #   $   $ ####  #
# #  $ $  #  @#...#
# #### ####   #...#
#             #...#
###################
Solution: l2u4r1d1l1d1r4u1r1d2r1d1l1u2l5d4l5u2r1u1r3l2,11-12u2,10-9r1,12-8d1,11-10r4,16-9d3,17-13l1,9-7d1,8-9r3,12-8d1,11-10r4,16-9d4,17-14l1,6-12l1,5-11r5,11-12u2,10-9r1,12-8d1,11-10r5u1r1d4,9-12l2,6-13u1,5-11r5,11-12u2,10-9r1u1r1d1,11-10r4u1r1d4,3-12r2,6-13u1l1u1r5,11-12u2,10-9r1,12-8d1,11-10r4,16-9d3,8-7l3u3,3-7r5l3u4,9-6d2,8-9r3u1r1d1,11-10r4,16-9d2,4-2r3u1r1d2l1d1r1u1r1d5,8-9r3u1r1d1,11-10r5u1r1d3,6-5d1,5-7r3,9-6d2,8-9r3u1r1d1l1d1r5u1d1u1r1d2

;15
  ############
  #          #
  # $  $     #
 ## ### ##  ##
## $#.. .#  #
#       .#$###
# #$#. #     #
# # #. ..#   #
#   ## ###   #
## $  $  $   #
 ##  # # # @##
  #        ##
  ##########
Solution: 6-10u2,5-7r1,10-6u2,8-9r1,10-10u3,11-6l2,8-5d1,7-1d3,6-5r1,10-4u1r1u1l3,7-1d2,6-4r1,3-7u1,2-5r2,2-9r1,5-4d2,3-3d1,2-5r2,5-4d1,3-9r2,6-10u5,7-4l1,5-2l1u1l1d7,2-9r3,6-10u5

;16
  ######## ########
  #....  ###@.##  #
  #....$ # #....  #
  #..##    #...#$ #
  #...# ## ##.##  #
####### ##$## ## ##
#       $    $$   #
#  #### ####$   $ #
##           #   ##
 #$######$## #####
 #   $  $ #    #
 ## $$# #  $ $ #
  # $ # ##  $$ #
  #   $ ## $ $ #
  #            #
  ##############
Solution: undefined

;17
######### #######
#....#  ###     #
#...## @##  $ $ #
#...  #     ## ##
#   # #     #  #
#       ###   ##
###     #  $  ##
  ###$ ##$$    #
    # $ $   $  #
    #  # ###   #
    # # $# #   #
    #    # #   #
    #    # #####
    ######
Solution: 15-2u1l2d1l1u1l1d1l1d2r1d1r1d3l4d2l1d1l2u5r1u1l2d1l1u4l1u1r1d4r2d4r1u3r1u1l3d1l1u2d1r2u2l3d1l1u2,8-8l2d1l1u3r1u1l2d1l1u2d1r2u2l2d1l1u2,8-12u3,9-8l3,5-9u3,6-5l2,3-6u2,4-3l2,1-4u1,11-5d2,12-8l6d1l1u3,6-5l2,3-6u2,4-3l1d1l1u1,12-10u1r1u1l7d1l1u3r1u1l2d1l1u2,3-4u2,10-6d1r1d1l5d1l1u3r1u1l2d1l1u2,4-3l2,9-6d1r1d1l4d1l1u3r1u1l2d1l1u2d1r2u2l2,11-2d5,12-8l6,5-9u3,6-5l2,3-6u3,15-2l3,11-1d6,12-8l6,5-9u3,6-5l2d1l1u2

;18
 ################
 #...#      #...#
 #...#$#### #...#
 #...      $@...#
 #  $#$#  #$#$  #
 #   # #  # #   #
 #####  $$# #####
     # $$ $    #
######     $#  #
#    $ $##  ## #
#   $#$ ###    #
####  $    $  ##
   #  #####  ##
   ##       ##
    #########
Solution: undefined

;19
  #######
  #     ###
 ## $  $  ####
 #  ####$    #
 #  # $     #####
 ## #   $######.#
  # ## #  #  ...#
  # $   $ #  ##.#
### $ $#  #   ..#
#   ## #  @  ##.#
# #  $ ## #   ..#
#     $   ### #.#
#######         #
      #######   #
            #####
Solution: l1d2l5u1l1u1l2d2r1l1u2r2d1r1d1l1r6u5l1d1r1d4l3u3l1u1r3u1r1d1l3d4r3u2l1r1d2l3u4r3d1u1l3d4r3l3u4r3d4l1d1r6d1r1u7,8-9u1,7-7r1u1r1d2,8-9r3,12-10u3l1u1r2,3-7r5u1r1d2l1d1r3,12-10u3l1u1r1,8-4d2,7-7r1u1r1d2l1d1r3,12-10u1l1u1r2,8-2l1r1d4,7-7r1u1r1d2l1d1r3u1r1d1l1d1r2,1-11r7,9-10d1l1d1r6,15-13u6,4-10r1,6-9d1l1d1r3,9-10d1l1d1r6,15-13u5,3-8r2u1r1d3,5-11r3,9-10d1l1d1r6,15-13u4,5-4r2,8-3d3,7-7r1u1r1d5,8-12r6,15-13u3,5-2l1,3-1d9,2-11r6,9-10d1l1d1r6,15-13u2,7-2l3u1l1d9,2-11r6,9-10d1l1d1r6,15-13u1

;20
#############
#           ####
# ##### ###  $ #
# #   $$$ $ #  #
# $       #  # #
# ### $$$ #$ $ ##
#   ### ###  #  #
# #     $  $ $  ##
#       #  ###   ##
### ### $ $  #    #
##   ###  #  ###  #
#      ##  $      #
#..... ###       @#
#......# ##########
#......#
########
Solution: 9-7l5d1l3u2r2d5l1r1l1d1r3u1r1d2,7-9r1d1r1u2r1u1l6d1l3u2r2d4r1d1l1u1l1d1r1d1l1u1l1d2,11-9l1r2d3l2u1l1u3r1u1l6d1l3u2r2d6r1d1l2,12-7l8d1l3u2r2d5r1d1l2,11-12u2r1u1l2,9-10u2r1u1l6d1l3u2r2d6l1d1r3,14-7l10d1l3u2r2d7l1d1r2,11-4d2r1d1l8d1l3u2r2d6l1d1r2,14-5l2u1d1u1l1d2r1d1l8d1l3u2r2d5r1d1l1u1l1d2,14-2l2,11-1d5,12-7l8,3-6d6r1d1l1,7-6d1l4u1l2u2r2u1r2d1r2d2,8-7l4d1l3u2r2d5r1d1l1,9-5l1u1l1d2,8-7l4d1l3u2r2d4l1d1r1u1r1d1l1d1r1,5-5r1u1r1d2,8-7l4d1l3u2r2d4l1d1r1u1r1d3,7-2d4,8-7l4d1l3u2r2d4l1d1r1u1r1d2,9-3l1,7-2d4,8-7l4,3-6d4l1d1r1u1r1d1,11-3l3,7-2d4,8-7l4d1l3u2r2d7,5-3d1u1r1,7-2d4,8-7l4,3-6d6,3-4r3,7-3d3,8-7l4,3-6d5

;21
########
#      # #########
#      # #  .....#
# ###$ ###  .....#
# #   $    # #####
#    #  @ $$$#
# ##$ $    # #
#   $  ###   #
###$#$ # ##  #
  #   ##  ####
  #   #
  ##  #
   ####
Solution: d1r2d1r2u3d3l2u1l1u2r1u1r5l5d1l1d2r1u1r1l1d2r2u4l1u1r4l5d2l1d1r2l1d2r2u3d1l2u2r4l4d3l1u1l3u1l2d1l3u3r4d1u1l4d3r2u1r6d1r3u2l2d1l1d1r2l1d2r2u4l1u1r3l4d2l5u2r1d1l1d1r4d1r3u2l2d1l1d1r2l1d2r2u3d1l2u2r3l3d2l1u1l6d1l2d2r4d2u3r4u1r3d2l2u1l1u1r2l1d2r2u4l1u1r2l3d3l4d1l1d2r1u1l1u1r4u1r3d2l2u1l1u1r2l1d2r2u3d1l2u2r2l2d2l4u1l2d2u1l3d2r4d1r1u1l1u1r4u1r3d2l2u1l1u1r2l1d2r2u4l1u1r1l2d3l2d1l2d2l1d1l1d2r1u4l1u1r5u1r3d2l2u1l1u1r2l1d2r2u4d3u1l6d2l1d2l2u1d1r2u3l1u1l3d2r4d1r1u1l1u1r4u1r3d2l2u1l1u1r2l1d2r2u3

;22
#######
#.....#      ####
#.....########  #
#.....#  $   $  #
#..  #   #   #  #
#.    $$ #  # $ #
## ##$  ## #  $ #
##   $ @ #$   $ #
# $ $ $ $  $ #  #
#  #$###   $$ # #
#    # #####    #
######     #    #
           ######
Solution: u2l3u1l2d4u1d1l1d2r1u8l1u1r3d4l1u1l1d4l1d2r1u7l1u1r3l1d3r3d2l3r3u2l4d3l1d2r1u6l1u1r3d2l2d2r3d1l2u1l1d1l1d2r1u7l1u1r2d1r1u1d3r2d2l1u1r1u1l3r2d2l3u4l1u1r2d3l1d5r2u1d1l2u3r3d1l2r1d2l2u6l1u1r2d2r2d2r2d1l4r1d2l2u5l1u1r1d1r1u3d1,7-3d1r1d1l5r2d3l3u5l1u1r1,8-3r2d2u2l2d2l1d3r1d1r2u1l7r1d2l2u6l1u1r1d5r8u1r2d1l3d1u1l6r1d2l2u5d2r3u2l1u1l2d1l1u3,10-5d2,9-8r1u1r2d1l9r1d2l2u5r1u1l1d1l1u2,12-8d1r1d1r2u3l4d1l3u1l1u4r3d4r1d1l8r1d2l2u5r1u1l1d1l1u1d1,15-6l1r1u2l1d1l1d1u1r2d2l4,10-6u1d2r1d1l8r1d2l2u5r1u1l1,14-5d1r1d1l4,10-6d1r1d1l8r1d2l2u4d1r3u2l3,12-11u3,13-7l2,10-6d1r1d1l8r1d2l2u8,10-9r1,12-10u2,13-7l2,10-6d1r1d1l8r1d2l2u7,12-3r1,14-2d4r1d1l2u1l1r1d1l2,10-6d1r1d1l8r1d2l2u6,10-3r3,14-2d4r1d1l4,10-6d1r1d1l8r1d2l2u5

;23
      #######
#######.....#
#   $  .....#
#   $ #.....#
##  # #     #
 # $  #  ####
 # # $ #  #
 ##   $   #
 # $$$ $$ #
##   $ #  #
#   $ $ $ #
#@ # $##  #
####      #
   #      #
   ########
Solution: undefined

;24
 #####
 #   #########
 #         $ ##
 # $#$$$   $  #
 #  #  # ###  #
## ##  #...# ##
#   # ##...  #
#   #   ...# #
# #$#@ ### # #
#  $   $     #
## ## ### ## #
 #           #
 #############
Solution: d1u2r4u2l1u3l2d1r1u1r1d4r2d3l1d2l4u4r4l3d1l1d3r4u2r2l1u3r2u3l3u1l1d4r1d1r1d2l1d2l4u3r1u1r3l4d4r5l1u2r1u2d2r2u3l2d1l1u1l1d1l3u2r1u1d1l1d2r3u4l1u1l2d1r2u1r1d4u3l2d2l1d2r4u1r3d3l2u2d2r2u3l2,3-4u1l1u2r1d1r6d1r3u1d1u1l5d1l1d2l1d4r6l2d2r3u7r1u1l4u1l1d4u3l2d2l1d2r4l3d2r4u2d2l5d2l3u2r9l2d2r3u7r1u1l4u1l1d4u3l2d2l1d2r4l3d1l1d1l4u3r1u3d4r1d1u1l2d2r10l2d2r3u7r1u1l4u1l1d4u3l2d2l1d2r3,5-3d5,4-9r7l2d2r3u7r1u1l4u1l1d4u3l3d6l2u3l1u2r1u1l1u2r2d1l1u1l1d5l1d1r1u1r1d2u1l2d2r10l2d2r3u7r1u1l4u1l1d3u3l5u1l1d5l1d1r1u1r1d2u1l2d2r10l2d2r3u7r1u1l4u1l1d2

;25
#####
#   #######   #####
#  $  $   #####...#
# $ $ $   $    ...#
#  ###    $  # ...#
#  $ ###$$##  #...#
#   $    $ # @  # #
#   #    #        #
#  #######    ##  #
####     ##########
Solution: l1u3l3d1r2u1r1d3r1d2l2u1r5d1r1u5l8u1l2d1r7d1r1u1l5r2d4l2u1l2r1u2l1u1r7d1r1u1l5d1l2d2l1u1r1u2l2d1r4u1r1d3r1d2l2u1r1d1r1u1l1u1r2d1r1u2,14-4r2,6-6r1d1r1u2,7-4r4u1r1d3r1d2l2u1r1d1r1u1l1u1r2,15-7u2,14-4r1u1r1d1,6-6l3d1l2u1r6d1r1u2r1u2l2d1r4u1r1d3r1d2l2u1r1d1r1u1l1r1l1u1r2d1r1u2,14-4r1,4-5l1d1l2u2r1d1l1d1r6d1r1u2r1u2l2d1r4u1r1d3r1d2l2u1r1d1r1u1l1u1r2d1r1u2,2-2d3l1d1r6d1r1u2r1u2l2d1r4u1r1d3r1d2l2u1r5d1r1u2,7-2l2d1l2,2-2d3l1d1r6d1r1u2r1u2l2d1r4u1r1d3r1d2l2u1r1d1r1u1l1u1r2d1r1u1,5-3r11,3-1d1l1d1r13l6u1l5d1l3u2r2d1l1d1r12

;26
       ######
       #....#
       #....##
    ####.... ###
 ####     #    #
 #  $$  #   #  #
 #  # $ # @ #  #
 #  #   #      #
###$#  $#$###$##
#  $ $# $     #
#  $$         #
#    ##########
#    #
######
Solution: undefined

;27
   ######
   #....#
  ## ...#
 ##   ..#
##     .#
#    ####
#  # #
# $$ ######
#  # $    #
#  #$ $ # ##
#  #   ##  #
##$ # $ #  #
 #  $$ $ @ #
 #         #
 ###########
Solution: 2-13u3l1u2r1u2l1u1d1u1r1l1d5r1d3r4u2l1u1l1u6l1u1r2d1r1u2l1u1r1,2-5r1,4-6u2l1u1r3d1r1u1,2-7r1,4-8u4l1u1r3,6-8l1,4-9u4,3-4r3,7-9l2,4-10u6,3-3r2d1r1u2,2-10u4,1-5r2,4-6u2l1u1r2d1r1u1,6-11u2,7-8l2,4-9u5,3-3r1d1r1u2,8-12l1,6-13u3,7-9l2,4-10u6l1u1r2,5-13u4,6-8l1d1l1u4l1r1u1l1u1r1d1r1u1,3-12r1d1r1u4r1u1l1d1l1u7

;28
######
#    # #####
# $$ ###   ####
# # $##   $#  #
# #   #       #
# ##  ####$   #
#          #  #
#        ###  #
#     $    $  #
# @  #$#   #$ #
#   #   #  $  #
### .....  ####
  ##..... ##
   ########
Solution: 7-8l1d3l1d1r2l1u5l2d1r1u1r1d4r1d1l2r1u5,4-2d5l1d2r1l1u1r2u1r1d4r1d1l1,3-1d1u1l2d1r2u1r1d6l1d1r2u1r1d3l1d1r1u1r1d1,3-4u1r1u2l3d1r2u1r1d6l1d1r2u1r1d4,10-6u1r1u1l2r4d6l1u2l5u1l1d3l1d1r2,12-10l2,9-11u2,10-8l3,6-7d2,7-11r1,6-9d1l1d1u1r2d1l2,10-11l4,12-6d1r1d1l6,6-7d3,10-2d1l1d1r2,12-3d6,13-10l3,9-9d1r1d1l2,7-4r4,12-3d6,13-10l3,9-9d1,10-11l1

;29
############
#          #######
#                #
# $########$$    #
# $    #  $  ##  #
# $$  $   $ $  # #
## #####  $  $ # #
#      ### ####  #
#   @            #
### ## ##   ######
 #      # ###
 #......  #
 #......###
 ########
Solution: undefined

;30
########   #####
#......#   #   ##
#......#####    #
#......#   $$$  #
##   ##  #   #  #
#   # $$# $  #  ##
#   # #  $   #  @#
#   #  $$    $  ##
##    $  #$###  #
 #      # $     #
 ###  $$# $$    #
   ###   $  #####
     #      #
     ########
Solution: undefined

;31
######
#    #   ######
# $ $#####    #
# #  $        #
#  #  # @   #$#
#  #  #   ##  ##
#  $   ###     #
####     $     #
   #$#$##$######
   #      ##
   ##   ####
    ## ....#
     # ...##
     ##..##
      ####
Solution: r1u1r4d2l1d2u2r1u2l4r4d2l1d2l6u1l1u1l1u2r7l8u2r1d1l1d1r5d2u2l3d1l1d3r6l5r1d2l1d1r1u1r1d1l1d1r3l3u2r3u1d1,10-7l1r1l3,6-6d3l1d1r1u1r1d2l1d1r2,2-6r2u1r1d1l1d1r1u1r1d3l1d1r1u1r1d2l1d1r1u1r1d1,4-9u2r1u3l1u3l3d5r3u1r1d1l1d1r1u1r1d3l1d1r1u1r1d1l1d1r2,1-2r2u1r1d4u3l3d4r3u1r1d1l1d1r1u1r1d3l1d1r1u1r1d2l1d1r1,12-7l6u1l2d1r1u1r1d3l1d1r1u1r1d1l1d1r1,13-5d1r1d1l8u1l2d1r1u1r1d3l1d1r1u1r1d3,11-3r1u1r1d4r1d1l8u1l2d1r1u1r1d3l1d1r1u1r1d2,8-3r4u1r1d4r1d1l8u1l2d1r1u1r1d3l1d1r1u1r1d1

;32
    ########
    #      #
    # $    #
###### ##$ ###
#..##   $ $  #
#..   #  $   ##
#..     # #   #
#..#      #   #
#..##     #   ####
#####  ##$ #$    #
   #      $ $   @#
   ######  $  ####
        ####  #
           ####
Solution: l3d1l2u1l4r3l1r2d1r2u5l1u1l3u1r1u3d4l2r1d2l4u3r2d2u1r2d2l3d1l1u1r1u1l1d1l1u1r1u1l3u1l1d3u1r4u2,9-2d2r1d1l2r1u2d4l4u3r2d2u1r2d2l3d1l1u1r1u1l3u1l1d2,7-4r1d1r2u2l1d1r1d1l2u1l1d2u1r2d2l3d1l1u1r1u1l4u1l1d1r3u1r1u1r4u3l3d2u1r3d3l2d1l2u2r3l2u2r3d2r1d1l2u1l1d2u1r2d2l3d1l1u1r1u1l3u1l1d1r5u1r5u1l2u1l1d1r1d1l2u1l1d2u1r2d2l3d1l1u1r1u1r1l2d1l1u1r1u1l3d1l1u1r4,11-10r2l1u3r1u1l1d1l1u1r1u2l1r1d1l4u1l1d2u1r2d2l2d1l1u1r1u1l2d1l1u1r1u1l2d1l1u1,9-10u4,10-5l2u1l1d2u1r2d2l3d1l1u1r1u1l1d1l1u1r1u1l3,15-10l2d1l1u4r1u1l1d1l1u1r1u1l4u1l1d2u1r2d2l3d1l1u1r1u1l1d1l1u1r1u1l2,5-10r6d1r1u4r1u1l1d1l1u1r1u1l4u1l1d2u1r2d2l3d1l1u1r1u1l4,9-11r2u1r2d2l1u5r1u1l1d1l1u1r1u1l4u1l1d2u1r2d2l3d1l1u1r1u1l3

;33
         ######
 #########   .##
 #     #     ..##
 # $ $ # $#  ...#
## ### #  # #...#
#  $ #  $## #####
#    # #  # #
##   $ #  # #
 ###   #  # #
   ##  $$$# ###
    ###       #
      ##@ # # #
       ####   #
          #####
Solution: 9-4u1l1u1r4u1r1d1l1d1r1u1r1d1l1d1r1,9-10u2l1u4d4r1d2l1u2,9-6d3l1d1r3d2r2u2l1r1d2l2u9r1u2l2d1r2u1r1d1l1d1r2,6-9r2u1r1d1l1d1r3d2r2u2l1r1d2l2u9r1u2l2d1r2u1r1d2u1l2d1u1l2d2l1d1l1r1d4l1d1r4d2r2u2l1r1d2l2u9r1u2l2d1r2u1r1d1l2d1r2u1r1d1,8-2d7l1d1r4d2r2u2l1r1d2l2u9r1u2l2d1r2u1r1d1l1d1r1,4-7r1,6-6d2,5-9r2,8-8d1,7-10r4,13-10l1,11-11u8,10-2r2u1r1d1,4-3r1u1r1d6l1r1l1d1r3u1r1d1l1d1r3d2r2u2l1r1d2l2u9r1u2l2d1r3l5d3l2u3l4d1r3u1r1d6l1d1r3u1r1d1l1d1r3d2r2u2l1r1d2l2u9r1u2l2d1r2,4-5l1d1l1,2-4d1l1d1r2u1r1d1l1d1r2,6-6d2l1d1r3u1r1d1l1r1l1d1r3d2r2u2l1r1d2l2u10l1u1r2

;34
     ############
     #    #     #
     #  $   $   #
    ###$###$# $####
#####    $   # $  #
#..#     $   $    #
#..# $##$#   #  $ #
#..#     # @ ##$###
#...# $#$#   #  $ #
#...##       #    #
#...  # ##$## $$  #
#...     $  $   ###
#...  ####      #
#######  ########
Solution: u2r3u1r1l1d2r1l1u2d1l6u1l2d1r4u1r1d3u2r3u2l1u2l2d5u4l2u1l2d3l1d1r4u1r1d1r3d1r1d2l1d2l1d2l3u1l6d1l1u1r1l1r1u1l2d1l1u5,13-11l10d1l1u6,15-11l13d1u1d1l1u5,10-9d1,11-11l8d1l1u5d2,14-10r1l1u2r1d2u1r2d1l2u2l1d2,15-12u1l13d1l1u4,16-10l1u1l1d1r1d1l12d1l1u4,17-8l1,15-7d1r1d1u1l1d1r1d1l1u1l1d1r1d1l11d1l1u3,15-4d5r1d1l1u1l1d1r1d1l13d1l1u3,17-6l1u1l1d4r1d1l1u1l1d1r1d1l12d1l1u3,12-8l1r1u3l2d5,11-11l9d1l1u2,14-1d3,13-5r1u1r1d5r1d1l1u1l1d1r1d1l12d1l1u2,17-4l2,14-3d1,13-5r1,15-4d5,16-10l1u1l1d1,15-11l11d1l1u2r1,12-7l1r1u2l2d5,11-11l6u1l1d1r1d1l3,11-5d3r1d1l1u1l1d2,11-11l6d1l1u1r1u1l3,13-2l1u1l1d7r1d1l1u1l1d2,11-11l6d1l1u1r1u1l2,8-4r2,11-3d5r1d1l1u1l1d2,11-11l6d1l1u1r1u1l1,7-2r3,11-1d7r1d1l1u1l1d2,11-11l6u1l1d1r1d1l2,8-7u1,7-5r1u1d1r1u1r1d6,11-11l6u1l1d1r1d1l1,5-7u1l1u1r5u1r1d6,11-11l9,8-9u3,7-5r2,10-4d6,11-11l8,6-9u1,5-7r2,8-8u2,7-5r2,10-4d6,11-11l7

;35
#####
#...#
#...#
#...#########
#.  #       #
##  #$#$##  #
##  #      ###
#      #$#   #
#  ## #      #
#  #  # $# ###
#####$#  # #
#   # #$ # #
#  $  @ ## #
#  $#$  $  #
##  #  #####
 #######
Solution: r1u1r1u2l1u1r3u4l5d2r1d1l3u1l1d1l1d2r1u7r1u1l1,7-4d1,8-6l2,5-5d1,6-7l3,2-6d1,2-9u6,3-2l1,8-8u1,9-6l3,5-5d1,6-7l3,2-6d1,2-9u5,1-3r1,3-4u2,5-11u3,6-7l3,2-6d1,2-9u4,1-4r1,3-5u2,5-14u6,6-7l3,2-6d1,2-9u4r1u2l2d1r1u1r1d1,4-12l1,1-12r4,7-12l1,5-13u5,6-7l3,2-6d1u3r1d1l1d2l1d2r1u4r1u1l1d3r1u1,3-14u1,2-12r3,7-12l1,5-13u5,6-7l3,2-6d1,2-9u5,3-3l1,3-6u2,9-13l1r1l3d1l1u6,6-7l3u1l1d1l1d2r1u7,7-9d3,8-13l2,5-14u6,6-7l3,2-6d1,2-9u6,12-8l1,10-7r1d1l2,8-9u2,9-6l3,5-5d1,6-7l3,2-6d1,2-9u5

;36
      ########
      #      #
#######$     #
# $     $##$ #
#  ##     # $###
# #  $      $  ###
# # $#       $   #
# $    ## @   $  #
#  $ ###      ####
#   #### #    #
#  ## ##    # ##
# ##  #    #   ###
###   #   #......#
      ##   ......#
       ####  #####
          ####
Solution: r4u1r2d1l4u1l1d2l2r1d1r2u1r1d3l1d1r3l2u5r1u1l3d1l2u1r1u1r1d3l1d1r1u1d1r1u1r1d4l1d1r3l2u8l2u2r1u1l1r1d6l1r1l1d1r1u1r1d4l1d1r2,9-2r2u1r1d7l1d1r1u1r1d3l1d1r2u1l1u5l4u1r2u1r1d4l1d1r1u1r1d4l1d1r1,8-2d3l1d1r5u1r1d6l1d1r1l1u1r1l1d1,7-1d3,6-5r2u1r1d1,8-6r1u1r1d4,11-10l2,8-9d2,7-12r1u1r1d1l1d1r3,12-14u1,4-8l1,4-5r4,9-4d1l1d1r1u1r1d2l1d1r1u2r1d2r1d1l1u1l1d1r1d1l2,8-9d2,7-12r1u1r1d1l1d1r2,11-14u1,4-7u1l1u1r5,9-4d1l1d1r1u1r1d4,11-10l2,8-9d2,7-12r1u1r1d1,8-13r3,1-7r2d1r1u2l1u1r5u1r1d1l1d1r1u1r1d4r1d1l2,8-9d2l1d1r1u1r1d1l1d1r2,1-3r6,8-2d3l1d1r5u1r2d2u2l1d7,1-8r1d1r1u1l1u1r1d1r1u2l1u1r8u1r1d4l1d1r1u1r1d3

;37
    ###############
   ##     ....#...#
####   #  #.......#
#     #  ######   #
#  ## #$   $      #
# $ $ $    #####  #
#  ## ## $##   ## #
# $ $ $  $ $      #
#  #  $##$ $      #
###### @   ########
     #     #
     #######
Solution: r3u1r5l5u1r2d1r2u1r3u3l2u2l4u1l3d3r7u1r2d2l1u2r1u1l5u1l4d1u1l3d2u2r4l1d6r2l1u2l1u1r7u1r2d2l1u2r1u1l4,9-9u4l1u1r7u1r2d2l1u2r1u1l1d1l1u1d2l7u3l3d4r3d1r1u1l1u1r7u1r2d3u1l1u3d2l8u1l1d1r1u3l3d4r2u1r2d2l1u4,7-1r5,2-6u1,3-5r4,8-6u4,7-1r4,2-8u2l1u1r6,8-6u4,7-1r3,2-3d1,1-5r6,8-6u4,7-1r2,5-7r3,9-8u3,8-4r7,16-5u2,17-2l3,3-7r5,9-8u3,8-4r7,16-5u2r1u1l2,6-9u1l1u1r3,9-8u3l1u1r7,16-5u2r1u1l1,12-7l2d1l1u3l1u1r7,16-5u2,17-8l7,9-9u4,8-4r8,17-5u3,12-7r4,17-8u5

;38
####### ########
#     # #      #
#  $ $###$ #   ###
# $ $     $      #
# $ #.....#$   # #
#  $$.....  #    #
# $ #..#..$# @   #
#  $ .....  #  ###
# $$# # # #$   #
#  $      $    #
########  #  ###
       #$#   #
       #     #
       #   ###
       #####
Solution: undefined

;39
    ##########
#####    #...##
#   # $  #....##
# $ ### ## ....#
#  $#  $   ....#
#   $  $ @#  ..#
# $$#  $    ####
#   #$##$#$ #
####   #   ##
  ##$  $   #
  #    ## $##
  #   # $$  #
  #####     #
      ####  #
         ####
Solution: undefined

;40
        ######
#########    #
#     $  $   #
#   $ #   $  ####
###$#######$##  #
#       #    $  #
#    @  $       #
####    ##$#### #
#... ####  $ #  #
#...    #    $$ #
###...  # $  #  #
  #...  ##  $#$ #
  #...  ####    #
  #######  ##  ##
            ####
Solution: undefined

;41
        ########
 ##### ##      #
 #   ###       #
##     #$#$# @ #
#....#  $  #   #
#....# $   $   #
#....#  ####   #
#....#  $   $$$####
### #    $  #  $  #
  #      ####  $$ #
  #  #   $   ## $ #
  ####  ##      # #
     #####  ###$# #
         #        #
         ##########
Solution: undefined

;42
       #####
 #######   #
 #         #
 # #   $$###
 #    # $  ##
## ###  $ $ ##
#... #   # $ #####
#.... #$# $$ #   #
#....   $ $  # @ #
#.... # $  $ $   #
#  ###  #    #  ##
#  # #   #$##  ##
#### #         #
     ###       #
       #########
Solution: 10-12u2,9-8l3,6-8l1,5-8l1,4-8l2,1-9u2,11-8l7,4-8l1,3-8l1,1-9u1,12-6l1,11-5l1,9-4l1u1l1,7-3l2,4-2d1,5-4l2,2-3d5,3-9l1,1-8d1,7-8u2,8-6u1,7-2r1,6-5r1u1,8-3l1,7-3l2,4-2d1,5-4l2,2-3d4,1-8r1,3-9u2,9-4l1,7-5u1,8-3l3,4-2d1,5-4l2,2-3d3,2-6d1,1-8r2,5-8l1,3-9u1,8-6u1,9-4l1,7-3d1,7-6u2,8-3l3,4-2d1,5-4l2,2-3d4,1-8r2,4-9u1,10-5l2,7-6u2,8-3l3,4-2d1,5-4l2,2-3d2,2-5d3,1-9r2,10-2l1,8-1d2,9-4l1,7-5u1,8-3l3,4-2d1,5-4l2,2-3d5,1-9r1,1-11u1,11-10u1,12-8l10,9-9l1,7-10u3,7-7u3,8-3l3,4-2d1,5-4l2,2-3d1,2-4d3,2-7d1,10-10u1,11-8l8,11-6d1,12-8l4,8-8l3,5-8l1,14-9l3,10-10u1,11-8l6,9-7r1u1,11-5l3,7-6u1,7-5u1,8-3l3,4-2d1,5-4l2,2-3d3,12-7l1,10-8u2,11-5l1,10-5l2,7-6u2,8-3l3,4-2d1,5-4l2,2-3d1,2-4d1

;43
      ######
#######    ####
#....  #      #
#....   $## # #
#....#$#  $   #
### #  $  #   #
  # $  $  #  ###
  #  $ #  #    #
 ##   #  ## #  #
 # $##  #    @ #
 #      #   #  #
 ##  ##$$      #
 ###$$  #  #####
 #   #    ##
 #        #
 ##########
Solution: 8-2d2,8-6l2,6-7l2,3-8u5,4-2l2,5-5d1l1,3-7u2,4-4l1,3-4l1,6-7l2,3-8u4,4-3l1,3-3l1,3-10u5,3-5u2,2-2r2,4-13u2,5-10l1,3-11u6,2-4r1,8-4d1,9-6l5,3-7u3,4-3l1,2-2d1,6-3d2,7-6l3,3-7u3,4-3l1,6-12l1,4-13u2,5-10l1,3-11u8,4-2l1,7-10d2,8-13l1,6-14u1,7-12l2,4-13u2,5-10l1,3-11u8,9-11l1,7-10d2,8-13l1,6-14u1,7-12l2,4-13u2,5-10l1,3-11u7,11-4l2,8-3d2,9-6l4,5-6l1,3-7u2,6-2l1,8-5l1,6-6u2,7-3l2

;44
      #########
      #       ##
 ###### $   $  #
 #    #$ $ $   ###
 #    $  #$###$  #
 ##$#####    # $ #
 #      #$   $   #
 #   @       #$$ #
#### ##  $   #   #
#.#   #####$######
#.#  ..## $ $  #
#.......#      #
#.......#      #
################
Solution: r5u2l1d1r1d1l5u1l1d4r1d1l3d1l1u2d1r3u4r7d3r1d2l1u4r1u1l7u1l1d4r1d1l3d1l1u1r3u4r7d4l2u1r1d1r1u3r1u1l7u1l1d4r1d1l3r2u4r8d1l1d3r3u1l2d1l1u3r1u1l7u1l1d5r1d1l3r2u6d1r3d1r3u1r1d3r1d2l1u4r1u1l7u1l1d5l1d1r3l2u5r6u4r1u2l1d5r1d1l6u1l1d4l1d1r3l2u4r6u6r3d1l2u1l1d5r1d1l6u1l1d5r1d1l2r1u5r6u5r3d1l2u1l1d4r1d1l6u1l1d4r1d1l2r1u5r2d1r4u6l3d1r2u1r1d5r1d1l6u1l1d5l1d1r2l1u5r6u5l2d1r1u1r1d4r1d1l6u1l1d4l1d1r2l1u5r2d1r4u4l2d1l3u1l2d3l1d1r1u1r1d3l1d1r2l1u4l1u3r2d1l1u1l1d3l1d1r1u1r1d5r1d1l1u6l1u2r5u2l1d1r1d1l4u1l1d3l1d1r1u1r1d4l1d1r1u1r1d1l1u4r8u1r2u2r2d2l5u1l1d1r1d1l6u1l1d3r1d1l1u1l1d1r1u3r8u1r4u2l1d1r1d1l6u1l1d1r1d1l5u1l1d3l1d1r1u1r1d1l1u3r8u1r4d2l1u1r1u1l6u1l1d1r1d1l5u1l1d3l1d1r1u3r8u1r3d2l1u1r1u1l5u1l1d1r1d1l5u1l1d5u5l1u2r5u2r6d3r1d1l5u1l1d1r1d1l5u1l1d4

;45
      ######
#######    #
#    #   $ #
# $  $ $ # ####
#  $ ##$##    #
##$###...$$$  #
#     ...#    #
#@ # #...###$###
#    #...#     #
###  #...#  $  #
  #  #...##$####
  ##$# ### $  ##
  # $    $  $  #
  #      #     #
  ##############
Solution: 3-12r2,6-13u3,6-10u1,4-12u5,3-6r4,8-5d4,8-12r2,10-11r1u2r1,12-8u2,6-3l2,2-4d2,2-8u1,1-6r1,2-6r4,6-6r1,8-5d2,8-9u1,8-6d2,8-3l1,7-3d2,6-6r1,8-5d2,5-3r1,7-2d3,7-5d4,10-6u1l2,7-4d2,6-7r1,12-6u1l4,7-4d1,6-6r1,6-9u3,10-3d1,11-5l3,7-4d4,13-11l1,12-13u1l5,6-13u5,11-10d1,12-12l5,6-13u4,13-11l1,11-10d1,12-12l3,9-12l2,6-13u3,10-8r1,12-9u2,12-7u1,14-9l2,11-8d3,12-12l5,6-13u2,13-5l1,12-5l4,7-4d3,13-4l2,10-3d1,11-5l2,2-2d4,2-8u1,1-6r4,5-6r1,7-5d1,4-3l1,2-2d4,2-8u1,1-6r5,4-4l1,2-3d2,1-6r4,10-2l2,7-1d1,7-2d2

;46
      ####
 ######  ######
 #...# $      #
 #...# #  # $ #
 #.... #  $$ ##
 #.... $$$    ###
 #  .##    #### #
 # ##  $ #$     #
##$   #  $ ###  #
#  #$$ # $ #   ##
#   $   #  # @ #
#   #   #  #   #
#####         ##
    #         #
    ###########
Solution: 10-8u2,8-6u2,7-8u1,8-5l3,4-6u3,7-7u1,8-5l3,4-6u1,3-4r1,5-10l2,2-9u6,10-8l1,9-10u1,8-9u2,9-6l1,7-7u1,8-5l3,4-6u2,10-8l1,8-9u2,9-6l1,7-7u1,8-5l3,4-6u1,9-4d1,10-6l2,7-7u1,8-5l4,3-6u3,11-3d1,8-2d2,9-5l5,3-4d1,2-6r1,11-4l2,8-3d1,9-5l5,3-6u2,6-2r1,8-1d2,8-3d1,9-5l5,3-6u1,2-11u7,4-10u1,5-8l2,2-9u1,2-8u3,6-9l1,4-10u1,5-8l2,2-9u3,10-4d1,12-5l2,10-5l6,13-3l1,11-2d2,12-5l7,10-7u1,11-5l2,9-5l1,8-5l2

;47
     ######
     #    ###
  ####      #####
###. #$#    #   #
#.....$ $#    # #
#.....#   ##    #
#.....#  $  #   #
##   ## $   #   #
 ## ####  @ $   #
 #   $  #$  $$###
 #  $     ##  #
##$# #$$   #  #
#   #  $      #
#   $  #####  #
#      #   ####
########
Solution: undefined

;48
   ####
####  ########
#     $      ####
#  $  #####     #
# ## ## $ $ $   #
#   $  $ $  ### #
# # # ## ##     #
# #$$ ....  #   #
#   # ....  #   #
#   # .... ##$ ##
##$### ### #   #
#              #
#     # @ ######
###########
Solution: undefined

;49
#####
#...##########
#...#    #   #
#...#        #####
#...    $#$  ##@ #
##  #    #  $    #
## ### ######    #
#     $ $   #$   #
#   #  $$     $  #
# ### ## ##$$#####
#     #    $     #
#######     #    #
   #        #    #
   #             #
   ###############
Solution: undefined

;50
######
#....####
#....#  #
#.#..#$ ####
#....   $  ######
#..  #$$   #    #
#.  ##     $    #
###  #####$#$#$##
 ##  $     #   #
##   #  @ $$$  #
# $$$#     #  ##
#    #$#####  #
#   $$        #
###          ##
  ##  ########
   ####
Solution: undefined

;51
 ###########
 #   #.....#
 #      ...#
 # #    ...#
 #   #.....#
 ##  ##############
  ##$     @       #
   #     ###  $$  #
  ##$# $#   #$  # #
  #   # #   $ $ # #
### # #  ###  $$$ #
# $  $   # #  $ # #
#  $$   ## ###    #
#      ##    #    #
########     ######
Solution: undefined

;52
#####
#...#    ########
#...### ##   #  #
#.....###  $ #  #
#....   $ $  $  ##
# ...#  # $  #$  #
## ##   ###$##   #
 #      $    #$  #
 #  ##  #    $ $ #
 ##     #####  ###
  # @ $#   #   #
  #   $   $#$$ #
  ####  #$ $   #
     #     #   #
     #    ######
     ######
Solution: undefined

;53
            ####
 ######### ##  ###
##  ...  # #     #
#   .#.  # #   $ #
#  #...  ####$####
## #.#. ## #  $  #
 #  ..#    $     #
 #  ..# @  #     #
 ###..#    ##$####
   ###### # $ $ #
####  # $ #     #
#  $  $  $#$ $  #
#  $ $#$        #
##    #   #   ###
 ###  #########
   ####
Solution: undefined

;54
 ######  ######
 #    #  #    #
 #   $#### #  #####
 # $  $    #  #...#
 #  # $  @    #...#
##  ##        #...#
#    ###  #  #....#
#  $   #  #       #
#  # $  $   #$#   #
####$#  $   $  ####
   # #$##### $ #
 ###   #   #   #
 #   # #   #   #
 # #   #   #   #
 #     #   #####
 #######
Solution: undefined

;55
         ####
##########  ######
#        #  ##   #
#    #   $ $   @ #
### $ #  $ $    ##
  #$  $ $ $#$   #
  # # ###  # $  #
  # #...   # #  #
  # #...#$$$ #  #
###  ...#   $   #
#  $ ...#   #  ##
#  # ## #  #   #
#   $  $ $#   ##
####  #$  ....#
   #    # ....#
   ############
Solution: undefined

;56
      ####
#######  #
#        ###
#   $$$#$  # ####
#    #     # #  #
#  $#  @#  ###  #
#   $ #  # $    #
####  #... $#   #
   #  #...#  #  #
   #   ...#  #  #
####$$# ## $ $  #
#     $    #$####
#   ## $        #
#     #$$## ....#
#        ###....#
########## ######
Solution: undefined

;57
 ################
 #          ##  #
 #      @#    ..#
 #  ###     # ..#
 # $  ####    ..#
 # $   $    #...#
 #  $# #$ # #...#
 ###  #  $#  ####
   #  #   $  #
####$ #  ##  #
#  # $#  #   #
#     $  #   #
#   # $###  ##
##    $      #
 #######     #
       #######
Solution: undefined

;58
 ######### #####
 #   #   ###...###
 # $ #     #.... ##
 #  $ $###  ....  #
 # $  $    #....  #
 ###  $  @ #####  #
  #    ##     $ $##
  #  # ####   #  #
  # $$ #  $ # #  #
####  $# $  # ####
#  ##   $   # ##
#    $$$     $ #
#...#  # ###$  #
#...#  # $ $   #
#     ##   #  ##
###############
Solution: undefined

;59
 ################
 #              #
 ##$### #  ## ###
 #  $  $##      #
 #  ##   #$##$# #
 #  #  #   ##   #
 # $# $ #   #   #
 #  $ # # @ # ###
 ###    # ###$#
   #$# $  ##  #
   #  ###$##  #
####        $ ##
#... # #####   #
#...   #..     #
#...    ..######
###########
Solution: undefined

;60
#######     ######
#     ##    #    #
#      ## ###$   #
#  ###  ###  $ $###
#  #  $$  $   #   #
#  #  $   $   # $ #
#  $  $$#####$## ##
#   $#         #  #
###  #  @  #      #
  #  #$      ######
  #    ####  .....#
  #    #  #  .....#
  #    #  ###.....#
  ######    #######
Solution: undefined


