;1
########
#@     ####
# $$$$$$  ##
# ..$ ...$ ###
# $# .$. $. .#
# ..######   #
#####    #####
Solution: 2-3d1,1-5r1,2-1d2,2-3d1,3-3r1,5-4r1,8-4r3,6-1d1r1,8-4l2,10-3l1,4-4r5,3-1d1,4-3l1,4-1d1,6-2l1,5-4u1l1,5-3r1,5-1d2,9-2l2d1,6-1d1,5-3r1,3-2r2,6-1d1

;2
     ## # # #
  ### # ##.##
  #. .##.   .#
   #  $. $ $ #
  ##.$  $$ $+#
## . $$$ . .##
#  $ $   ###
 # .##.$#  #
 ### #  #
      ###
Solution: 10-4r1u1,10-2r1,8-5u2r1,10-4u2,9-3d1,8-5r2,6-4l1,6-6l1u1,4-5u2,5-2l1,5-3r1,6-6u1,6-5r2,7-8u1,5-5u2,7-4l2,3-7u1,2-5r3,5-6l1,3-5d1,7-5l3,8-6l1,6-5d1

;3
     ## # # #
  ### # ##.##
  #...##. . .#
   #$ $. $$$ #
  ##.$  $$ $.#
## .@$$$ . .##
#  $ $   ###
 # .##.$#  #
 ### #  #
      ###
Solution: 4-4u1,5-2l1,3-5d1l1,4-6r2u1r2,7-3l2,6-5l1u2,4-4u1,4-6u1,6-3d1,7-5l3,8-5r2,10-4u2,10-4r1u1,10-2r1,8-3r1,10-4u1,8-5u2,9-3d1,8-6l2,7-8u4,4-6r1,6-5d1

;4
     ## # # #
  ### # ##.##
  #...##.$. .#
   #$ $. $$$ #
  ##.$  $$ $.#
## .@$$$ . .##
#. $ $   ###
 # .##.$#  #
 ### #  #
      ###
Solution: u2r1u1l1d4l2r4u1r4u1r1l1u2d2r1u1l1u1r1d1l1d2l5d1l1u3d2r1u2d2r2u2r2d1l1u1l1d1r1d1l3u1l1d1r1d1l1u1l1d1r3u1r2u1r3u2l2d2r1u1l2d2l3u2r1d1r1d1l3r2l1r3d1l2d2r1u3r1u1l3d1l1d1r1u1r1d1

;5
#############
#@ $       .#####
#..*.$.$.$.$ . .#
#$$ ##*###*## $ #
#  $.$.$. .$ .$.#
#      # $      #
###### #$########
     #   #
     #####
Solution: r9d1r3l3u1l9r3d1l1u1l2d2r1d2r2u1d1l2u2l1u2r9d1r3d2u2r1l1d3r2u2l1u1l1r1d1r1d2l2u1r1d1l4u1r2,6-4r4,8-7u2,10-5l1,7-4r1d1,8-2r1,6-2r1,4-2r1,1-2r2,4-4l1u1,2-5u2,1-5u2,6-4l3,10-4l4,8-7u2,7-4r1,4-4r1,1-4r2,10-4l1,12-4l1,14-4l1u1,11-4r1

;6
################
#@             #
#  $*.$*.$*.$  #
# $..$. $..$ $ #
#*. $.$$.$$.$.*#
# $..$. $..$ $ #
#  $*. ..$*.   #
#              #
################
Solution: 1-3d2,1-5r2,6-5u1,5-4u1,5-4d1,3-7u1,2-2d1,13-2d1,12-3d1,11-4d1,9-5l1,8-4l1,7-3l2,3-4r1,6-3d1,1-7u2,3-1d1,8-4u1,6-1d1,7-4d1,11-4u1,10-5u1,10-7u1l1,12-6l1,10-4l1,9-1d1,11-5l1,12-4d1,14-5l2,11-6u1,11-6r1,12-1d4,12-7u1,13-5l2,14-6l2

;7
################
#@             #
#  $*.$*.$*.$. #
# $..$. $..$ $ #
#*. $.$$.$$.$.*#
# $..$. $..$ $ #
#  $*.$..$*.$. #
#              #
################
Solution: r1d2r1d2r1u1r1u1d2r2u1r1u1d2r2u1r1u1d2,12-3d1r1d1u2,12-1d2l1d1r1,1-5r2,13-5l5u1l1d1u1r3,5-4r2,6-1d2,7-4l1,8-3l1,6-7u1,3-7u1,9-7u1,9-1d1,12-7u1,13-5l2,3-1d1

;8
################
#@             #
#.$$*.$*.$*.$. #
# $..$. $..$ $ #
#*. $.$$.$$.$.*#
# $..$. $..$ $ #
#.$$*.$..$*.$. #
#              #
################
Solution: d4,4-5u1r1u1d2,7-5u1r1u1d2,10-5u1r1u1d2,12-5u1r1u1d2,1-5r10,3-3l1d1l1u1,2-7u2r1u1l1,2-1d2,3-1d1,3-7u1,6-7u1r1u1l2,7-4l1,6-1d3,8-3l1,13-5l5u1l1d1,10-4l1,11-3l2,13-3l2,12-1d2l1d1r1,12-7u1,13-5l2,9-3r1,10-1d2l1d1r1l1d1r3,12-3l1,10-4u1,7-3r2,9-7u1,14-5l3,9-1d1

;9
################
#@     #       #
#.$$*.$*.$*.$. #
# $..$. $..$ $ #
#*. $.$$.$$.$.*#
# $..$. $..$ $ #
#.$$*.$..$*.$. #
#      #       #
################
Solution: d3r2d1r1u1r1u1r2d2u1r1d1r3u2l1r1d2l4u2r1,14-3d1u1d1l1u1,10-3l1,8-2d1,13-4d1,14-6u1,13-5l1,11-4d1,8-5u2,5-4r2,6-1d2l1d1,3-3l1d1l1u1d2,4-5r1,3-7u2r1u1l1,1-5r2,7-5l1,5-4r1,5-6u1,4-4r1,6-7u1,7-5l1,5-4d1,3-3r8,1-4r2,2-1d2r1d1l1,2-7u2,5-5l1,4-3d1,3-1d1,7-5u1,8-3l3,7-4l1,9-7u1,10-5l3,13-3l6,9-3d1,11-4r1,9-4r1,9-1d1,12-7u1,13-5l2,12-1d1,13-3l2

;10
################
#@     #       #
#.$$*.$*.$*.$.##
# $..$. $..$ $ #
#*. $.$$.$$.$.*#
# $..$. $..$ $ #
#.$$*.$..$*.$. #
#      #       #
################
Solution: undefined

;11
    ####
   # . #
  # .$. #
 #  $$$ ##
# .$.@.$. #
# $*.$.*$ #
#         #
###########
Solution: r2l4u2r1d2r3u2l2r2d2l1u1d1l1u2,5-6u1,6-4l1,7-6u1,9-5l2,7-3d1,3-4r2,1-4r2,2-6u1

;12
    ####
   # . #
  # .$. #
 # .$$$$##
# .$.@.$. #
# $*.$.*$ #
#         #
###########
Solution: l2r4,9-4l3,7-2d1,6-4r1,4-2d2,6-4u1l1u1,4-4u1,3-6u2,4-4r1,4-6u1r1,7-6u1l2,1-5r1,9-5l2,7-3d1

;13
    ####
   # . ####
  # .$.   #
 # .$$$$#$#
# .$. +$. #
# $*.$.*$.#
#         #
###########
Solution: l3,6-2d2,4-4u1r1u1,8-4l3,4-5u1,7-2d1,6-4u1l2,8-4l1,9-2d2,5-4r1,5-6u1,6-4l1u1l1d1,8-4l1,8-6u1,1-4r2,2-6u1

;14
    ####
   # . ####
  # .$.   #
 # .$$$$#$#
# .$. +$. #
# $*.$.*$.#
#    $ .  #
###  * ####
  ######
Solution: undefined

;15
    ####
   # . ####
  # .$.   #
 # .$$$$#$#
# .$. +$. #
# $*.$.*$.#
# .$ $ .  #
#    * ####
########
Solution: undefined

;16
   ##########
   #   .    #
   # $$.$$. #
   #.$.$.$ ##
   # $. .$.#
   #.$. .$##
  ##  $.$ ###
 ##.   $   .##
 #  $$$$$$$  ##
## $...$...$  #
#  $.  $  .$$ #
# $$.  .$ .$. #
# .$...$...$ ##
#   $$$$$$$  #
#     .$.    #
###.  .$. .###
  #   .$. ##
  # $..$. #
  # $..$. #
  # *  $.##
  ## **. #
   #   @ #
   #######
Solution: undefined

;17
###########
#@        #
#  # .# $ #
# # $$.#. #
# ..#. .$ #
#  #  $$$ #
# $$.$.#  #
# .#  .#$ #
# ..#$$.$ #
#         #
###########
Solution: d3r1d3l1d1r1u3l1u4r8d8l8u5r2l2u3r4d1u1r4d8l4r1l5u4d1u5r4d2u1d1r1d2l2d1l1r1u1r2u2l1u1l1u1l3d4r1d2u1r2u1d2u2r2l1r1u1d1l2d1l2u2r1u1r2l2d1l1d2r2u1r1u2l1r1d2l1d2r1u1l3u2d2r3u1d1l4d3r4u2l1u2r2d1l3r2d3l4u4r1l1d2r1u2l1u1r1l1d2r4d3r2u1l1d1l1u2l1u2r2d1l3r2d3l4u2r1u2d1r4d1l1d2r2u1l1d1l1u2r1u1l3r2d3l4u4r1d1r3d3r4u2d1l3d1l1u2r1u1l1d2r4u2l1d1r1d1l2d1l1u2d2r2l1r2u5l1d3r1d1l2d1l1u1l1u3r2l2d3r4u4l1d3r1d1l1r1u7l1d1

;18
###########
#@        #
#  #$.# $ #
# # $$.#. #
# ..#. .$ #
#  #  $$$ #
# $$.$.#  #
# .#. .#$ #
# ..#$$.$ #
#         #
###########
Solution: undefined

;19
###########
#@        #
#  #$.# $ #
# # $$.#. #
# ..#. .$ #
# .# .$$$ #
# $$.$.#  #
# .#. .#$ #
# $.#$$.$ #
#         #
###########
Solution: undefined

;20
             ###
            #  #
           # . #
          # $ ##
         # .$.##
        # $    #
    ####. $.$. #
  ##   $  $@$##
 # $.$.$ #$. #
 #.    $.  ##
#  $.$*  ##
#.. $  $ #
#  $.$.$.#
##  . .$ #
 #.  . ##
  ### ##
     ##
Solution: undefined

;21
             ###
            #  #
           # . #
          # $ ##
         # .$.##
        # $    #
    ####. $.$. #
  ##   $  $@$##
 # $.$.$ #$. #
 #.    $.  ##
# $$.$*  ##
#...$. $ #
# $$.$.$.#
##  . .$ #
 #.  . ##
  ### ##
     ##
Solution: u4r1l1d2r2u2l2d1r1l1d3u2r2l2d2l2r2u2r2l2d2l2u2r1l1d2r2u2l2r2d2u2r2d1l1u1l3d2r2d1r1u1l3u2r2d1r1l1u1r1d3l1u1l2u1l1d1l2d2l2d4r1d1l2u1l1u1d1r2u2l2r2u2d2l2d1r1u1r2d2u2l1d1r2l2r2l2u3r2d1r2d2l4u1l2d1u1r3d1r3d1l1r1u3l2d1r1u1r1d1l6d1r1u1l1r2u2r1d1r1u3r3l3d2l2d2l1r1u4d2r2u2r2d2u2l2d3u3r2d2r2u1r2u3l1d2u2l2d1r1u1r2d2u2l1r1d2l1r1u2l3d1l1d3l1r1u2l2d2l2d2l2r2u4r2d2r2u1l1r1d1r2u2r2u2l1d1u1l2d1r1l1d1l1d1l1d1l5d1u1r1d1u1r4d2l1u1r1u1l2r2d2r1l1u2l3u2r1d2l1d1r1l3u2r1l1d2r2u1l1r4d1l2r2l1u1l1u2r2d2r3u2d2u3l2d2u1r2d2l2u1l1u1l2d2r1d1r1u1l2u2r1d2u2r2d1l1d2u3r2u2r3d2l3r1d2l2u2l1d4r1u1

;22
             ###
            #  #
           # . #
          # $ ##
         # .$.##
        # $    #
    ####. $.$. #
  ##   $  $@$##
 # $.$.$ #$. #
 #. $  $.   #
# $$.$*  ###
#...$. $.#
# $$.$.$.#
##  . .$ #
 #.  . ##
  ### ##
     ##
Solution: undefined

;23
##########
#     . .#
#  #$##$##
#@$..$ .##
# $#.$#. #
# $ .$ .$#
#.$$.$$ .#
#   $ ..##
###   ###
  #####
Solution: d4r2d1r2u1r2u5d5l2d1l2u1l2u6r6l6d6r2d1r2u1r2u2l1r1l1r1d2l2d1l2u1r1u2r2l1r1l2d2l3u6r6d4u1r1d1l4d2u2r2d1u1r1d1u1l3d1r1l1d2r1u1l1u4r2l2d2u1d2u3d4l3u6r6d2l3d2r1u1l1u1r2l2d4r1u2r2d1l2d1u2l1u2r1d1l1d1r2l1d2l4u1d1r4u3l1u2d1r1d4l4u6r4l4d6r3u3d3l3u4r1l1d2r2l2d2r3u2l1r1d2l1r1u2l1d1u1l2d1r1d1r1l1u2r2l2d2r1d1r1u2d1l2u1r1l2u3r1d2r1d1l1

;24
##########
#   .$. .#
# $#$## ##
# $..$ .##
# $#+$#. #
# $ .$ . #
#.$$.$$ *#
#   $ ..##
###   ###
  #####
Solution: d1r1l1u2d2r2d1u1l2d1r1d1r1u1r1u1d1u1d1l3r1d2l2u1l2u6r6l6d6r2d1r2u3l1u2r2l2d2r2l1d3l2u1r2u2l1u3d5l3u6r4l1d4u2r1d1l1d2r2u1l1d1l1d1l3u4r1l1r1u1l1u1r2l1d2r1l2d4r3u2d2l3u2r2l1u1l1u1r1l1d4r1u1r1u1l1u1l1d1

;25
##########
# . .$. .#
# $#$##$##
# $..$ .##
# $#+$#. #
# $ .$ . #
#.$$.$$ *#
#   $ ..##
###   ###
  #####
Solution: undefined

;26
  #########
  #       ##
###..$..###
#  $ $ ##
# .$.$##
#  $@ ###
##.$.$ .##
## $ $   #
### .$.  #
  ##  ####
   ####
Solution: u3r2l2d1l1r1d2l1u2d1l2u1d1r3u2r2d1l1u1l1d1l1d2r2u2l1u1r1d3l2u1l2u1r2d2r2u1l1u1d3r2l2d2r2u2l2u3l3d2r1d2r1l1u4r3d2l1d2u2d1l1r3d2l1u1r1l1r3d1l1u1l3u3l1u1l2d2r2d1r1u1d2r2u1l1

;27
  #########
  #      .##
###..$..###
#  $ $.##
# .$.$##
# $$@ ###
##.$.$ .##
## $ $$  #
### .$.  #
  ##  ####
   ####
Solution: d3u7d5l1r1u2l1u1r1l2r1l2r3u2d2u1d1r1u1l1u1r4l4d4r1u2l1u1r2l2d1l3d1r2u1r2d2l1u1l1u1r1d1r1u1l1u1r1d2l1d2l1u2l1u1r1d1r1u1l3d2r1u1r2d2l1u1r1u1d1l2r2d3l1u2r1u3l2d2r1l1u2r2d1l1d2r1u1d3u2d2r2u1l1u1d2l1u1l1u4r2d3r1l1d1r1d1l1u1r3d1l1

;28
  #########
  # $.$. .##
###..$..###
#  $ $.##
# .$.$##
# $$@ ###
##.$.$ .##
## $ $$  #
### .$.  #
  ##  ####
   ####
Solution: u3r2l1u1r3l2d1l3u1r3l2d4u3d6u6d1r1l1d2r1u2l1u1r1l1d2l1u1l2d1r2u1r2d2l1u1l1u1r1d1r1u2l1d4l1u1r1u2l2d1r1d2r1u3l3d2r1u1r2d2l1u1r1u1l1r2l1d4u1d1u2r2l2d2u2r2d1u1l2d2l1u2r1u3l3d2r1l1u2r3d3l1u1d1r3d1l1u1l2d2r1u1d2r1u1l2u3r2l2d2r1u1r2d1l1u1l1d1r1u3l1d1u2l1d1u1l2d2r2d2r2u1d1l2u1r1u1d1u1r1l1d2r1d2l1u2l1u2d2u2r2d1r1d1l1d1l2u2r1u1d1l1d2r1u1r3d1l2u1l2u2r2d1u1l2d2r2u1r1d1

;29
##############
#@     #     #
# .$.$.# $.$.#
# $.$.$# $$. #
# . $     .$.#
####### ######
#  .  .   $ .#
#.$.$. $ $.$ #
# $#$*.# .$. #
#.$.$.$# $.$ #
#      #    ##
##############
Solution: undefined

;30
##############
#.  $@ #.    #
#..$.$.#$$.$.#
#$$.$.$# $$. #
# . $     .$.#
#######$######
#  .  .   $ .#
#.$.$.  $$.$ #
# $#$*.# .$. #
#.$.$.$#.$.$ #
#      #    ##
##############
Solution: undefined

;31
    #########
    #    $ .#
  ###.*# $#####
  #@ .$ .$....#
### $*$$.$*$$.###
#*# $..*.$. $.#*#
#*# $. $.$. $.#*#
#*# $. $.$..*.#*#
#*# $*$$.$$$$ #*#
### $...      ###
  #############
  #  #**#**#  #
  # #### #### #
Solution: undefined

;32
#########
#       #
#  . .$.#
##.$$ #.#
 #  @$ .#
 #.$ $$.#
 # $  #.#
 #.$ $$.#
##    #.#
# .$$ $.#
#   ###.#
# .$  $.#
##  ##$ #
 #  ##  #
 ########
Solution: undefined

;33
#########
#       #
# ....$.#
##.$$ #.#
 #   $ .#
 #.$$$$.#
 # $@ #.#
 #.$$$$.#
##    #.#
# .$$ $.#
#   ###.#
# .$  $.#
##  ##$ #
 #  ##  #
 ########
Solution: undefined

;34
#########
#       #
# *...$.#
##.$$$#.#
 #     .#
 #.$$$$.#
 # $@ #.#
 #.$$$$.#
##    #.#
# .$$ $.#
#   ###.#
# .$  $.#
##  ##$ #
 #. ##  #
 ########
Solution: undefined

;35
######
#    #
#..  #
#..  #
#.#$ #
#.$@ ##
#.#$ ######
#.$  #    #
#.$ $ $ $ #
#.##   #  #
#.   #$ $ #
#.   #    #
#    #$ $##
#    #   #
##########
Solution: undefined


