;1
###########
#         #
# $$.$$.$ #
# $.$..$. #
# $..$$.$ #
# $.*+.$. #
# .$....$ #
# $.$$.$. #
# $$..$.$ #
#         #
###########
Solution: d1l1d1r1d2l4r8u1d1u8l2r2d8l4u4r2u2r2u2l1r1d4u2l2d4r2d2l1u1r1u2l2r2d3l2u2d2l2u1r1l1d1l4u2r3u1r1d1l4d2r4l4u2r4u2r2u2l1d1u1r3d6l8u3r2u3r1l1d4l2u6r2d3u3l2r8l3r3d2l4d2u1l2u3r2d3u2l2d2r1l1u1r1u2r2d1u1r3d3l1r1u3l1d1u1l7d1r2l2d2r2l2u1r1l1d3r1u1l1u1r1l1d5r1u2d2r1u1

;2
#############
#           #
# .$.$$$.$. #
# $.$.$.$$$ #
# $$.*.$... #
# ..$.*.$.$ #
# $$..$$*$. #
# ..$*+.$.$ #
# $$.$*.$$. #
# $.$..$..$ #
# .$.*..*.$ #
# $.$.$$.$. #
# $$.$..$.$ #
#           #
#############
Solution: d1l1,5-9d1,4-10l1,7-10r1,8-11r1,7-12r1,4-12u1,3-9r1,3-10r1,1-10r2,3-7d2,4-9d1l1,3-8r2,4-2l1,3-5u1,4-4u1,3-7u1,4-6u1l1,3-4u1,8-4u1,7-3l1,10-4u1,8-3r1,6-4r1,7-5l1,4-12u1,5-8r1,6-7u2,10-8u1,9-7l1d3,6-12l1,6-10d1,7-10d1,6-8r1d1,8-10l1,8-12u1,7-13u2,11-11l2,7-11u2,8-7l1,6-6d1,11-9l2,10-11u2,1-6r3,4-8u1,1-8r1,2-8r1,3-13u5,1-10r1u2,3-11u1,1-12r1u1,3-13u1,9-5l2d1,8-7l1d4,9-9l1,7-8d1,8-7d1,9-7d1,10-13u1,9-5d1,9-1d2,11-5l1,10-7d1,10-5d1,11-2l1d2,9-1d1,8-3r1,10-4u1,10-6u1,10-8u1,10-10u1,7-1d6,4-3r2,7-2d4,5-1d1,4-3r2,7-2d2,1-3r2,3-3r3,7-2l1,5-1d1,1-4r1,3-3d1,3-1d1

;3
#############
#           #
# $.$.$.$.$ #
# $.$.$.$.$ #
# .$.*.$.$. #
# $.$+$.$.$ #
# $..$.$.$. #
# $*.$.*.$. #
# ..$.*.$.$ #
# $$$*.$$.. #
# .$..$..$$ #
# $.$.$.$.. #
# .$.$.$$$$ #
# $.$$$..$. #
# $..$.$$.. #
#           #
#############
Solution: undefined

;4
#################
#               #
# $$.$.$$.$.$.$ #
# .$$.$.$$.$.$. #
# $$.$.$..$.$$$ #
# ..$..$.$.$.$. #
# $$$$$.$.$.$.$ #
# ..$..$..$..$. #
# $$.$$.+$.$$.$ #
# $.$.$$$.$..$. #
# .$.$....$.$.$ #
# $.$.$$.$.$.$. #
# ..$.$.$.$.$.$ #
# $$.$.*.$.$... #
# $.$...$.$$$.$ #
# $.$.$$.....$. #
# $..$..$$..$.$ #
# .$..$...$.$.$ #
# $.$$.$$$.$.$. #
#               #
#################
Solution: undefined

;5
###################
#@                #
#  $ $ $.$$$.$ $$ #
# $.$.$.$$..$.$   #
#  $$..$..$.$..$$ #
# $.$$$.$$.$.$$.. #
# .$...$..$.$..$$ #
# ..$$$.$$...$.$  #
# $$...$..$.$.$.$ #
# ..$.$.$..$...$. #
# .$.$.$.$...$..$ #
# $.$..$.$.$.$$$  #
# $..$$.$.$.$..$$ #
#  $$.$.$...$..$  #
## $.$.$.#.$.$$  ##
  # $.$.# #.$.$ #
  # $.$..#...$. #
  # .$..$$$.$.$ #
  # $.$$.$.$..$ #
  # .$..$.$.$$. #
  # $.$$.$.$..$ #
  #             #
  ###############
Solution: undefined

;6
###############################
#@        #         #         #
#  $.$$.$ # .*$.$.$ # .*$.$.* #
# $ $..$. # $..*.$* # $..$.$. #
# $.$.$.$ # .*$.$$. # $.$.$$$ #
# .$.$.$. # $..$.*. * .*...$. #
# $.$.$.$ # .$.*... #$*..$$.* #
# .$$.$.$ # $.*.$$. # .$$..*$ #
# $.$$$$. # *.$.$.$ # $$..$.$ #
#       $ #     $   #         #
#####*#### ####*#### ####*#####
#         # *     * #   $     #
# $$..$$$ #.$     $.# $...$.$ #
# ..$.$.. # .$ $ $. # .$$$.$* #
# $$.$.$$ #. .$.$. .# $..$..$ #
# ..$.$$. #*$$.$.$$*# ..*.$.$ #
# $..$$.$ #. .$.$. .# $*.$.$. #
# .$$..$. # .*.*.*. # ..$$$.. #
# $$.$$$$ # *. * .* # $$...$$ #
#      $  #.* .*. *.#         #
#####*#### ######### ####*#####
#         #         #     $   #
# $$$.$$. # $.$.$.$ # $.$$.$  #
# $...*.$$# .$$$.$. # $$..$.$ #
# .$$.$.$ # .$..$.*$# ..$$$$. #
# $....$. * ..$..$. * .$....$ #
# .*$$$*$ #$$.$..$. # ..*$.$$ #
# $.$.$.$ # .$*$$.$ # .$..$.* #
# .$.$.$. # $..$.$. # $$$$.$. #
#         #         #         #
###############################
Solution: undefined

;7
###############################
#         #         #        @#
# .$.$.$$ # $.$.$.$ # $.$.$$  #
# $.$.$.$ # $$..$.$ # .$.$. $ #
# .$$.$.$ # .$.$.$. # $$$.$$. #
# $.$.... $ $.$.$.. $ $..$..$ #
# .$$.$*$ # $.$$.$$ # $$$.$.$ #
# $.$$..$ #$$$.$$.$ # $..$.$. #
# .$$.$$. # $.$.$.$ #$.$$.$.$ #
#      $  #         #         #
#####$#########################
#   $     #.. .*. . #         #
# $.$...$ #**. * .$*# **.$.*. #
# .$..$$. # .*.$.$  # ..$.*.* #
# .$$$.$$ #. .$.$.$ # $*..*.$ #
# $$...$. #***.$.$  $ ..*$.*. #
# .$..$.$ #. .$.$.$ #$*$..$.* #
# $.$$.$. # .*.$.$  # .*.*$$. #
# .$..$.$ #**. * .$*# *....*$ #
#     $   #.. .*. . #         #
#####$###################$#####
#         #         #   $     #
# $....$$ # $.$.$.$ # *.*.**. #
# $$.$.$. # $.$..$. # $$.*..* #
# $.$.$.$ # .$.$.$.$# .$..$.$ #
# $.$.$.$ $ .$$.$$. $ ..*..$. #
# .$..$$.$# .$.$..$ # $.$.$.* #
# $.$.$.$ # $.$..$. # .*.$*$. #
# .$$$.$  # $..$$$$ # $$*.$.* #
#         #         #         #
###############################
Solution: undefined

;8
            #
           # #
          #   #
         #  $  #
        #  ..$  #
       #  $$$.$  #
      #  $.$.$.$  #
     #  $.$*.$.$.  #
    #  $.$...$..$$  #
   #  ..$..$$*.$.*$  #
  #  $.$.$$...$..$.$$ #
 #  $.$.$.$.$.$...$..  #
#@ $..$....$.$*$.$$$.$  #
 #  $.$.$*..$...$...$  #
  #  $*$.$.$*$$$.*$$  #
   #  ..$*.$...$.$.  #
    #  $.$$.$.$..$  #
     #  $..$...$$. #
      #  $$.$.$.  #
       #  .$..$  #
        #  $$$  #
         #  $  #
          #   #
           # #
            #
Solution: undefined

;9
 ###################
 #                 #
 # $ $ $ $ $ $ $ $ #
## ################################
#                                 #
# .$$..$$$.$.$.$..$.$.$..$.$$$.$. #
# $..$$...$.$.$.$$.$.$.$$.$...$.$ #
# .$$..$$$.$..$...$.$.$..$.$$$.$. #
# $..$$...$.$..$$.$.$.$$$.$...$.$ #
# $$..$.$$.$.$...$.$.$...$.$$$.$. #
# .$$..$.$.$..$..$.$..$$$.$...$.$ #
# ..$$.$.$.$$$.$.$.$.$...$.$$$.$. #
# .$$..$.....$..$.$.$.$$$.$..+.$. #
# $..$.$$.$.$.$$.$.$.$...$.$$$$.$ #
# $.$$.$.$$$.$.$..$.$.$$.$..$..$. #
#                                 #
###################################
Solution: undefined


