;1
   ####
   #  #
 ###  #
 #.#  #
 # # #####
##   #   #
#        #
#  # #####
#  # #
####$#
   #@#
   ###
Solution: u7,4-1d4l1d1r3,8-6l5,2-5d1,2-8u4

;2
#########
#       #
# .#.#. #
#  $$$  #
# .$@$. #
#  $$$  #
# .#.#. #
#       #
#########
Solution: d1u2d2l1r1u2l1d1l1u1r2l3d4r1u2l1u1r1u1r2d2l1r1u2l2d2r3l2,6-4d1,4-3r1,6-4u1l2d1r1l2

;3
#########
#       #
# $...$ #
# .$$$. #
# .$@$. #
# .$$$. #
# $...$ #
#       #
#########
Solution: u1l1r2l1d2l1r2,4-4l1,4-4r1,7-6l1,1-6r1,1-2r1,7-2l1

;4
  ######
###    #
# $...$##
# .$$$. #
# .$@$. #
# .$$$. #
##$...$ #
 #    ###
 ######
Solution: u1d1l1r2l1d1l1u2r2d2,7-3l2,6-1d1,3-1d2,1-2r1,3-3r1,5-4u1,1-5r2,2-7u1,3-5u1,4-3l1,5-7u2,7-6l1,5-5l1,3-4d1,5-3d1,4-5r1

;5
#########
#.. $ ..#
#.$@$  .#
#.$ $ $.#
#$$***$$#
#.$ $ $.#
#.  $ $.#
#.. $ ..#
#########
Solution: undefined

;6
   #####
  ##   ##
 ##  .  ##
##  * *  ##
#  * * *  #
##* * * *##
#  * * *  #
##  * *  ##
 ##  $  ##
  ## @ ##
   #####
Solution: undefined

;7
#########
#@      #
# $ $ $ #
# $$$$$ #
#   $   #
# $$$$$ #
#   $   #
#### ####
   # #
   #.#
 ###.###
 # ... #
 # ... #
 # ... #
 # ..  #
 # ..  #
 #######
Solution: 5-4l2,5-6l2,4-4d7,5-12l1,3-13u1,6-4d1l1,4-4d7,3-12r1,5-13u1,7-6l2,4-5d7,5-13l1,3-14u1,1-6r2,4-5d7,3-13r1,5-14u1,3-4d1,2-6r1,4-5d8,5-14l1,3-15u1,1-5r2,4-4d9,3-14r1,3-2d3,2-6r1,4-5d8,5-15u1l1,5-2l1d12,5-15l1,7-2l2,4-1d13,6-2d1l1,4-2d11,7-4l2,4-3d9,1-4r2,4-3d8,3-1d4,2-6r1,4-5d5,1-2r1d3,1-6r2,4-5d4,2-2r1,4-1d7

;8
###########
#    @    #
# $ $.$ $ #
#$$$$*$$$ #
#.* $.  *.#
#...#.#...#
#####.#####
#...#.#...#
#.* $.  *.#
#$$$$*$$$ #
# $ * * $ #
#         #
###########
Solution: undefined

;9
###########
#    @    #
# $$$$$$$ #
#         #
#* * * * *#
# * * * * #
#* * * * *#
# * * * * #
#* * * * *#
# * * * * #
# ....... #
#         #
###########
Solution: undefined

;10
###########
#    @    #
# $$$$$$$ #
#         #
#### * ####
  # * *#
  #* * ##
 ## * * ##
## * * * ##
# * * * * #
# ....... #
###       #
  #########
Solution: undefined

;11
###########
#    @    #
#$$$$$$$$$#
#         #
#  * * *  #
# * * * * #
#* * * * *#
# * * * * #
#  * * *  #
# * * * * #
#.........#
#         #
###########
Solution: undefined

;12
       ######
      ##....#
     ##....##
    ##....##
   ##  $.##
  ## $  ##
 ##    ##
 #  $ ##
#### #####
# $   $ @#
# $   $  #
# $$$$$$ #
#        #
##########
Solution: d3l4u2r1u1r1l1d1l2u1r1u2r1l2u1r1u1r1u1d1l1d2r1u1r1u1r1u1d1l1d1l3r1u1r1u1r1u1r1l1d1l1d2r1u1r1u1r1u1d1l1d1l2u1r1u1r1u1r1l1d1l1d2r1u1r1u1r1u1d1l1d1l2u1r1u1r1u1r2l2d1l1d2r1u1r1u1d1l2u1r2l1u1r1l1d2l2d2l2d6u1r2u1l1d1l1u3l1u1r1d1r1u1l1u1r1d1r1u1l1u1r1d1r1u1l1u1r1d1r1u1l1u1r1d1r1u1d1l3d3l2d6l3u3r2d1r1u3l1u1r1d1r1u1l1u1r1d1r1u1l1u1r1d1r1u1l1u1r1d1r1u2d1l2d1l1d3l1d5l1u2d2l2u3r2d1r1u3l1u1r1d1r1u1l1u1r1d1r1u1l1u1r1d1r1u1l1u1r1d1r1u1l1u1r1l1d1l1d2l2d7r4u3l3d1l1u3l1u1r1d1r1u1l1u1r1d1r1u1l1u1r1d1r1u1l1u1r1d1r1u1l1d1l1d1l2d7r1u2r1u1l1d1l1u3l1u1r1d1r1u1l1u1r1d1r1u1l1u1r1d1r1u2d1l2d3l1d3u1r4d1l3d1l1u4l1u1r1d1r1u1l1u1r1d1r1u1l1u1r1d1r1u1l1u1r2,1-10r2d1r1u4l1u1r1d1r1u1l1u1r1d1r1u1l1u1r1d1r1u1l1u1r1l1d1l1d3l1d5l2u2l1u1r2d1r1u3l1u1r1d1r1u1l1u1r1d1r1u1l1u1r2l1,6-12u2r1u1l2d1l1u3l1u1r1d1r1u1l1u1r1d1r1u1l1u1r1d1r1u1,8-11l3d1l1u5l1u1r1d1r1u1l1u1r1d1r1u2

;13
       ######
      ##....#
     ##....##
    ##....##
   ##  $ ##
  ## $  ##
 ##    ##
 #  $ ##
#### #####
# $   $ @#
# $   $  #
# $$$$$  #
#        #
##########
Solution: d3l4u2r1u1r1l1d1l2u1d1r3l3u1r1u2l1u1r1u1r1l1d2r1u1r1u1r1u1d1l1d1l2u1r1u1r1u1r1l1d1l1d2r1u1r1u1r1u1d1l1d1l2u1r1u1r1u1r1l1d1l1d2r1u1r1u1r1u1d1l1d1l2u1r1u1r1u1r2l2d1l1d2r1u1r1u1d1l2u1r2l1u1r1,6-9l1d1l1u3l1u1r1d1r1u1l1u1r1d1r1u1l1u1r1d1r1u1l1u1r1d1r1u1l1u1r1d1r1u1,1-9r2d1r1u3l1u1r1d1r1u1l1u1r1d1r1u1l1u1r1d1r1u1l1u1r1d1r1u2,8-9l3d1l1u3l1u1r1d1r1u1l1u1r1d1r1u1l1u1r1d1r1u1l1u1r1d1r1u1l1u1r1,3-12u2,2-9r1d1r1u3l1u1r1d1r1u1l1u1r1d1r1u1l1u1r1d1r1u1l1u1r1d1r1u1,8-10d1l1r1u1l3u1l2d2r1u4l1u1r1d1r1u1l1u1r1d1r1u1l1u1r1d1r1u1l1u1r2,1-10r2d1r1u4l1u1r1d1r1u1l1u1r1d1r1u1l1u1r1d1r1u2,2-12u2l1u1r2d1r1u3l1u1r1d1r1u1l1u1r1d1r1u1l1u1r1d1r1u1l1u1r1,5-12u2r1u1l1d1l1u3l1u1r1d1r1u1l1u1r1d1r1u1l1u1r1d1r1u1,6-12u2r1u1l2d1l1u3l1u1r1d1r1u1l1u1r1d1r1u2

;14
#########
#   *   #
# + * # #
#   *   #
#*******#
#   *   #
# # * $ #
#   *   #
#########
Solution: undefined

;15
  #####
  #   #
###$ $###
# $...$ #
#  .@.  #
# $...$ #
###$$ ###
  #   #
  #####
Solution: undefined

;16
 #########
##   .   ##
#  $ . $  #
# *#$.$#* #
#  $ . $  #
#..**+**..#
#  $ . $  #
# *#$*$#* #
#  $ . $  #
##   .   ##
 #########
Solution: undefined

;17
 #########
##       ##
#  * . *  #
# *#$.$#* #
#  $ . $  #
#.***+***.#
#  $ . $  #
# *#$*$#* #
#  * * *  #
##   .   ##
 #########
Solution: undefined

;18
    #####
  ###...###
 ##..*.*..##
 # .*.*.*. #
##.*.*.*.*.##
# * * * * * #
#  $ $ $ $  #
# $ $ $ $ $ #
## $ $ $ $ ##
 #  $ $ $  #
 ##   $   ##
  ### @ ###
    #####
Solution: undefined

;19
      #####
      #   #
  #####$  #
  #...* $ #
  #.#.#$  #
  #...* $ #
###*#*#$@ #
# $ $ $.$ #
#         #
###########
Solution: undefined

;20
       #####
    ####   ####
    #  #$$ #  #
##### $  $  $ #
#      #   #  #
# #$#$$#####$ #
# *......+..  #
###############
Solution: undefined

;21
   #########
   #       #
   # $     #
####$$$ $$$####
#             #
#$$$$$$*$$$$$$#
#.............#
#......@......#
#.............#
#$$$$$$*$$$$$$#
#             #
####$$$ $$$####
   #     $ #
   #       #
   #########
Solution: undefined

;22
        ######
        #    #
        # $  #
        #  $ #
##########$$ #
#      # # $ #
# #### ###  $#
# #  #     $ #
# # *#######.#######
#   *    @  .......#
####*$ #############
   # * #
   #   #
   #####
Solution: undefined

;23
###########
#    @    #
# $ $ $ $ #
#  $ $ $  #
# $ $ $ $ #
#####$#####
##... ...##
# ... ... #
#         #
#   ###   #
##### #####
Solution: undefined

;24
 #########
##       ##
#  #.#*#  #
# $.$.$.$ #
#  # # #  #
# $.$.$.$ #
#  #*#.#  #
##   @   ##
 #########
Solution: undefined

;25
####
#..##
#...#######
#...  # @ #
##..$   $ ##
 ## # ###  #
  # #  #   #
  #  $$#$$ #
  # $# #   #
  #  $ $ $##
  ##      #
   ########
Solution: undefined

;26
  ###
 ##.##
##...##
#..$..#
#..$..#
#.$#$.#
#  *  #
## $$##
#  $  #
# #$# #
#  $  #
## $ ##
#  $  #
# $#$ #
#  $  #
## @ ##
 #####
Solution: undefined

;27
               #######
               #     ##
########       #$ $   #
#  ... ######  # $ $  #
# $### .... ## #$ $ $ #
#  ...  ###  ### $ $  #
#@$###*....     $ $ $ #
#  ...  ###  ### $ $  #
# $### .... ## #$ $ $ #
#  ... ######  # $ $  #
########       #$ $  ##
               #    ##
               ######
Solution: undefined

;28
#########
#       #
# $.$.$ #
# .$.$. #
# $.@.$ #
# .$.$. #
# $.$.$ #
##      #
 ########
Solution: undefined

;29
########
#      ##
# $.$.$ #
# .$.$. #
# $.@.$ #
# .$.$. #
# $.$.$ #
##      #
 ########
Solution: undefined

;30
###########
#         #
# #$#$#$# #
# $ . . . #
# # #.#.# #
#@$$.$*$. #
# # #.#.# #
# $ . . . #
# #$#$#$# #
#         #
###########
Solution: undefined

;31
####
#  #######
#        #
#  ##### #
#*###### #
#  #   # #
## # $ # #
 # ### # #
 # # . # #
 # #   * #
 # # @ # #
 #   ### #
 ##### ###
Solution: undefined

;32
      ####
 ###### .#
 #  .$ $ #
 #.$ .$ .#
##$*$.$.$#
# $ @*$. #
#. $.$ $.#
###.  .###
  ######
Solution: undefined

;33
   ###########
   #  * * *  #
####   * *   ########
#    ** * ** #  # # #
#      * *      $   #
## # ** * ** # # # ##
 # #   * *   #      #
## #  * * *  ## # # #
#  ###########      #
#       +        # ##
####################
Solution: undefined

;34
#############
#   *   *   #
# $ * $ * $ #
#   *   *   #
#***********#
#   *   *   #
# . * + * . #
#   *   *   #
#############
Solution: undefined

;35
#####   #####
#   #   #   #
# $ #   # $ #
#   #   #   #
#***#####***#
#   * @ *   #
# . * # * . #
#   *   *   #
#############
Solution: undefined

;36
#############
# . $ . $ . #
# $ . $ . $ #
#@###*#*### #
# $ . $ . $ #
# . $ . $ . #
#############
Solution: undefined

;37
    #######
    #   $.#
#####.#####
#    $    #
# * * * * #
#  * * *  #
# * * * * #
#* * * * *#
# * * * * #
#  * * *  #
# * * * * #
#    $    #
#####.#####
#@    #
#######
Solution: undefined

;38
######
#    ##
# $ * ##
#  * . ##
# * . $ ##
## . $ * #
 ## $ +  #
  ## *  ##
   ##  ##
    ####
Solution: undefined

;39
######
#    ##
# $ * ##
#  * . ##
# * . $ ##
## . * * #
 ## $ @  #
  ## *  ##
   ##  ##
    ####
Solution: undefined

;40
############
#          #
# .*.*.*.$ #
# *$$$$$.$ #
# .$...$.* #
# *$.$.$.$ #
# .$.$+$.* #
# *$.$$$.$ #
# .$.....* #
# .$*$*$*$ #
#          #
############
Solution: undefined

;41
############
#          #
# .*.*.*.$ #
# *$$$$$.$ #
# .$...$.* #
# *$.$.$.$ #
# .$.*+$.* #
# *$.$$$.$ #
# .$.....* #
# *$*$*$*$ #
#          #
############
Solution: undefined

;42
############
#          #
# .*.*.*.$ #
# *$$$$$.$ #
# .$...$.* #
# *$.$.$.$ #
# .$.$+$.* #
# *$.$*$.$ #
# .$.....* #
# *$*$*$*$ #
#          #
############
Solution: undefined

;43
  #########
 ##   @   ##
## .$.$.$. ##
# .$$$.$$$. #
# ...$*$... #
# .$$$.$$$. #
## .$.$.$. ##
 ##       ##
  #########
Solution: undefined

;44
  #########
 ##   @   ##
## .$.*.$. ##
# .$$$.$$$. #
# *..$ $..* #
# .$$$.$$$. #
## .$.*.$. ##
 ##       ##
  #########
Solution: undefined

;45
###########
#.  $.$  .#
# *.$.$.* #
# . $.$ . #
#$$$$.$$$$#
#....@....#
#$$$$.$$$$#
# . $.$ . #
# *.$.$.* #
#.  $.$  .#
###########
Solution: undefined

;46
  #####
  # @ #
### # ###
# .$ $. #
# # # # #
# .$ $. #
### # ###
# .$ $. #
# # # # #
# .$ $. #
### # ###
# .$ $. #
# # # # #
# .$ $. #
### # ###
  #   #
  #####
Solution: undefined

;47
     ######
    ##    #
   ## $ $@###
   # $ $    #
  ##$ $ $ $ #
 ##. $   $  ##
##. . $ $ $  ##
#. . . $   $  #
##. . . $ $ $ #
 ##. . . $ $ ##
  ##. . . $ ##
   ##. . . ##
    ##. .###
     ##.##
      ###
Solution: undefined

;48
     #######
    ##     #
   ## $ $$@#
   # $ $  ###
  ##$   $   #
 ##. $ $ $  #
##. . $   $##
#. . . $ $ #
##. . . $ ##
 ##. . . ##
  ##. .###
   ##.##
    ###
Solution: undefined

;49
        ###
       ## ##
      ##   ##
     ## $   ##
    ## $ $$@ ##
   ## * *  $  ##
  ## * . * $   #
 ## . * * * $ ##
## . * * . $ ##
# . * * * * ##
## * * * * ##
 ## * * . ##
  ## * . ##
   ## . ##
    ## ##
     ###
Solution: undefined

;50
#############
#....*@*....#
## $  $  $ ##
 ## $$$$$ ##
  ##     ##
   ##   ##
    ## ##
     ###
Solution: undefined

;51
###########
#         #
# .  .  . #
# ....... #
# ....... #
#####*#####
#   $ $   #
#  $ $ $  #
# $ $ $ $ #
#  $ $ $  #
#   $ $   #
##### #####
#  $ $ $  #
#         #
#    @    #
###########
Solution: undefined

;52
###########
#         #
# .  .  . #
# ....... #
# ....... #
#####.#####
#   $ $   #
# $$ $ $$ #
#   $ $   #
# $$ $ $$ #
#   $ $   #
##### #####
#   $ $   #
#         #
#    @    #
###########
Solution: undefined

;53
##### #####
#   ###   #
#    .    #
# ....... #
##.......##
 ####*####
##  $.$  ##
#  $ $ $  #
#   $ $   #
#  $ $ $  #
##  $ $  ##
##### #####
#    $    #
#    $    #
##  $@$  ##
 ##  #  ##
  #######
Solution: undefined

;54
###########
#         #
# $.$*$*$ #
# .$.*.$. #
# $.$.$.$ #
##$ $.$ $##
 # $.+.$ #
 ## $.$ ##
 ## $.$ ##
 #...*...#
 #$$$*$$$#
 #...*...#
 #########
Solution: undefined

;55
  ####
  #  #
###$.###
# .  $ #
# $. . #
##* @*##
# . $$ #
# $  . #
###.$###
  #  #
  ####
Solution: undefined

;56
  ####
  #  #
###$.###
# .  $ #
# $  . #
##*$+*##
# .  $ #
# $  . #
###.$###
  #  #
  ####
Solution: undefined

;57
  #####
  #   #
###$.$###
# $...$ #
#   *   #
# $.*.$ #
### + ###
# $.*.$ #
#   *   #
# $...$ #
###$ $###
  #   #
  #####
Solution: undefined

;58
#########
#.      #
# $$*$#$#
# $.$ . #
# * ##* #
# $ ##. #
# *.*.* #
#      +#
#########
Solution: undefined

;59
      #####
      # $.#
  ##### $####
###  #  $.  #
#.. * * $.$ #
#+** #  $.$ #
#.. * * $.$ #
###  #  $.  #
  ##### $####
      # $.#
      #####
Solution: undefined

;60
########################
#@$.$.#     #.$   # $. ##
# $.$.#$$$.$# .$. # $.$ #
# $.$. .....  $.$   ....#
# $.$.## $$ #  $.$# $.$$#
#   $.#.  $ #    .#     #
### ##### ##### ##### ###
# $.$.# $.  #.   .#  $#.#
# $.$.#.$.$ # $$. # $$. #
# $.$.  $.$.  $.$$  $.$$#
# $.$.#.$.$ ##.$  # .$. #
#     # $.  #. $ .#.    #
#########################
Solution: undefined

;61
  ###        ###
 ## ##      ## ##
## $.##    ##.$ ##
# .$$.##  ##.$$. #
## .$$.####.$$. ##
 ## .$$.##.$$. ##
  ## .$$  $$. ##
   ## .$  $. ##
    ## ***+ ##
     #     ##
     ##$$$$#
      #    #
      #.***#
      #....#
      ######
Solution: undefined

;62
#########
#   @   #
# $$$$$ #
# $   $ #
# $   $ #
#### ####
# $ $ $ #
#.......#
# ..... #
###   ###
  # # #
###***###
#       #
#       #
#####  ##
    ####
Solution: undefined

;63
           ##### ######
##### ######   # #    #
#...###   ## # ###    #
#...  *   *   *   ***##
#..  #############    #
#    #           #    #
## ### ##### ####### ###
 #*  # #   # #   #  $  #
 #   ### # ### # # $ $ #
 #  *    *   **   $  $ #
 ##* # # ### # ### $$$##
  #  #   # #   # #    @#
  ######## ##### #######
Solution: undefined

;64
##### #####
#...###...#
#... # ...#
#$$$$$$$$$#
#         #
## $$$$$ ##
 ##     ##
  ##. .##
   ##@##
    ###
Solution: undefined

;65
###############
#.............#
#.............#
#$$$$$$$$$$$$$#
#             #
## $$$$$$$$$ ##
 ##         ##
  ## $$$$$ ##
   ##     ##
    ##   ##
     ##+##
      ###
Solution: undefined

;66
#######
#@    #######
# $$$$$.....#
# $ . $. $ .#
# $.#.#.$$$.#
# $ . $. $ .##
# $$$$##.... #
# ....##$$$$ #
##. $ .$ . $ #
 #.$$$.#.#.$ #
 #. $ .$ . $ #
 #.....$$$$$ #
 #######     #
       #######
Solution: undefined

;67
#######
#@    #######
# $$$$$.....#
# $ . $. $ .#
# $.#.$.$$$.#
# $ . $. $ .##
# $$$$*..... #
# .....*$$$$ #
##. $ .$ . $ #
 #.$$$.$.#.$ #
 #. $ .$ . $ #
 #.....$$$$$ #
 #######     #
       #######
Solution: undefined

;68
     #########
 #####      @#
 #.....$$$$$ #
 #.$ $.$. .$ #
 #. $ .$ . $ #
 #.$ $.$. .$ #
 #....##$$$$##
##$$$$##....#
# $. .$.$ $.#
# $ . $. $ .#
# $. .$.$ $.#
# $$$$$.....#
#       #####
#########
Solution: undefined

;69
     #########
 #####      @#
 #.....$$$$$ #
 #.$ $.$. .$ #
 #. $#.# # $ #
 #.$ $.$. .$ #
 #....##$$$$##
##$$$$##....#
# $. .$.$ $.#
# $ # #.#$ .#
# $. .$.$ $.#
# $$$$$.....#
#       #####
#########
Solution: undefined

;70
###########
#         #
#         #
# $$$$$$$ #
##       ##
 ## $$$ ##
  ##   ##
  ###@###
  #.....#
  #.....#
  ##   ##
   #   #
   #####
Solution: undefined

;71
################################
#  . $. $. *. $.#   $...$  $   #
#@$  $  $ .$  $    $ ... $  $  #
# $. *. $. $. *.# $  ...  $  $ #
################################
Solution: undefined

;72
#############
#           #
# #$####..# #
# #.$  $.+. #
# #. $  *.. #
# #$  $. $# #
# #.$  $  # #
# #. $  $ # #
# #$  $  $# #
# . $..$..$ #
# $.####### #
#           #
#############
Solution: undefined

;73
#############
#           #
# #$####.## #
# #.$  $.+# #
# #. $  *.*$#
# #$  $. $#.#
# #.$  $  #.#
# #. $  $ #.#
# #$  $  $#.#
# . $..$..$ #
# $.####### #
#           #
#############
Solution: undefined

;74
#############
#           #
# #$####.*# #
# #.$  $.+* #
# #. $  *.*$#
# #$  $. $#.#
# #.$  $  #.#
# #. $  $ #.#
# #$  $  $#.#
# . $..$..$ #
# $.####### #
#           #
#############
Solution: undefined

;75
    ##########
  ###..$ $   #
###.....$ $  #
#+.....# $ $ #
#......#$ $  #
#....### $ $##
#..###  $ $ #
#### $ $ $ $#
# $ $ $ $ $ #
#  $ $ $ $  #
##          #
 ############
Solution: undefined

;76
#########
#       #
# $$$$$ #
#  # #  #
# $ $ $ #
#  # #  #
# $$$$$ #
#       #
####@####
#.......#
#  ...  #
#   .   #
####.####
   #.#
   ###
Solution: undefined

;77
#######   #######
#.    #   #    .#
# $ $ #   #   $ #
#  $$$#   #$$$$ #
# $ $ #####   $ #
#. $ ...+...$ $.#
#####.#####.#####
    #.#   #.#
    #.#   #.#
    #.#   #.#
#####.#####.#####
#.$  ...*... $ .#
# $ $$#####  $  #
#  $  #   #$$$$ #
# $ $$#   #  $  #
#.    #   #    .#
#######   #######
Solution: undefined

;78
###################
#  * . #  .$  *.  ##
#$   # *     #   $ #
# . $   $*#. $. #  #
#  .# # # .  # $  .#
# $ # .* *  ###$####
#* * $  #  * .  .#
# # # $ .#@ $ #$####
#.  .  $  #   . * .#
# $ * $ # . $#  $ ##
##   #.$ .*  # $* ##
#  #    #  $.   . .#
# $ $ .# $#   $ ####
####  ##    .  ##
   #############
Solution: undefined

;79
 ##################
##.$. .#. .$. $ . ##
#.$ $# * * . *$  * #
#   $  $$$# *$  #$.#
#. .#.$ #.$. # *   #
# * * .$ $. # #$.#.#
#*$$$* .#$ $$. . $$#
# * # $ .$+ * #$$#.#
#. . . * $#.$.$. . #
# . * $ # .$  . $ .#
##$.$#$$$. .$# *$$##
#  #.   # $$$     .#
#.$ $. * *#.$.$$#* #
##.$. .#. . .$. . ##
 ##################
Solution: undefined

;80
 ##################
##.$. .#. .$. $ . ##
#.$ $# * * . *$  * #
#   $  $$$# *$  #$.#
#. .#.$ #.$. # *   #
# * * .$ $. # #$.#.#
#*$$$* .#$ $$. . $$#
# * # $ .$+ * #$$#.#
#. . . * *#.$.$. . #
# . * $ # .$  . $ .#
##$.$#$$$. .$# *$$##
#  #.$  # $$$     .#
#.$ $. * *#.$.$$#* #
##.$. .#. . .$. . ##
 ##################
Solution: undefined

;81
 ##################
##.$. .#  .$. $ . ##
#.$ $# * * . *$. * #
# . $  $$$# *$  #$.#
#.$.#.$ #.$. # *   #
# * * .$ $. # #$.#.#
#*$$$* .#$ $$. . $$#
# * # $ .$+ * #$$#.#
#. . . * *#.$.$. . #
# . * $ # .$  . $ .#
##$*$#*$$. .$# *$###
#  #.$  # $$$     .#
#.$ $. * *#.$.$$#* #
##.$  .#. . .$. . ##
 ##################
Solution: undefined

;82
      #######
      #     #
####### # # #
#. . .$$ $ $##
# # #$# #.#  #
#**.*..$.**$@#
# #$# # #.#  #
#. . .$$ $ $##
####### # # #
      #     #
      #######
Solution: undefined

;83
 #########
##       ##
#  $ $ $  #
# $@$ $ $ #
#  $ ######
# $ $#
#  $ #
# $ $######
#  $     .#
# #$##### #
# #.....$ #
# #.###.# #
# #.# #.# #
# #.###.# #
# $.....# #
# #####$# #
#.        #
###########
Solution: undefined

;84
###############
#      @      #
# $ $ $ $ $ $ #
## $.$.$.$.$ ##
 #  $.$.$.$  #
 #   $.$.$   #
 #####$.$#####
    ##.$.##
   ##.$.$.##
  ##.$.$.$.##
 ##.$.$.$.$.##
 #. . . . . .#
 #############
Solution: undefined

;85
 ############
##          ##
# +$*.$*.$*. #
# *    *   $ #
##$ ###### *##
 #. #    # .#
##* ###### $##
# $   *    * #
# .*$.*$.*$. #
##          ##
 ############
Solution: undefined

;86
#############
#           #
#$ $ $.$ $ $#
# $.$.$.$.$ #
# #$.$.$.$# #
# #.$.$.$.# #
# # .$+$. # #
#. . .$. . .#
#############
Solution: undefined

;87
####
#  ######
#  $ $  #
# .*.#. #
#  $@$  #
# .#.*. #
#  $ $  #
######  #
     ####
Solution: undefined

;88
    #####
    #   #
    # $ #
#####   #####
#   ## ##   #
#  $     $  #
# $### ###$ #
## ###.### ##
##  # . ## #
#   ..+..  #
#   # . ## #
## ###.### ##
# $##   ##$ #
#  $  #  $  #
#   #####   #
#####   #####
Solution: undefined

;89
#########
#    .$ #
#$$$$.$ #
#...+.$ #
# $.#.$ #
# $.....#
# $.$$$$#
# $.    #
#########
Solution: undefined

;90
###########
#         #
# *.* *.* #
# $*$ $*$ #
# *.* *.* #
#    #    #
# *.* *.* #
# $*$ $*$ ##
# *.* *.*  #
#        @ #
############
Solution: undefined


