;1
      #####
      #   ####
      # .$   #
   ##### ##  #
   #   #$ # ##
   # .$ . # #
 #### ##  # #
 #  #$ #### #
 #   . #    #
## ##  #    #
#  #####    #
#         # #
#########  @#
        #####
Solution: u10l2u1l2d1r1d2r1d2l1u1l2u1l2d1r1d2r1d1l3u1l1d3l1d1r7u3r3d4l2u3l1u1r1d1r2u7l2u1l2d1r1d2r1d2l1u1l2u1l1d3r1d1l3u1l1d3l1d1r7u1r3d2l2u2l1u1r1d1r2u8l2u1l2d1r1d2r1d1l3u1l1d3r1d1l3u1l1d3l1d1r7u1,10-2l1u1l1d3r1d1l3u1l1d3,9-12u1l1u1r2l1d2r2u9r1u1l3u1l1d3r1d1l3u1l1,9-9r1d1r1u7r1u1l3u1l1d3,9-8r1d1r1u6r1u1l3

;2
##################
#         ##.    #
# ####### $ $..  #
# #     # $  .$. #
# ############$  #
# ##     ### #  ##
# ## $...$ #### #
# ## $   $      #
# ## $...$ ######
# ####    ##
# #*#######
# .#.$    #
#  ...  $ #
## $  $$@##
 #   ##  #
 #########
Solution: 7-14u1l1,6-11l1,4-13l1,2-14u2,6-13l2,3-14u1,8-11d1l3,8-14u1,9-12l3,9-3r2,11-2r2,10-8l1,10-6l2,9-8u1,10-6l1,4-8r2,4-6r1d1,4-8r1,13-3r1u1,15-1l2,14-5u2,11-3r1,9-2r3

;3
         ####
         #  ######
########## $##   #
#              $ ##
# #### ####$$# #  #
# $   ...  ....$$ #
#### #  .......$  #
   # ## # # ###  ##
   # ##$# # # #$##
  ##    # #$### #
  # $#### #  ## #
  #       #   $ #
  #####   #  ## #
      ###$##### #
        #@      #
        #########
Solution: u1d1r3l1r4,15-11l3u1l1u4,12-5l3,7-9u2,6-6r3,1-5r5,4-11u5,2-5r3,11-6l2,16-6l1,13-5r1,11-12u6,10-5r1,11-3d2,12-6l1,9-13u2,13-5l1,11-3d1,11-4d1,11-1d3,12-3d2,15-6l1,16-6u1l3,15-9u3,16-5l2,16-3l1,14-2d3,16-3d1,17-5l2,9-11u4

;4
#######     #######
#     #  ####     #
# $ $ ## #.   $ # #
#    $ # #. $$# # #
# $ $  # #$##@# # #
#  $ $ ### ##$# # #
# $# ###.# ## # # #
#    ###......  # #
# $ $ $ ......# # #
# ## $  ......# # #
#    ###..$ $ $ $ #
# $ $ $ ...# ##   #
# ### ##. ## ## # #
# ### ##$$      $ #
#           #######
#############
Solution: d3l3r5d6l5d1l2u7d7r2u1l1d1l1u6d5r1u2r1u1l1u3r1u1d1r1d3l1u2r1u1l1u4r1u1r2l2d1l1d5r2d1r1d1l3d1l1u2r3d4r3u3l2r2d3l3u3l1r2u1l2d1l3u2r3l2d1r1d1r1u1l2d2u1r6d2u1r2d2l8d1l1u1d1r1u4r6d1r2u1l8u2r1u1r3d2u2r2d3l5,13-2d6,15-2l1u1l1d6,11-3r1u1r1d4,4-9r5,10-10u6,11-9u1,12-9u1,8-11u1,7-9r4,9-11u1,8-9r2,8-13u3,7-9r2,5-11r2,8-12u2,7-9r1,3-11r4,8-12u2,1-11r6,8-10d1,10-10u2,5-8r6,3-8r7,8-8d2,7-11r2,8-9r1,1-8r2,4-7d3,3-11r5,9-10d2,8-13r4,8-13u2,10-8d1,11-10l1,9-9d1,8-11u1,7-9r2,2-5d2l1d1r2,4-7d3,3-11r4,8-12u2,7-9r1u1r1d1,2-3d4l1d1r2u1r1d3l1d1r4,8-12u2,7-9r1,2-1d6,1-8r2,4-7d3,3-11r4,8-12u2,5-2l2u1l1d5l1d2u2r1d1l1d1r2u1r1d3l1d1r4,8-12u1,4-3d7,3-11r4,14-13l5,8-14u1,6-5l1u1l1d3l1d1r6l5u4l2d1r1u1r1d3l1d1r5l4u6r1d2r1d1l1u1l1d3l1d1r4

;5
   #####
   #   #############
####$            $ #
#  $..........$ ## #
#   $#  .##  #  ## #
# ##..... # $# ### #
# #####$. $   $    #
# #  #  .## $  ### #
# #  # $. $  ##### #
# #  ## . $ $  $ $ #
# ##  ##$    ### ###
#  #   # $    $@$  #
## #   ##   ###### #
 # ############### #
 #                 #
 ###################
Solution: l4,10-3l7d1l2u1r8,4-5u1,3-3r3,7-7u1,8-5l3,7-9u3,8-5l2,9-12u1l1u5,9-5l2,10-10l1d1l1u5,9-5l1,10-12u1,17-11l7,11-9l2d1l1u5,11-8l2,8-9u3,11-6l2,9-12u3,10-8l1d1l1u1,11-10l2d1l1u2,12-8d2,13-11l3d1l1u2r1u1l1,16-9l5,8-3l1,11-3l3,12-6u2,13-3l4,12-8u4,13-3l3,9-9r1d1r1u6,12-3l1,15-3l3,14-7u3,18-2l12u1l1d1u1l1d1,18-9l5,12-10u6,15-3l1

;6
#############
#           #
#           #
# $ $ $ $ $ #
## $ $ $ $ ##
 ## $ $ $ ##
  ## $ $ ##
   ## $ ##
    ##@##
   ## $ ##
  ##     ##
 ##   .   ##
##   ...   ##
#   .....   #
#  .......  #
#############
Solution: d5r1d1l3,6-8u1l1u1d1u1l1u1l1u1l1u1l1r1d1r1u1l2u2r4d2l1u2l3d2r1d1r1d1r1u2d3r1l1u3r1u1r2d1l1d1l1d1u1r1u3r3d2l1d1l1d1l1d8r2d1l3,6-3d10r1d1l1,4-6r1,6-5d7l1d1r2u1r1d1l1d1r1,8-3l1u1l1d10l1d1r2u1r1d1,5-4r1d2l2u1r1u1r1d7l2d1r2u1r1d2,3-4r2d1r2u2l1d10,4-3r1u1r1d10r1d1l2r1u6l1u6l1d3l1d1r2u1r1d8l1d1r2u2l1u6l3u1l1u1r3u1r1d9l1r1u1l1d2r1u1r1d1,3-1d1u1l2d1r4u1r1d10r1d1l1u1l1d1,2-3r3u1r1d9r1d1l1,11-3l4u1l1d8l1d1r1u1r1d1,10-4l3u1l1d9,9-5l2u1l1d7,8-6l1u1l1d5

;7
        ########
####### #      #
#..$..# # #$$  #
#..#..# # ...# #
# $$$ # ##...$ ##
#  $  #  # ## $ #
# $$$ ####$  $  #
#  #  #..#  #   #
# ##### .###### #
# ####  $.# ### #
#   ## $  ###   #
### #  #$$ ## ###
  #     @     #
  #############
Solution: l2u2r2u2d2l2d2r2u2d2r2u1l1d1l3u2r2u1r1d1l3d2r2u2r1u1l1d1l1u2d2r1d2r1u2d2r4u2r2u4l1d1l1u1r1u3d1l2u1l3u2r3l1r3d4u3l1u1l4d2u2r2d1u1r3d3u3l5d2r2u2r2d1l1u1l1d1r3d3r1d2l2u2r1u1l1d2l2d1l1u3d2r3u1r2d1l4d1l1u2d1r5d4l2d2l10u2l2u5r1l1r1u1l1u2r3d1r1d2l1u2d1l2d1l1u2d1r1u1d1l1d2u2r4d3l1u2r1u1l3d1l1u1d3r1u3d1r2d1r1u2l3d2r1u1r2d2l1u3

;8
       #######
       #   ..#
      ##$# ..#
  #####   #..#
  #   #   $ ##
###   ##$    #
#... #@$   $ #
#### #$# ##$ #
 #   $   #   #
 #   #$#######
 ###   #
   #####
Solution: r2u1r1u1d1r1l2d3l4d1l2u1r1d1r1u3l1u2r2d1l1u1l1d1r1d1l2r2d2r4u2l2d1u1r2d2l3r1l2d1l2u1r1d1r1u3l1u2r2d1l1u1l1d1r1d1l1r1d4r2u2r2u2l2d1u1r2d2l3r1d2l2u4l1u2r2d1l1u1l1d1,8-6u1r1u2l2d1u1r2d1r1d1r1u2r1u2d2l1d1l2u1l2d1r2d1r2u2r1u2l4d2u2r2d1r1u1r1d1l1d3l2u1r1d1r1u2d1l2u1l1u2r2d1r1d2l2u1l2d1r3d1r1u3l1u1r1d4l1r2l2d1l2r1u1r3d1l1r1d2l1u6d3l2d1r1u1r2d2l1u4d1,6-6r4u1r2d2l1u3

;9
     ####
######  #
#    $$ #
# #$  $ #
# #  #$ ######
#   #   ##...#
###$ # ###...#
###   $   ...##
#   $ $ ###   #
# # ##### # # #
#   #     #  @#
#####     #####
Solution: u2l2u1l6d1l2u1r7u1r2d2l1u2r1u1l1d2l8d3l2u2r2u1r3u2r1u2l1r1u1d2u1l1d3u3r1u2l1d1l3r1d2l1d3r7u1r2d2l1u2d1l8r3u3r1u2l1d4u4l2d2l1d3r8d1r1u2d1l9u3r1u1r1u1r1d4u3l2d1l1d3r7u1r1d2u1l8u2l2u3r4d1r2u2l1d5u3l2d1l1d3r7u1r2d2l1u1r1u1l1d2r2d2l2u3l8u4d2l2u3r4d1r2u2l1d5u3l3d4r8d1r1u1l9d1l2d2r2u7d2l2u3r4d1r2u2l1d5u3l3d4r8l6d1l1u1l1d1l2d2r2u7d2l2u3r4d1r2u2l1d5u3l3d4r7l3d1l3u1l1d1l2d2r2u7d2l2u3r4d1r2u2l1d5u3l3d4r6

;10
          #######
       #### @#  #
     ### $  $   #
   ### $  $#    #
  ##   $$..$.$  ##
  #  $...#.#.##  #
  #$  .#...... $ ##
###  $ $  $##.$ $ #
#  .#   $ $... $  #
# ###. $ # ..#   ##
# # #.$ .. $..$ ##
# # # # $   #$  #
# ###$$   $   ###
#     ##    ###
#############
Solution: l1d1r2l1d4l2u2l1u1l1u1r3l2d2r1d2l1d2r2l1d3r1u2l1u1l1u2r4d2r1d1r1d1l5u2l1u1l1r1d1u1l2d1l1u2l2d1l1d1l2d5r4u3d3l4u3d3r4u1r3l3d1l4u5r2u1r1u2l1d2u1r3d3r1d1l1r1u3r2d1l1u1l2d3r2u1l1d3r1u1r3d1r2u1r1u1l1r2u1r1u1l2r1u1l1r1l1u1r1d2r2u1l2u1l1d3r1d1l1d1l1r1u5r1u1r1d1l1d5l2d1l2d1l1u1d1l2u2r2d1r1u2l1u1r1d4l3u1r2d1r1u3l1u2l1u2r1d2u4l1u2d1l1d2u1r2d3l4u1l2u2r1d1u1r3u2r2d4l1d1l2r2u1r1u3l2d1l2u1r2u1r2d1l1u1l1r1d1l1r2u1r1u1r1d1r1d1r1d1r1d2l3u2l1r1d2l3d2r1u2d1l3r1u1d1l3u1l1u2r4d1u1l2u1r2u1r2d1l1u1l1d2l3d1r1l2d1r1d1r1u1l3d1r2d1r1u1d1u1r3l3d3r1d1r3u4l1u1r1l1d1l3d2r2u1d1l2u2r3d1r1u1l4d1r1d1r1u1l1u1r1d1r1u1d1r1d4r3u1r2u3r2u1l2d1l1u1r1u1l1r1u3l2u1l1d3u2r2d1l1u1l1d1r3u3l1d2r1d1l2

;11
          #####
###########   #
#       $   # #
# ###$### # # #
#      $  # # #
# # ##### # $ #
# # #...# # # #
# #$#...# #$# #
# # #...$ # #$#
# $ #.... $ # #
# # ####$## # ##
# #  $         #
# # #####$#### #
#@             #
################
Solution: r13u2l3u2l5r3u1l2d1l1u2r1u1l1r1d2r2d1r2d2l3u2r1u1l2d1l1u2d1r3u6r2d4u4l2d6l1d3r6d2l13u9r1l1d9r13u2l3u2l2u7r2d7l3d2r6d2l13u11d2r7l7u2r8d2l8d9r13u2l6u2r3u7l2d6u6r2d7l2u5l8d9r13u2l6u2r1u1l2d1l1u1r1u1l1r1d2r1d2r6d2l13u11r4d1u1l4d2r7l7d9r13u2l6u3r1d1r2u7l2d6u6r2d7l2u5l8d9r13u2l6u2r1u1l2d1l1u1r3d1l1d2r6d2l11u8d8l2u10d1r7l7d9r13u2l6u2r3u7l2d6u6r2d7l2u5l8d9r13u2l6u2r1u1l1d1l1u2d2r1d2r6d2u2l10r10d2l11u8d8l2u9r7l5d7r5u2r3u7l2d6u6r2d7l2u5l8d9r13u2l6u2r1u1l1d1l1u1d1r1d2u2r3d1u1l3d2l5d2r11u2l10r10d2l11u8d8l2u10d1r7l5d7r8u9l2d6u6r2d7l2r2d2l3u2r1u1l3r2d3r6d2l5u1d1r5u2l10r5d2l6u8d8l2u9r7l5d7r8u9l2d6u6r2d7l2r2d2l3u2r1u1l2r2d1r2u8r2d4l1r1u4l2d9u1l3d2r1d2r5u2l10r5d2l6u8d8l2u9r7l5d7r8u9l2d6u6r2d7l2r2d2l3u2r1u1l1r1d1r2u4r2d5u5l2d6l2d2r5u2l10r5d2l6u8d8l2u9r7l5d7r8u9l2d6u6r2d7l2r2d2l3r3u2l4r1d2l5d2l2u4r1l1d4r2u8d5u1l2u5r7l5d7r8u9l2d6u6r2d7l3r1u5l4u2r5l1d7r2u4r2u4l2d9u6d1r2d6l9r5d2l6u8d4l2u5r7l3u2r4d6u6r2d7l2

;12
        #########
      ###       #
     ##    $ $ $#
    ##  ## #$## #
  ###  ### .. ..##
  #   ## ##.. .. #
### ####### ##$# ##
#    #    #$ $ $  #
# $ $$$$$ #      @#
#         #########
##### #############
   #.             #
   #.  ###   #$#$ #
   #...# # $$  .$.#
   #.  # #  ###...#
   ##### #### #####
Solution: undefined

;13
   ######
####    #######
#    $$ ##    #
# $ $  ##  ## ##
#  ## $#@ #... ##
#####  $  ..#.  ###
   #   #  .#..    #
   #   ## ...# #  #
   ####### ##  # ##
####  ####    ## #
#    $$  ####### #
# #   $     $    #
# $$     ######  #
# # ######    ####
#   #
#####
Solution: undefined

;14
################
# $.......     #
#  . . .#.$ ##$##
# $.#. .#.###   ##
# $.......# #$   #
###   ##  ##     #
### # ##### $ $$##
#   # ##         #
#   # ## $ $   $ #
## ## ###  ### $ #
 # ## #######   ##
 #        $@$ $ #
 #  #  #######  ##
 ####$ $ $ $ $$  #
    #            #
    ##############
Solution: undefined

;15
  #####
  #   #
###$.$#####
#   . $   #######
# ##$##         #
#   . ######### #
### . #       # #
  #   #   ##### #
  #####   #  ## ##
         ##$ ##  #
         #  $@$  #
         #   ##$ #
         ###.## ###
          #...$ $ #
          ##..    #
           ########
Solution: undefined

;16
            #####
   ####     #   #
 ###  ####  # #$##
 #       ####    #
 #$#$$#$ #  # ## #
## #  #  # $$    #
#  ##  # #  #$#####
#        ##   #   #
##$### #### ### $ #
 # ### ##....## ###
 #       ....##   #
 ### ####....     #
   # ######### #####
   #       @   $ $ #
   ###########     #
             #######
Solution: 2-3d2,2-7u1,2-4d2,1-7r3,2-9u2,4-7r1,6-6d2,6-8d1,5-10r2,7-10r3,11-9d1,10-11r5,11-4d5,12-10l3,9-10l3,13-7u2l1,11-4d5,12-10l1,11-10l2,13-3d1,14-5l2,11-4d5,12-10l1,10-11u1,15-1d1,16-3l2,13-2d2,14-5l1,13-5l1,11-4d4,11-8d1,12-10l2,9-11u1l1,6-10r2,8-10r3,12-11u1,4-10r6,11-11u1,17-11l3,14-11l4,17-8l1,15-7d3,16-11l5,16-13l1,14-14u2,13-11r2,17-11l5,18-13l3,14-14u2,13-11r2,17-11l4,5-3d1,5-4d2,4-7r1,6-6d3,5-10r3,8-10r3,2-5d1,1-7r2,3-7r1,4-7r1,6-6d3,5-10r5,4-5u1,3-3r1,5-2d4,4-7r1,6-6d3,5-10r4,7-5u1,8-3l2,5-2d4,4-7r1,6-6d3,5-10r3

;17
             ####
        ######  #
   ######       #
   #   ##  ###  #
####$# ### $ #$##
#   $@$  #   # .#
#   $#$#   $ # .#
##   # # #   # .#
 #  #  # #$$ # .#
 ##$#  # # ### .#
  # #... # #  $.#
  #  ...##   #  #
  ###############
Solution: undefined

;18
######    #########
#    ##   #   #.  #
#     #   #..  $  #
#$$$$$#   # #$##$ #
#     #   # $ #   #
#     # ####  #$. #
#$$$$$# #@### .  ##
#.....### ##### ##
#.....          #
######### #######
  #####    ######
  #   #$$$$$ #  #
  #  $........$ #
  ####   $#  #  #
     ##   #    ##
      ##########
Solution: undefined

;19
#########  #########
#       #  # . $   #
# $.$.$ #  # $.$ $ #
# .$.$. ####.......#
# $.#.$   ##$$$$.$$#
# .$.$. # ##   $ . #
# $.$.$ # #### #####
#       #     @ ####
######### $$ ##    #
     ###...$ # .$$ #
     # $...###.$$.##
     # $$ ## #.   .#
     #    #  ##.$$.#
     ######  # $$. #
             #    ##
             ######
Solution: undefined

;20
 ####  ######
 #  ####    #
##.$  .$..$ #
# $ . $ $.# #
# . $ ###   #
######   #@##
# . . . $.. #
# $ #$$ # $ #
##. $ . #$# #
 #  #####   #
 ####   #####
Solution: undefined

;21
     ####
     #  ###
     #    #
     # #  ####
     # $ ##  #
     # #   $ #
    ## #  ## #####
    #  ## #  #   #
    #     #@ # # #
    ####  #  #   ###
 ########### ### $ #
 #   ##    ..### # #
##$# # $  #..      #
#     $  ##..#######
#   ##  ######
#########
Solution: r1d3l3d1l1d1l5r3u1r1d1r1u1l1u1r4d1r1u3l1u2r1d5r6u2l1r1d2l2u3d3l5u1l4d1l1d1l3d1l2u1r5d1r1u1l1u1r1u1r5u6l3,8-4l1,6-3d4,5-8r3,9-9u3l1u1r3u1r1d7,11-12r5,18-12l6,11-11d1,8-5u2r1u1l2u1l1d6l1d1r3d1r1u3l1u1r3u1r1d3,16-7d4,17-12l5,12-7d4,8-13u1l1u1r4,2-11d1,1-13r5d1r1u1l1u1r1d1r1u1l1u1r3

;22
 ########
##      #######
#  $   $ #.  .#
# $ $   $ .  .#
## $ $ $ #....#
 ####### ## ###
  #           #
 ## ######### #
##     $@#    #
#  $$$$###$## #
#        ...# #
#########...  #
        #######
Solution: l2d1u1l2d1u1r2d1u1l2d1l1r1u1r2d1u1l2d1r1d1r4d1r4u5l10,3-10r1,1-9r1u1r1,6-10l2,2-9r1,4-10l1,11-10l5,10-8d2l1d1r2,4-10r5,10-9d1,11-11l1,1-10r8,10-9d1,13-11l1,6-8d1,5-10r5,5-8l1,3-7d2,2-10r7,4-8d1,3-10r5,9-3l1u1l2d1r3,10-2r1l1d1,6-4r1,8-5u1,7-3r5,13-2d1,4-2r2u1r1d1,7-4u1r1u1l1d1l2u1r1u1l4d1r3l2d1u2r4d1u1l2d1r1l3r2l2d1r1u1r2d2r2u2l2d2r2u1l1d1u3l3d3r3,8-5u1,7-3r3,11-4r1u2l2d1r1u1d2r1u1l1u1r1,1-3r1d1r5,8-5u1,7-3r3u1r2d2l1u1r1u1l1,6-2l1,6-4u1,4-3r6,11-2d1,6-1d1l1d1r6u1r1d1,2-3r10,4-1d1l1d1r6

;23
##### ##############
#   ###..... ...#@ #
# $ # $... .....#$ #
#   # $.....#...#  #
# $## $# ########$ #
#  ##  # # $     $ #
#        # $ #### ##
#  ####  #         #
##     ########$$$ #
#   #  #      # #  #
#  ## ## $$ $ # #$ #
# $ $ ####  $ # #  #
#  #  ####$ ##   $ #
# $##        $   ###
#   #  ###########
########
Solution: 18-5l1,15-7d5,14-13l7,7-13l1,5-14u5,6-8l3,2-9u2,1-6r6,8-7u4,7-2r2,9-2r3,13-1d1,5-2r1,7-3u1,2-3d2,1-6r5,8-6l1,5-6r2,8-7u4,7-2r1,8-2r5,14-1d1,2-1d4,1-6r6,8-7u4,7-2r7,15-1d1,2-12u5,1-6r6,8-7u4,7-2r7,2-14u2,2-12u5,1-6r6,8-7u2,8-3d2,8-7u2,8-5u1,8-4u1,7-2r3,11-1d1,5-11l2,2-12u5,1-6r6,8-7u4,7-2r2,10-1d1,10-11d1,11-13l3,8-13l2,5-14u2,5-12u3,6-8l3,2-9u2,1-6r6,8-7u4,7-2r4,11-2r1,12-2r1,10-9d3,11-13l3,8-13l1,7-13l1,5-14u5,6-8l3,2-9u2,1-6r6,8-7u4,7-2r5,8-10r1,10-9d1,10-10d2,11-13l5,5-14u5,6-8l3,2-9u2,1-6r6,8-7u4,7-2r4,13-10l2,10-9d3,11-13l5,5-14u5,6-8l3,2-9u2,1-6r6,8-7u1,8-6u3,7-2r1,9-3u1,8-1r6,13-11l2,10-10d2,11-13l3,8-13l2,5-14u5,6-8l3,2-9u2,1-6r6,8-7u4,7-2r1,9-3u1,8-1r5,16-13l8,8-13l2,5-14u5,6-8l2,4-8l1,2-9u2,1-6r6,8-7u3,8-4u1,7-2r1,9-3u1,8-1r4,18-12l2,15-11d1,16-13l3,13-13l2,11-13l5,5-14u5,6-8l3,2-9u2,1-6r4,5-6r2,8-7u4,7-2r1,9-3u1,8-1r2,17-9d1,17-10d1,18-12l2,15-11d1,16-13l10,5-14u5,6-8l3,2-9u2,1-6r2,3-6r4,8-7u1,8-6u3,7-2r1,9-3u1,8-1r1,17-7d4,18-12l2,15-11d1,16-13l2,14-13l4,10-13l4,5-14u5,6-8l3,2-9u2,1-6r6,8-7u4,7-2r1,9-3u1,17-8l1,15-7d5,16-13l10,5-14u2,5-12u3,6-8l3,2-9u2,1-6r6,8-7u2,8-5u1,7-3r1,17-3d8,18-12l2,15-11d1,16-13l6,10-13l4,5-14u5,6-8l3,2-9u2,1-6r6,8-7u4,7-2r3,17-1d3,17-4d3,17-7d4,18-12l2,15-11d1,16-13l2,14-13l7,7-13l1,5-14u5,6-8l2,4-8l1,2-9u2,1-6r6,8-7u5,15-5r1,17-6u1,17-3d8,18-12l2,15-11d1,16-13l2,14-13l1,13-13l2,11-13l1,10-13l2,8-13l2,5-14u5,6-8l3,2-9u2,1-6r6,8-7u4,7-2r1,10-5r1,11-5r3,14-5r2,17-6u1,17-3d3,17-6d5,18-12l2,15-11d1,16-13l1,15-13l1,14-13l1,13-13l4,9-13l3,5-14u3,5-11u1,5-10u1,6-8l3,2-9u2,1-6r6,8-7u4,11-5d1,10-7r6,17-6d1,17-7d1,17-8d3,18-12l2,15-11d1,16-13l2,14-13l3,11-13l1,10-13l4,5-14u5,6-8l1,5-8l2,2-9u2,1-6r6,8-7u3,5-3r1,6-5u2,5-2r1

;24
    #####       ####
#####   #########  #
#     $    #  $ $$ #
# $  # #   # #.... #
##$## $ # ## .$$$. #
#  $ $ $   # #.... #
#   # $ #  #  $ $$ #
#####   # ####   ###
###### ##$##### ##
#....#  #@$     #
#...    #$####  #
#..   ### ##########
########  $ ...    #
       #    ###$$$ #
       ## $ ...    #
        ############
Solution: undefined

;25
  ######### #######
###   #   ### $.  #
#  $. . $ #  $.$.$#
# #.#.#.# #  .$.$.#
# $$$ $$$ ## $.$. #
# #.#.#.# ##  $.  #
# $ . .$  ### #####
#   # #####   #####
#####    @  #  .$ ##
   ### ##### .$. . #
####    . ##$ $. $$#
#  $ $ $. ##.$ .$$.#
#  .####.### $ .$  #
# $.$ $  # # . .$. #
#  .  #### ## $.  ##
#######     #######
Solution: undefined

;26
########
#......# #####
#  $ # ###   # #####
# $ # $    # ###...#
##$ $ $ ###   $@ $##
 #      # #  $ # $ #
 ### #### #. $ #$  #
 #   #    # #### #.#
## ###    #.     $.#
#    ###############
# $$$##   #########
#  #..# #   $ ..  #
##  ..$ ### $$.. $##
 #      # # $ .. $ #
 ######## ######   #
               #####
Solution: undefined

;27
 #######    #####
 #.... #  ###   ###
###...$####   $ $ #
#  $#$ $ #  ##$## ##
# $$  #$ # $.#.$   #
#    #     #.#.#   #
####   ### $...  ###
   # ### ###$# #####
  ## ###   #   #   #
 ##    #   # $     #
 # $ $$ #####.### ##
 #......#   ...   #
 # $$ $   # #.###$##
 ###  ### $  $$    #
   #### #####@ #   #
            ########
Solution: undefined

;28
##################
#  ..  #  #@ #   #
# $  $ #   $$$   #
# #..# #  ##.##$ #
# $$$$ ##$##.##  #
# #..# #  .....$ #
# $..$ # $##.#####
# #..# #   #.#   #
# $$$$ ##  $ $   #
###.. ###  #   # #
  ### ########## #
    #            #
    ##############
Solution: undefined

;29
######### #########
#  $  . # #    .$ #
# $$$.$$# #$$$. $ #
#.......# #.......#
# $.$$$ # # $$.$$$#
# .  $  # #  $ .  #
###### ##### ######
     #   @   #
###### ##### ######
#   .$  # #   .$  #
#$$. $$ # #$$$.$$ #
#.......# #.......#
# $$$.$$# # $$.$$ #
# $ .   # #  $.   #
######### #########
Solution: undefined

;30
#######
# @#  #####
# $$  $   #
#  #.##$# ######
##$#...   #    #
## ...##$## ## #
#  ##.##  # ## #
#  $  $     ## ##
#  #   #  ###   #
########### # $ #
            #$.$#
           ##.$.##
         ###.$.$.###
         #  $.$.$  #
         #    .    #
         ###########
Solution: undefined


