;1
                ###
               #   #
              #     #
             #   . . #
     ####   #   # #  #
    #   #  #  #  . . #####
    #   # #      #   #   #
     #  ## $$ # #. . #   #
     ## $ $  $  ##   #   #
    ##  $$  #@$ #. . #   #
  ### . $ $    $##   #   #
###.      $ #  $ #   #   #
   #  .### # #   . . #   ###
    ###  # # ####    #
         # # #       #
         ### #########
Solution: u1,16-11l1u7,14-3r4,19-2d4,20-7l2,13-11r1,15-12u8,14-3r4,19-2d6,20-9l2,13-9r1,15-8d3,11-11l7,13-8u1,12-6r2,15-7u3,14-3r4,19-2d9,9-10l2,6-9d2,9-10r5,15-11u7,14-3r4,19-2d6,7-8r1d1,9-10l2,11-6d3,10-10r4,15-11u7,14-3r4,19-2d4,10-7d2,9-10r5,15-11u7,14-3r4,19-2d2,8-8r6,15-9u5,14-3r2,17-2d2,12-8u1,11-6r3,15-7u3,14-3r4,9-10u1,8-8r6,15-9u5,14-3r2,14-12r2

;2
             #####
            #.....#
   #####   #. $   .#
   #   #  #.  $  $$.#
   #   # #.$  $ $   .#
    #  ##.  $  $    .#
     #  $   $$$$ #.$..#######
    # . $$$$#@ $#.  .# #    #
   #  $$$  $   $.$$$.#      ##
  #.$....  $   $.  $.#
 #######.########  .#
#       #       #..#
       #       ####
Solution: u5r1u1r2d2l3d1l1u1l1d1l1d2r1u2d2l4d1l1u1d1l1d2l1u1r1u1r1u1r3d2r1d1l4r3u3l2d1r1d2u2l1d1u1l1d1u2r5u2r2d5l4u1l2u2l1u1l1u2r1d3r2d2r2u3d3l1u2d3r4u6r2d1r4l2u2d2r1u1l3u1l1u1r1l1d2l1d2r1u3d3l1d2r1u4l1u1r1d1r1u1d2r1d1l1u1l2d2r1u2l1u1r5d3r2l1d1l1d3u3l1d3u3r3d2l1r1u2l2r2d2l1u2l1u1r1d4l2u1r1d1r1u2l1u1r1u2l3d1u1l2d3r3d1r1u2d1l4d1r4u1r1d1l5u4r2d1l1d2l1d1r2u1r2d2l1u2l2u3l1d3l1d1r6l9u1r9l9u3r9l9r1d1r3u1r1d2l1d1r1u2l4d2l1d1r5

;3
             #####
            #.....#
   #####   #. $ $ .#
   #  .#  #.$$$$$$$.#
   #  .# #.$  $ $  ..#
    # .##.$ $  $  $$.#
     #$ $   $$$$ #.$..#######
    #.. $$$$#+.$#.  .#      #
   #. $$$  $ . $.$$$.#      ##
  #.$....  $ . $.  $.#
 #######.######## $.#
#       #       #..#
       #       ####
Solution: d1l1d1l2u1l1u2d1l3u3d3r2l2r2d2l4r3u1l2r2l1u2r1d2r1d1l2u2r3u1l2d1l1u2d3r4d1l3r5u1l4d1l1u1r1u1l1d1l1u2d1r3u1r2d1u1l2d3r3u1l4d1l1u1r1u1l1r2u1r1u1r1u1r1u1d1r1u2d6r1d1l6r6u2l1u2r2u3d2r4l2u2d2l2u2r2d1r1l1d1l1u2d2l1d1l3r1d1l2r2u1r2u1r4l1d2r2u1l1d1l1u1l1r2d2l1d1r1d1r1u2l2u2l1u1l2d1l2d4r3u1r1d2u2l3d1l1u3d2r2l2u3r2u1r2d1r2d4l10r9d1u1l1u1r2d1r1u1l7u3r1d2l1d1r6l2d1l3u4r1u1r2d1l1d1l2r1d1l1d1r4u1r1d1l1d1r1l4u3r1u2l1d3l1d1r1l1u3l2d1r2u1r1d3l1d1r1u6r3d2u1l3d1l3u2r3l1u1r2d2l1d1r4l4u2l1d1u1l2d1r6l7d4l1d1r2u1l3u1r1l1u1r3u1r1d1l2d1l1d1r2l1u4r3d2

;4
              ##
           ########      ########
           #      ##   ###      ######
           #       #  ##             ##
           ##      #  # $$$$$$$.....  #
           #       # ##        .$$$$$ ##
          #   $#######.. .. .  .....$  #
       ####   $ ##   #. . . .      .$  #
      ##      $  $   $. . . . $ .. .$  #
    ###   .   $  $   $.   . . $.   .$  #
   ##   $     $  $$$$$. $ . .  . ...$  #####
 ###.$$$$$$$$$$$$$ @ $  $      .    $  #   #
#### ....     $  ##  $  $      .    $  #   ##
   #####..... $ ..## $  $$$$$$$.$$$$$  #    #
       ########  ..# $     .....      ##   ##
            ###  ..########          ##    #
            #.....##     #############     #
           # ######        ##              #
           ###             ##             ##
                                          #
                                          ##
Solution: u2l3d1l3u1l3r1d3r1d1l3r6u1r1d3r1d1l3r1u3l4u4r2d1r2d5r1d1l1u6r1d3l1d1r2l1u5r3d2l2r2u2l3d5l1d1r2l2u2l2u1r1d1r2u2l1d4u5l1d2l1d1r2u1r1d2l1d1r1u1r1d1u2l1u5l1d4l1d1r1u1r1d2l1d1r1u6r1d1u1r2d2l2u1l1d3l1d1r1u3r3u1l2u1l1d3l1d1r1u5l2d4l1d1r2l4u4l4d1l1d1l1u1r2u1r4d3l5u2r1d1u2r4d3l4r4u2l3u1l1d2u1r1d1u1r1d2u2r1d2r4u2l1d2r3d3u3l4d1r3u2l3r1u2l1d3u2l1d2u3r4u2l3u1l1d2r1d1l1r9u1r3d1r1u2r1u1l2d8r3u6d6u2d2l3u6l3d1l1d2r1d3r10l4u2r4l4d2r4d1r3u1l1u3l2d2u1l1d1u1l1d1u1l1d1u4l4d5l3u1r1d1r1u6l1r2d2r2d1r1u2d1l3d2r1u3l2u1l2d1r7d1r1l1u5r4u2l7d2r1d1l1u3r1d2r1d1l1u1l1d1u3r3d2r1d1l2r1u3l1d2r2d4u4l1u2r1l1d2r3d1r5u1d1l1u1d1l1u1d1l1u1l1u2l2d1r1l1u1l2d2r3l3u2r1d2l1d1r3d1r3d5l1d2r5u8l4r4u2l1d1r1d1l3d1u1r3d1l2d1l1u1r3d7l2u7d8r1u1r1u1l1d1l1u6d5r2u3l2r2u1l1r1u1l1r1d4l1d1l1u2d2u2l4u1r1l3u2r3l3d1r2d1r1u1d5r2u1r1u1l3r2d1l2r6u2l6u1l3d1l2u1r3l6d2r5d1r1u3l1u1r1l11d2r8d1r1u5d4l9d1r9d1r1u5r1u1l1d3l7d1l1u1d1l2u1r8d1r1u2d2l8u2r7l7u2l1d1l1d1r7l9u1r3u1r1d2l1d1r8l4d4r2u3l1u1r1d4l1u4r1u1l2d1l1u1l10u2r1d1l1d1r9l9u4r2d4l1d1r8

;5
        ###    ####
       #  #   #    #
      # $ #  #..$$. #
     #   .# #.. $ ..###
     # ...##..$$$$$$  #
      #$$# $.$$ $..$  #
     #   $ .  $@ . $$ ##
    #  .$ $ $ $$$.#.$ .#
   #  $$$$$$ #    #.$$.#####
  # .....$ .# #####.$  #   #
########## .# #.....  ##   #
        ###.# # #######    #
       #    # # #        ###
       ###### ###        #
                         ###
Solution: r3u1r1u1d5u5r2d3r1d2l1d1l5r5u1l1r2u2l1u3l2d5r1d1l3r3u1r2u2l2r1u3l2d5r1d1l2r3u2d1l2u1r2l1u1r1u2l1u1l1d5r1d1l1r2u4l1u1l1d4u4l2d1l2u1r3d1r2u2l1d4u2l2d2l1u1r1u2l2d1r3u1r1d2u3d1l1u2l1d2l1d1r2u1r1d1l3r1u3l2u2r2d3r1d2l2u1r1u4l1d1l1d1r2l2r2d3l1u3r1u1l2r1d3l1u2d2u1l2d2r3u1r1d1l1d2l2u1d1r2u4l3d2r3l5d4u2r1l1u2l1u1r2d1r1u2d1l2d3r1u2r2l1u1r3d3l1u3r1u1l2d2l3d3l6u2r2u3l1u1r1u1r1u1r1d2u1l2d1r1l1d3r1u1d1r5l4d2u2r2d3l5r3u3l2d2u1l1d1u2r3d1l1u1l2d2r1u3d1r1d2r2l1u2r2d3u2l3r4u1r1u1r2d2l3u1l1d2u1r4u1l3

;6
         #####################
         #           @       #####
         #                       ##
        ##      .#       #.       #
        #     ####       ####     #
        #     #**# #   # #**#     #
        #    .#**# #   # #**#.    #
        #    ##### #   # #####    #
        #          #. .#         ##
        #          ## ##         #
        #          .# #          #
        #          ## ##         #
        #    #  #. ##$##  #.#    #
        #   #.$$.#$$ $   #.$$$#  #
        #  #.   $ .# ##$#  $  .# #
######### ###$ $$ .   .  $ $ .## ##########
  #     .    $ $ ###.  ### $ $    .     #
 ############    #  # #  #    ############
 #          #####    #    #####          #
Solution: l3d9l3d2l1d1r1d1l2r1d2l5r4u2d3r3u1l1u7r1u1l3d1l1u5l1u1r4l3d9u1r3d6l1u8r1u1l2d1l1u2l1u1r1u5r7l1d13l1d1l1d1l1u4l1u1r2u1r1d1l2d4r2u1l1d1l2u7r4u5r6d8r5d3l1d2r5l5d1l2u3r3l2u1r1d1r1u5l1u1r1d1r1u2r1u1l1d6l1d2l3d1l4d1u1d1l2u1l4r4u2l1r1d2l2u4l1u1r1d5r2d1r2u1r4u1r3u3l5d2l5r1d2l2u12r1u2l2d1r2u1r1d6u3l2d9r3u6l1u1r1u1r1d2l1d6l1d3r2u1r4u2r1u4l1u1r3d1r1u5r1u1l4r3d9l1d1l3d2l5d1l1u1l2u2r2d2u2r3d1u1r1u2r5d3l4d1l2r3u1r2d1l1r1d2l1u4d3l1u2r3u3l5d2l6u2l4d3r3l3d1r3

;7
        ###    ####
       #  #   #    #
      # $.#  #..$$. #
     #   .# #.. $ ..###
     # ...##..$$$$$$  #
      # $# $.$$ $..$  #
     #   $ .  $@ .$$$ ##
    #  .$ $ $ $$$.#.$ .#
   # $$$$$$$ #    #.$$.#####
  # .....$ .# #####.$  #   #
########## .# #.....  ##   #
        ###.# # #######    #
       #    # # #        ###
       ###### ###        #
                         ###
Solution: r2u1r2l1u2l4r4d2r1u1r2d3r1d2l1r1u2l1u3l2d5u5r2d3r1d2l1d1l5r5u1r1u2l2r1u3l2d5u2r3d2l1d1l4r2u6r2d2l1r1u2l2d5u2r3d2l1d1l3r3u1l1r2u2l3d2r1d1l1r1u2r1l2u1r2u3l1d5r1d1l1u5l3d1r1u1r1d3u2l2r1u3l4r4d3l3u1r3u1r1d3u1l2d2l2u1r1d1r1u1l1u1r2u1r1d1u2l1u1l1d3u3d2l1r1u2l2u2r2d3r1d2l2u1r1u4l2d1r1u1r1d1l1d1r1d2l2u2d2u1r1u1r1d2l1d2l1r1u5l1r1d5l1u4d1l2d2r2d1r1u1l1u1r1l1d1l1u2d2r1d2l1u3r1u1l1d2l3d4u1l6r6u3d2r1u1l1u1r1l2u1d1l1d2u2r2d3l4u5r2u3l1d1l1d1u1r2d2l1u1l1u1r1l1d1l1d1r2l1d2r3l4d1l1d1u1r2d1r1l1u1l2d1r1u1r1d1r1l1u2r1u2l1u1r1d3l1d2r1u1r1u1l1d1l1u2d2u1r2d1u1r1u1r4l2d2l4u1l2d2r1u1l1u1r1d1r1u2d2r1d1u1r2d2l2u1r1u1r1d2u2r1u2r2d2l6r2u2r1d3u1r3u1l2r4u1l3

;8
        ###    ####
       #  #   # $ .#
      # $ #  #..$$. #
     #   .# #.. $ ..###
     # ...##..$$$$$$  #
      #$$# $.$$ $..$  #
     #   $ .  $@$. $$ ##
    #  .$ $ $ $$$.#.$ .#
   #  $$$$$$.#    #.$$.#####
  #......$ .# #####.$  #   #
########## .# #.....$ ##   #
        ###.# # #######    #
       #    # # #        ###
       ###### ###        #
                         ###
Solution: u1d1r2u1r1l1r2u1r2d3r1d2l1d1l5r5u1r1u2l1u3l2d5u5r2d3r1d2l1d1l4r4u1l1r2u2l1u3l2d5r1d1l2r1u6r2d3l1r1u3l2d5u1d1r1d1l1u3d2r1u1l1u1r2l1d1r1u2l1r1u2l2d5u5r1d4r1d1l1u4l3d1r1u1r1d2u1l4u1r3d1r2u2l1d2l2d2l1u1r1u2l2d1r3u3l3u2r2d1u1l2d2r2d2u3l2r2d3l2u2d3r1d1u2l1u1l2r2d2r1l1u2r1u1r1d1r2l1d2l1r1u2l2d1r1l2d1r1u1r1d1u2r3d2l2r1u2l4d2r1d2l1u2r1u3l2r2d3l1u2r1u1l1d2u1l2d1l1d2l1d3u3r1u2r4l4d2r1u2r2d1u1l3d1l2u1r1d4l7r1u2r2u1r3u1r1d4u3l3u2l1u2r1u1r1d2u1l2d1r1d3l1u1d1l1d2u2r5d3l6r1u2r1d1u2r4d3l5r3u2l1r1d2r2u3l2d1l1u2d3r1d1l2r4u1l2u1l1d1r1d1l1r3u3l1d2r1d1l2u2r4u2r2d2l3u1l1d2u1r4u1l3

;9
       ####   ####
       #**#   #**#
       #**#   #**#
     ###############
     #      @      #
     #  ###$.$###  #
     #  #*# . #*#  #
     #  ###$.$###  #
    #  $. # . # .$  #
     # $.$ $.$ $.$ #
      # .$ $.$ $. #       # # #
       # $.....$ #           #
        #  $.$  #  ## ##  # ###
         #  .  #   # # #  # #
         ###.###   # # #  # ###
##########**#**##### # ## #   #
         #*###*#          # ###
##########**#**##########
         ### ###
Solution: d7l2d1r1u1r1d2u2r2d1l1u1l1d1r1u1r1u2l1u1l1d3l2u1r1d1r3u2l2d1l2u1d1r2u6r6d5u1d1u1d1u5l6d5r2d1u1l2u5r6d5l1u1d2l1d1l2u1l1r1d1r2u1l1d1l1u1r3u2l2d1u1r3u4l6d5r1d1r2l2u1d1r2u1d1l2u1l1u1l1d2r2l1u6r6d4l3d1l2d1l1u4r1l1d4u1r2d1u1l2u3r1d2l1d2r2l2u4l1d1r1d3r2u1l1d1l1u3l1d1r1d2l2u1r1d1r1u2r1d1r2u1r3u4l7d4r1d2l2u1r1d1r1u1l1u5r2l7d5r1u1d2r4l3d1r1u1l2u2r2d1r1d1l1r2u6l5d3u1r1d1l1d1r1u4r6d4u4r5d4l3d1l2r2u1r3u2l1d1r1d1l1

;10
    ######
   #     #
  # .$.$ # #########
   # .$. # #*      ##
    #  ### # $. .  *#
     # #   #  $   $ #
     # #####. .$.$. #
    #    $ $.   $ . #####
   #..    $@  .$.$  #   #
  #   ###* $  $   $ #   #
## ###  #### $. .####   ####
         #  ######
Solution: l6r1u4l1u1l1u2r2d1l1d2r1u1l1u2r2d1l1u1l1d1r1d6r4u1l3d1l1u5d5r6u4r3l2r2d1r1d4l1d1l1u2l2d2r1u2l3d1r1u1r2d2l1r1u3l3r3d3l1u2r1u1l1r1u3r2l2d2r1u1r2d2l2d1l1u1r3d1u1r3d2l5u1l2d2r1l1u3r4u2r1u1r1d1l1d1l1d1r1l1d2u1l10r6d2r1u1l1u1r1u1r1u1r1u1l3d1r1u1r6d3l2u1l5d1l2u1r1d1r1u1d1l4u1r3

;11
       #####        ##
       #    #      #..#
    ### $.$ #     #.  .#
    #   $.$ #    #.$$$ .#
    # ..... #   #.   $  .#
    ## $$. #   #.$$$$$$$ .#
      #  $#   #+   . $    .#   #
      ## $ ###.$ .$ .###$$.#
     #  $.$    $  $$$.$. $$.######
     #  $ $ $$$.$$$  #. .$.#      #
   ###$  $  $ .#. $  #.  $ #      #
  #    .## $$.# #.$ .#.$.$.#      #
## ## .#  #   #  #.  ## $  #      #
     ##   ##.#    #.$.#. .$#   ####
           #.#     #.# #   #   #
           #.#    # .     .#   #
           ###    ##########
Solution: r4l1u2r1u1d1r1u2d2l2d1l1r1u1r2u2r2d2l4r3u2d2r3d2l2u3d1l4d2r2u2l1u1r3d2r1d1r1u1d3l1d2r1d2r1d1l1u2l1r1d4l4u2l1u2r1d1l1d1r1d2r4u3r2d2u2l2u2l1u2d2r1u4r1u1l1d2r1l1d5r2u2l3r3u1l1u1r1l1d4u4l1d2u4r1d3l1d1r1u1r1d1u1l1u3l3u2r1l3d3l1d4r1d1u1l1d1u6l2d4r2u1r1d5u4l2d1u1l1u1r1l1u3r2d4l1d1r1u1r1d3u4l1u2r1d1r2l3d2u4r1u2r3d1l1d1r1u1r1d3r1d2l2u1r2l1u3l2u2l2d1r2u1r1d1l1d1r1u1r1d3r1d1l2r1u4l4d1r3u1r1d3u2l4d2l1d2r1l3u2r3d2u4l2u1r6l7d3r1u1l1u1r8l8d2l1d1u2l1r1d2l1u2d1l5u1l1u1l1r1u2d2l2r2u2r2u3l2d2u2r2d3l4u1r1d1r1u1d1r1l1d3r1d1r4l1d1r1u1l2r2d1r5d1r1u2l9d1r7d1r1u3l4d2l2d1u1l2d1r2l1d4u4l2d1r1u1r1d3u5l2u1l1u3r2u1l1r1u2l3d2l1d1r2d2l2u1r1u1r1l1d2r1d1r1d2l1r1u2l1u1l1u5r3d3l2r1d1l1r1u2d2l1d1l2u1r1d1r1u1d2r1d2r1d2l1r1u2l2r2d2l1r1u3d3l1u1l1u1d1r2u2l1u1l1d1l1u1r2d1r1d2l3u1l1d1u1l1d2u1r5u2l1d1l1d1r2u1r1d3u2l5u1r5d1r1u1l1u1r4d1r1u1l8u1l1d1r1d2l2u1r7l5u2l1u1d3l2u1r2u2r1u1r1u2l1r1d2l1d3l1d1r1u4r1u2l1d3u3r2u2l2r2d3l2d2l1r1d2u5r2u2l2d5u4l2d1r1u1r1u1r2d1l1u1l2d2r1l1u2r2d2l1d3l2u1r1d1r1u2d2l1d2r1u3d3l1d2r1u4d4r2u1l1d1l1u1

;12
       #####        ##
       #    #      #..#
    ### $.$ #     #.  .#
    #   $.$ #    #.$$$ .#
    # ..... #   #.   $  .#
    ## $$. #   #.$$$$$$$ .#
      #  $#   #+   . $ .. .#   #
      ## $ ###.$ .$ .###$$.#
     #  $.$    $  $$$.$. $$.######
     #  $ $ $$$.$$$  #.$.$.#      #
   ###$  $  $ .#. $  #.$ $ #      #
  #    .## $$.# #.$ .#.$.$.#      #
## ## .#  #   #  #.  ## $  #      #
     ##   ##.#    #.$.#. .$#   ####
           #.#     #.# #   #   #
           #.#    # .     .#   #
           ###    ##########
Solution: r3u2r1u1d1r1u2d2u1r2d1r2d2l2u3l2d1r1u1r1d1r2d2l2u1d1r2u2l2u1l3r1l1d1l1d2r2u2l1u1r1d1r1u2d2l1r1u1r1d1r2d2l1u1r1u1l2r2d2r1l1d4l1d2u2r1u2l1r1d2l1d2u2r1u6l2u1l2d6l1d4r1d2r5u3r1d2u4d1u1l1r1d4l2d1l4u4l1u3r1u5r2d1r2d4l1r1d1l1u1l1r1d4r1d1r2u3l2u1l1d1r3d3l2u2l1u2r1d1l1d2r2d1r1u1l3u2r2d1u1r1u1l1d1l2u2r1u1r1d1r1d2l1u2l2d1r2l1u2d1r1u1l1u1r1l2u2l1u1l2d3r3u1r1d2r1d1l1d1r1d3u6l8d3u1r2d1r1u2d1l3u3d1r6u1r1d3u2l1u2l1d1u2l2d2r4l4u1r3l2d2r2l5u1r4u1r1d1l3d9u6l3d1r2u1r1d5u4l3u1l1d1r1d1r2u1r1d1l2d1u3l1u2r2d6u4l2u1r2l4d1l1d1u1l1d2u2l2d1r1u1r2d1l1u1l2d2u2l1u1l1u4d4r1d1r1d2l1r1u2l1r4d1r4d1r1u3l3d1l5d1r6d1r1u2r1u1l2d1l1u2d2l5d2l1r1u2l1u1l1u3r2u1d1l2d3r1d1r1d2l1r1u2l1u1l1u1l1u1r1u1l2r2d3r1d1r2l2u1l1d1l1r3d2l3r3u2l3d1l1d1u1l1d2u2r2u1r3d2l3r2u1d1l2u2r7d1r1u2r1u1l1d2l5d1r2d1l1d4u5l2d2u1d1r1l1u2r2d4u2l1u2l1u1r6d1r1u1l9d1l2d1r5u1r1d3u2l1u2l2u2l1d3l1d1r4d1r1u1l1u1r3l4d1l2u1r3l3r1u5r2u3l2d7l1d1r2u2l1u3l2u1r1d1r3u3l2d7l1d1r1u5r2u2l1d1u2l1r1d2l2d3l1u1r1u2r2u2l2d2r1d7r2u1l1d1l1u6d6r4u1l3d1l1u5d4r3u1l2d1l1u3d3l3u1r2

;13
       #####        ##
       #    #      #..#
    ### $.$ #     #.  .#
    # $ $.$ #    #.$$$$.#
    # ..... #   #.   $  .#
    ## $$. #   #.$$$$$$$$.#
      #  $#   #+   . $ .. .#   #
      ##   ###.$ .$ .###$$.#
     #  $.$    $  $$$.$. $$.######
     #  $ $ $$$.$$$. #.$.$.#      #
   ### $ $  $ .#. $. #.$ $ #      #
  #.  $.## $$.# #.$ .#.$.$.#      #
## ## .#  #   #  #.  ## $  #      #
     ##   ##.#    #.$.#. .$#   ####
           #.#     #.# #   #   #
           #.#    # .     .#   #
           ###    ##########
Solution: undefined

;14
       ####   ####
       #**#   #**#
       #**#   #**#
     ###############
     #      @      #
     # $###$.$###$ #
     # .#*# . #*#. #
     #  ###$.$###  #
    #  $. # . # .$  #
     # $.$ $.$ $.$ #
      # .$ $.$ $. #       # # #
       # $.....$ #           #
        # .$.$. #  ## ##  # ###
         # $.$ #   # # #  # #
         ###.###   # # #  # ###
##########**#**##### # ## #   #
         #*###*#          # ###
##########**#**##########
         ### ###
Solution: d7r2d2l1r1u2l2d2u2l2d2r1l1u2r2u7l5d1u1r10l11d3r1u1l1d3r1u1l1u4r6d7l2u1d1r2d1l1r2l1u8l6d5r1d1r1d1r2u2d2r1d1r1u6d5l2r4u2l1u1l1d3l2u2r1u1r1d2u1l1d1u1r2d1u1l3d2l2u1l1u2l1u4r12d5l1u1d2l5u1l2d1r1u1r3d1r2d1l1u1r2u2l2d1l1d1r1l2u2l2d2l1d1l2u1l1u2l1u4r12d2l1d1r1d1l1r1u4l1d1u1l11d5r1d1r2l2u2r2d1r1d1l1u2l1r1d1r3u3l1d2r1d1l1u3r2d1l2d3r2u1r2d1l2u1l1u2r1d1l1d1r1l2d1l2d1u3l3u4r5l5d4r3d2r2u1r2d1u1l2d1l2u1l1r1d1u2l3u4r7l7d4r3d2r2u1d1u1r2d1u1l2d1l2u2l3u4r6d2l1d3r2d1l1u2l1u2r1u2l6d4r3d1r2u1r2d1u1l1u2d1r1d3l1u3d3l1r4u1l2d1l1u2d1l4u1l2u4r7d4l1d2r2u1l1d1l1u1l3d1r2u1r2u5l2d4u4l5d4r3d1r2l3u1l2d1r1l1u3r1d1l1d1r1l1u4r1d1

;15
       ####   ####
       #**#   #**#
       #**#   #**#
     ###############
     #      @      #
     # $###$.$###$.#
     # .#*# . #*#. #
     #  ###$.$###  #
    #  $. # . # .$  #
     # $.$ $*$ $.$ #
      # .$ $.$ $. #       # # #
       # $.....$ #           #
        # .$.$. #  ## ##  # ###
         # $.$ #   # # #  # #
         ###.###   # # #  # ###
##########**#**##### # ## #   #
         #*###*#          # ###
##########**#**##########
         ### ###
Solution: undefined

;16
       ####   ####
       #**#   #**#
       #**#   #**#
     ###############
     #.     $@     #
     # $###$.$###$.#
     # .#*# . #*#. #
     #  ###$.$###  #
    #  $. # . # .$  #
     # $.$ $*$ $.$ #
      # .$ $.$ $. #       # # #
       # $.....$ #           #
        # .$.$. #  ## ##  # ###
         # $.$ #   # # #  # #
         ###.###   # # #  # ###
##########**#**##### # ## #   #
         #*###*#          # ###
##########**#**##########
         ### ###
Solution: undefined

;17
     #
    # #    #
   #  .#  # #
    #  # #. .#
     #$.# $ $ #
    #   $$@    #####
   # .$ $ $$$  #   #
  # .  .#.   .#    #
## ##### ###.#     ###
      #  #  #
Solution: d1l1d1r3l2u2r2d2u2l2u1d1r2u1l2d2u2l1d2u1l2d2l2u2r1u2d2l1d2r2u2d1l1u1l1d1r1d1l1r2u2r2d1l3r4u1r2d1l4u1l1d1

;18
     #
    # #    ####
   #  .#  #   .#
    # .# #.$.$  #
     #$.# $ $.$$#
    #   $$@.   .####
   # .$ $ $$$$ #   #
  # .  .#.   .#    #
## ##### ###.#     ###
      #  #  #
Solution: r2d2u2r1d1u3l1u1r1d1r2d1u1l2d2l1u1d1l2d1u1r2d2l2u1l1r1u2r3u2l2d2r2u1r2d1l1u1l1u1l2d2l1d2l2r2u2l1d1l2d1l1d1l2u1r1u1r1u2d2l1d2r1u3d2r1u1r3d1l4u1l1d1r1d1l1u2r5u1r2d2l6

;19
          #
         # #
        #   #
     #########    ######
     #   @$  .#   #....#
     #     $ $ #  #....#
    ##     $ $ .# #...#
  #### $$$$$    .##..#
  # ##     $$$$$$  $$.#
  #  #     $     $$$  .#
  #  #      ####   $   .#
  #  #     .#  #.####.# ###
###  ###### #  # #   # #
          #.#  # #   # #
          ###  ###   # #
Solution: l3d5r1l1u3r2l1d4l1d1r4u1r1d2u1l4u5r3d4l1d1r1l1u4r3u3l2d4u1r2u1r2d1r2d3r4u1d1u1r1d1l2r1u5l1u1r2d2l1d4l4u2r3l3d2r4u4l1u1r2l1d5l1u1d1l3u2r3d1r1u2l1u1r1,18-10u1d1l2u2r3d1r1u3l1u1r1l1d5l3u1r3d1r1u5l1u1r1,10-9r9,20-10u5,15-7d1,14-9r5,20-10u4,14-7d1,13-9r6,20-10u3,11-7d1l1d1r9,20-10u2,12-7d1l1d1r7,19-10u5,12-8u1r3l2d1l1d1r6,19-10u4,13-4d4,12-9r6,19-10u3,10-5r2d1r1,13-4d3,12-8r6,19-9u1,11-5d2,10-8r10,8-6d2,7-9r14,9-5d3,8-9r9u1r1d1l1d1r5,8-4r4

;20
          #
         # #
        #   #
     #########    ######
     #.$   .  #   #....#
     # .$$ $ $ #  #....#
    ## . $ $ $ .# #...#
  #### $$$ $  $ .##..#
  # ##   $ $$$$$$   $.#
  #  # .$$ $     $$$$$.#
  #  # ..$ $####   $@. .#
  #  #   $ .#  #.####.# ###
###  ######.#  #.#   # #
          #.#  #.#   # #
          ###  ###   # #
Solution: r1u1d1l4u1d1r2l2r2u1r2l1u3l1u1r2l1d5l3u1r2d1r1u3l1u1r1d3l2u1r1d1r1u3l1u1r1d4l4d3u3l1u2l1r1d2r1u1r3d1r1u4l1u1r2l2d4l4u1l1u2d2r1d2l4d3u1l3u1l1u2l1u2r2l2u1d5r2d1r3l3u1l2d1r4u1r1d1u1l3d1l2u2r1d1l1d1r4l3u3r1l1d2r4u1r1u3d3l1d1l4r4u1r1u2l1d1l1d1r9u1r1d1l1d1r1u1r1d1l4u1l5r3u2l1u1d1r1d2l3u2r1d1l1d1r3u1r1d3u3l1u1l1d1l1d1r6u1r1d1l1d1r3l6u1l5d1l1d1l3u3r4u1r1d1l1d1r4u1r1d2u1l3u1l6d2r1u1l1u1r12d1r1u4l1u1r1d4l12d1r11u1r1d1l1d1r1u1l12d2r1u2l1u1r11d1r1u4d4l14u3r1d1l1d1r13d1r1u3d2l13u2r1d1l1d1r11d1r1u4d3l5u1d1l2u3l1d3l1d1r9d1r1u3d2l8u4l1u1l4r1d3l1d1r11d1r1u3d2l5u2l1r1d2l3u3r1d2l1d1r7d1r1u2d1l5u2l1d1l1d1r6d1r1u1l11u2r3u1r1d2l1d1r8d1r1u1l6u3l1u1l1d4r1d1l5u1l1d1r4u3l1d3r1d1l2r1u3l2u1l1d2u4r2d1l1d2r3u2l3r2d1l2

;21
                        #######
                        #     #
                        #     #
          ############  # $ $ #
         #           ###   ####
        #.$ $.$ .$ $.  .$ $#
       # ..$..$ .$$..$@.$. #
      # $.$.$.$ .$.$.$ .$.$.#
      # $.$ ####..$ .$ .$.$. #
      #  .$$$. #.$  ## .....  #
######## . $ . #####  ## $$$ $ #
#       #          #    ##   $  #
#        ###########      ##     #
#                           ## ## #
#                             #  # #
Solution: u1l2u1l10r1d1l1d1l1d4r3l1u2d2l2r2u1r1l1d1l2u4r1u2r4l1d2l2d3r1d1l1d1u7r2d3u1l2d1l1u1r1d5l2u4d2l2u2r3l1d2l1u1l1u1r1d2r1d2r2u1l1r1u1l1r1u1l1u2r1d1u3r4d2l2r2u2l5d1r1d2l1d2u2r1d1u3l1d1r1d2l1d2r1u4l1u2r10d4l1d1l2r2u1r1u4l7d1r1l1d2r1u3l4d2r1d1r1l1u1r1l2u2r1d3u3d1r1d2l1d1l1d2r1u4d2l1u1r2u3l1d2u2r3d2l1r3u1l1u1l1d1r1d1l1d1r1u1r1d1u3r4d4l2u1l1r1d1r2u4l2d1l1u1r3d4l2u2l1u2r3d1r2d3r1d1r2u4l1r1d1l1r1d1l1r1d1l1d1r4d2l2r2u2l6u1l1r1u1l1r1u1l1u1l1u1l3d1u1r1l1d3r1d1r1l1u2r3u1d1l3d2r1u1l2u3r1d2r1l1u2r1d1r2d3r1d1r2u4l3d2r1u1l1u1r1d4r5u1l2u1l1d1r1d1l1r4d2l2u1d1r1u1r1u2l4d2r2l1u2r1d1u1r2d1l3r1u1r1u1l1u1l1d1r1d2r2d2l2u1d1r2u2l2u3l1u2r1d1l2d3r2l1u3r1d1l1d2r1d2l1u4l1u2r1u2r1d2l2d2r2d2l1d2r1d1r2u2l2u3l1u3d5r1d1r2d2l2u2d1l1u4d4r1u1r2d1l1d1l1u1r1u1l1d1l1u1d1r3d2r2u2l3d1l1u1r1u1l1r1d1r3d2l1u1r1u1l2d1l1u1l1u4l2u2r2d4u6r3d1l2u1l1d4u2l2d3r2u3l1d2u3r1u2l1d4

;22
                        #######
                        #     #
                        # .$. #
          ############  # $.$ #
         #           ###   ####
        #.$ $.$$.$ $.  .$ $#
       # ..$..$ .$$..$$+$. #
      # $.$.$.$ .$.$.$ .$.$.#
      # $.$ ####..$ .$$.$.$. #
      #  .$$$. #.$  ## .....  #
######## . $ . #####  ## $$$ $ #
#       #          #    ##   $. #
#        ###########      ##     #
#                           ## ## #
#                             #  # #
Solution: u1l3u1l10r1d1l1d1l1d4r3l1u2d1r1l1d1l2u4r2d3r1d1u1l1u5r5d2u2r4d4l1d1l2u1l1u4l5d3l1u1l1d3l2u1r1d1r1u2d1u1r2d2l1u3d2l3u1r1d1r3d1l1d2r2u1l1d1l1u2r1u1l1u2r1u2l1r3d3l1r1u3r3d3l1r1u3l3d3r2u1r1d1u1l2r2u2l3d2u2r1d1u1r2d2l2u2l3d1r1u1l2d1u1r10d4l2u1l1r1d1r2u3r3d4r2u7r2u1r2d2l1r1u2l4d3r1u1d1l1d5r3d3r2u2l1r1d2l2u1r1u2l4u2r1l1d1r1l1d1l2u2d1u3l3d3l2u1r1u1r1u2l2d2u2r1d1l1d1l1r1u2l2d1r1u1r3d1r3d2u2l4u1l3r3d1l1r5d2l1u1r1u1l3r2d1u1l2d1u1r3d4r6d2l3u2d1u1l2d1r1u1r4d2l3r3u2l6u4r1l1d4r1l1u4l3u1l6d1l2r2u1r2d1l2u1r4d1l1u1r3d1l1r4l4u1l2d1l1u1r3d1l1r4d2r1d2l1u3r1u1l3r2d3l1r1u3l2d1r2d2l1u1r1u1l1r1d3r3u1l2u1l2d1r1u1r1d1l1u3r2u1r1d4l1d2r1l1u2r1u1l1r1u2l1d2r1d1l1d2r1u3d2r4d2l3u1d1r3u2l4u2r1d1l1d2r1d1r3u2l3d1l1u1d1r1u5d6r2u1r1u1l3d2r1u1l1u5l1u2r1d5u3l1d1u1l5u1l2d1r6u1r1d1l7u1l2d1r6l6u1l2d1r5u1l9d1u1r2d1r3u1l5d1r2

;23
                        #######
                        #     #
                        # .$. #
          ############  # $.$ #
         #           ###   ####
        #.$ $.$$.$ $.$ .$ $#
       # ..$..$ .$$..$$+$. #
      # $.$.$.$ .$.$.$ .$.$.#
      # $.$ ####.*  .$$.$.$. #
      #  .$$$. #.$  ## .....  #
######## . $ . #####  ## $$$ $ #
#       #          #    ##   $. #
#        ###########      ##     #
#                           ##.## #
#                             #  # #
Solution: undefined

;24
   ######     ####
   #    #    #    #
   # . .#   # $  $#
    #. .#  #  .$$.#
     #$$# #   $.. #
    # $ ##    $..$#
   #       @  . $.######
  #           $$  #    #
 #    #   #   .$$.#    #
# #### ######$$..$#    ##
         #  #  .. #     ###
        ##  #######
Solution: r2u4r1l1d3r2u1l2u1l1d2l1d1l4u3d3l2u1r1u2l1u2r2d1l1u1l1r1d3r1u1l1d1r1d1l1d2r2u1l1d1l1u3r1u1l1r1d3r4u1r3l1d1l5d1l1u3d2r6d2r1u2r1u1l3r2d1u5r2d1l1u1l1d4r1d1l3r2u2r1u1d3u2r2l3d3u3r3d2l3r2d2l3r2l2u3r1u1l1d4r2d2l2u3d2u1r4u1l1d1l1d2r2u1d1l2u2r1d1u3l1d3u1l2d1r2u2l4d1r3u1r1d1u4r2u1d1l3u3r3d1l1d1u1l1u1l1d1r1d4l1d1l4u2r4l3u1r3l1d2l1d1r1u1r1d1l4u1r3

;25
   ######     ####
   #    #    #    #
   # . .#   # $  $#
    #. .#  #  .$$.#
     #$$# #   $.. #
    # $ ## $  $..$#
   #       $@ . $.######
  #        $  $$  #    #
 #. ..#   #   .$$.#    #
# #### ######$$..$#    ##
         #  #  .. #     ###
        ##  #######
Solution: l3d1l2u4d3l2u1r1u2l1u2r2d1l1d2r1u1l1d4r3u1l2d1l1u3r1u1l1d3r1u2d2r5d1l7u1l1d1r1d1l2r2u2r7u2l1d2r1d1l7u1l1d1r8u1r3u1l3u1l1d1r1d1l6u1l1d2u1r10u1r1u1l3u1l1d2r1d1l2r4u2r2d2l5d1l1u1d1r2d1r1u2r1u1l1d1l1u1r1u1l1d1r3d3l3r4u1l1d1l1d2r2u1d1l2u2r1d1l1d1l2u3r1u1r1d3u2l2d2r2u2l4d1r3u1r1d1u3l2d2l1d1r1u6r1u1r3d1l1d2u2l1u1d2l1d1r1u3l1d1r1d5l6u1r4l3u1r4l3u1r3

;26
   ######     ####
   #    #    #    #
   # . .#   # $  $#
    #. .#  #  .$$.#
     #$$# #   $.. #
    # $ ## $  $..$#
   #       $@ . $.######
  #       $$$ $$  #    #
 #. ..#. .#   .$$.#    #
# #### ######$$..$#    ##
         #  #  .. #     ###
        ##  #######
Solution: l4d1l2u1d1r2u1l1u3d4l2u1d1r3u1r5d2l1u2l5d1l2u1r2d1r2u1r3d2l1u1l6u1l1d1r1d1l2r1u1r6u1d1r3u3l1d2r1d1l8u1l1d1r8l2u1r1d1r2u2l1d1r1d1l7u1l1d1r2u1r3l4r1u3l1u2r1d5l1d1r2l3u2r1d1r1u3l1u2r1d4l1u2r1u1l1d5r2u1l1d1l1u3r1u1l1d3r1d2r2u1r1u1l2d1l1u4d3r1d1r4u1l4d1l1u3,11-4d2r1d1l4u1l1d1,15-5l2u1l1d2r1d1l3u1l1d1u1r5u1r1u1l2u1l1d2r1d1l7r6u2r1d4r1u2r1u1l3u1l1d1r1d1l4r4u3r1u1r1u1r2d1l1u1l1d4r1d1l5r2u1r1u1r4d2l5r4d2l3r2d2r2l2u2r2u1d1l2d2r2u1d1l2u2r1d1l1u1d2l2u3d3u1r2l1u3r1d3u2l4d1r3u1r1d1u3l2d2l1d1r1l2u1l1u1r3d1u4r1u2r3d1l1d1u1l1d1l2d4r1u3d3l6u1r4d1r1u1l1u1r3l2d1l3d1l4u1r5d1r1u1l1u1r3l2d2l8u1r9

;27
   ######     ####
   #    #    #    #
   # . .#   #.$  $#
    #. .#  #.$.$$.#
     #$$# # $ $.. #
    # $ ## $  $..$#
   #.      $@ . $.######
  #      $$$$ $$  #    #
 #. ..#. .#   .$$.#    #
# #### ######$$..$#    ##
         #  #  .. #     ###
        ##  #######
Solution: l5r1d1l3u1r1d1r2u1r1d1l3u1r1d1r2u1l2r6d2l2u1d1r2u2d2l2u1l3u1l1d1r2u1d1r2d1r2u1l8u1l1d1r1d1l2r2u1r7l2u1r1d1r2u2l1d1r1d1l8u1l1d1l1d1r1u1r7l1u2d1r4l1u2r1d1r1d1l4d1l2u1r2d1r2u2l1d1r1d1l8u1l1d1u1r1d1r2u1l2r2u3l1u2r1d5l1d1r4l4u1l1u1r1d1r1u3l1u2r1d4l1u2r1u1l1d5r2u1l1d1l1u3r1u1l1,11-8u1r1u1l4d1l1u4d3r3u1r2d1r2u2l1d1r1d1l6d1l1u3d2r5l1u2r1d1r2u2l1d2r1d1l7r5u1r1u2d2r3u1l2u1l1d2r1d1l5r4u4r1u1r2d2u1l2d3r2u1r1d2l6r1u1r4d3l2r3u1d1l2d2r2u1d1l2u2r1d1u2d1l1d1u1l2r1u1d1r1u1d3l1u1d1l1u1r1u1r2u3l1d4u4l2d2r2u1r1d2u1d1l2d1l1u1r2u3l3d2r2l1u2r2d3l1u1l3d1r2u3r1u3r2u1r1d1l1d1u1l1d1l1d1l1d3r1u3d2l1d1l4u1r1d1u1r2d1r1u1l1u1r3l2d2l6u1r5d1r1u1l1u1r2l2d2l7u1r8

;28
   ######     ####
   #    #    #    #
   # .$.#   #.$  $#
    #. .#  #.$.$$.#
     #$$# #.$ $.. #
    # $ ##.$  $..$#
   #. $    $@$. $.######
  # .$. .$$$$ $$  #    #
 #.$..#. .#   .$$.#    #
# #### ######$$..$#    ##
         #  #  .. #     ###
        ##  #######
Solution: undefined

;29
   ######     ####
   #    #    #   .#
   # .$.#   #.$  $#
    #. .#  #.$.$$.#
     #$$# #.$ $.. #
    # $ ##.$  $..$#
   #. $    $@$.$$.######
  # .$. .$$$$ $$  #    #
 #.$..#. .#   .$$.#    #
# #### ######$$..$#    ##
         #  #  .. #     ###
        ##  #######
Solution: undefined

;30
               #######
       ###     #   . #
      #. .#    # .  .#
     # $  .#   #     #
    #  $   .#  # . .##
    #  $    .# ##  #
    #  $      #..# .#
    #  # $$$$$      .#   #
#####  $ #   $       .#  #
#   # $$$# @ $    ... .# #
#   # #  #   $  #.##### ###
#   # $ $$$$$ ###.#      #
#   #        #  #. ##    #
#   ##########  ####     #
#
### # # # # #
Solution: r5u1r1d3u3l3d1l2d1r1l1u4d2l1u3d3l1r1u2l1d1u3l3u1l1d1l1d2r1u1l1u1r3d1r1u2d1l3d1r3d1r1u2d3r5d1r1u1l4d2r1u1l1u1r2d1r1u1l5u1l2d1r9d1r1u5l1u1r2l1d6l7d1l1u1r1u3l2d2r8d1r1u6l1u1r1d6l10u2l2d1r4u1r1d2l1d1r7d1r1u6d4l10u1l3d6r5u4r1u2l2d1r8d1r1u3l1u1r1l1u1r2u1l1u1l1d2r1d4l10u1l3d6r2u2r1u3r1u2l2d1r4u1d2r2u1l1d1l2u2r1d3l1d1r6u1r1d2u1l7d3r2u2l1u1r5u1r1d1l2d1l1u1l2d2r1u3l1u1r5d1r1u5r1u1l1d7l8d3r1u4l1u1r8d1r1u1l10u1l3d2r1l2d4r2u2r1u3r1u2l2d1r3u1r1d1l1d1r2u1r1d1l2d1r8d1r1u1l10d4l3u3d3l2u3r2d1r1u3d2l2u3r4u1r1d3l1d1r11l11d3l2u5d2l2u3r4u1r1d2l1d1r10l10d4l2u1r3d1r1u2l1u1r8l9d3l5u1r6d1r1u2l1u1r7l8d2l3u2l1u1r1l1u2r2d4l1d1r4d1r1u2l1u1r6

;31
      ##
     #  #    #####
    # . .#  #*   *#
     #. .# # $$ $*#
      #  ##  $ $ $ #
     #.   $$ $ @ $ #
    #.     $ $ . $.#####
 # #.  . .#         #  #
### ###########. .  #  ####
 #        #   #######
       ####   #
Solution: d2l3u1l5u1l1d1r1d1l2r3u1r4u2l1d1l3d1l1u3r1u1l1r1d3r4d2r2u2l7r8d1l2d1l1u1r1u1l5d1l1u2r1u1l1r1d2r4d1l6r10d1r2u1l9d1l1u4d3u1r6u1l1r1d1r2u1l1u2r1d5r2u3l1d1l1d1r1l2u3r1d2r1d3l1u1l1u1r1u1r1d2u2l4u1r2u2l1d3r1d1l6d1l1u3d1r4l1u1r1u1r1d2r1d1l4u1l1d1r6u3r1d2r1d1l9u1l1d1r8u4l1d3l1d1r1

;32
    #########
#   #   @   #   #
 # ##.$.$.$.## #
  #  $ $ $ $  #
   # .$.$.$. #
 #  # .$.$. #  #
     #  $  #
 #    #. .#    #
 ####  # #  ####
        #
        #
       ###
Solution: undefined

;33
  #               #
   # ########### #
    #     @     #
#    # $.$.$.$ #    #
 #    # $.$.$ #    #
  #   # .$.$. #   #
       #  $  #
  # #   #.$.#   #
  #      #.#      #
  #       #       #
  #####       #####
      #       #
      #       #
      #########
Solution: 14-3l1d2l1d1l2d1u1r2u1r1u3l7d1r1d2r1d1u1l1u3r6d3l1d1l2u2r1d2u1r2u3l6d3r2d1r2u1r2l2r2u3l2d1r1u1l6d1r1d2r2d1r3l3u1r1l3u3r2d2u2r2l4d3r1d1r2u1l1d1r3u1l1d1l2u4l2d2r1l1u2r6l1d2u2r2d1l1


