;1
#########
#@. * . #
# $.$.$ #
# .$$$. #
# $.$.$ #
# $.$.$.#
#.$.$.$ #
#   .   #
#########
Solution: undefined

;2
###########
#     @  ##
# $#.$$$$ #
# .$.... ##
# $$*$$*$ #
# #.....  #
#    #*   #
###########
Solution: l5d5r2l2u5r5l2d2r4d1u1l5r1d1u3l3d5r3l1u1r2l1u2l1d1r1d2l3u5r7l4d3u1r4d1r1d2l2u1l2r2d1r2u2l1u1l3d1u1r1d1l2u3l3d3r2u1r5d1r1d1l1u2l4u2l3d2r2l2u2r1d1u1r6d3u3l2d1l1u1r3d2l2r2d1r1d2l1u3l2d1r1u1r1d1l1u1l1u2r1d1l1d2r2u1l1r1d1r1d2l2u1d1r2u2l1u1l1u2d3u3r1d1l1d2l1r1u3l6d3r1u1l1u2r6d3l4r6d2l2u2,9-5l1,8-2d2,7-6u1,9-5l1,1-4r2,2-1d1

;3
###########
#     @   #
#$$ .$$*$$#
#..$..... #
# $$*$$*$.#
#  ..*..$ #
# .$  *   #
###########
Solution: undefined

;4
##########
# #      #
#  ..#$* #
###. . # #
#  $ * # #
# $.$@$$ #
####.$.  #
# #   # ##
#  #  #  #
##########
Solution: d1l1u1l1u2d2r1u2d2u2r2d1l1u1l1d1r1d2l1d2r1u4r1u1l2d2u1r1d2r1u1d1r2u1l1d1l2u1l1d1r3u1l1d1l1u1d3l1u1r1u2l1u2r2d1u1l2d2r1u1l4d1r1u1r3d2r2u1l1d1l1u1r3u4l2d4

;5
##########
# #      #
# $..#$* #
# #. . # #
# .$ * # #
# $.$@$$ #
####.$.  #
# #   # ##
#  #  #  #
##########
Solution: undefined

;6
##########
# #      #
# $..#$*.#
# #. . #.#
# .$ * # #
# $.$@$$ #
# ##.$.  #
#  $  #$##
#  #     #
##########
Solution: undefined

;7
##########
# #      #
# $..#$*.#
# #. ..#.#
# .$ * # #
# $.$@$$ #
# $#.$.  #
#  $  #$##
#  #     #
##########
Solution: undefined

;8
##########
# #      #
# $..#$*.#
# #.$..#.#
# .$ * # #
# $.$@$$.#
# $#.$.  #
#  $  #$##
#  #     #
##########
Solution: undefined

;9
##########
# #      #
# $..#$*.#
# #.$..#.#
# .$ * #$#
# $.$@$$.#
# $#.$.  #
# .$  #$##
#  #     #
##########
Solution: undefined

;10
##########
#  @ #   #
#  #   ###
# # $ $ ##
# $.$$   #
# ....$ ##
# *$$*$###
# ....   #
##########
Solution: undefined

;11
##########
#  @ #   #
#  #   ###
# # $.$$ #
# $.$$   #
# ....$  #
# *$$*$###
# ....   #
##########
Solution: undefined

;12
##########
#  @ #   #
#  #   # #
# # $.$$ #
# $.$$$. #
# .... $ #
# *$$*$###
# ....   #
##########
Solution: undefined

;13
##########
#  @ #   #
# $#   # #
#  #$.$$ #
# $.$$$. #
# .... $ #
# *$$*$###
# .... . #
##########
Solution: undefined

;14
##########
#    . $ #
# $#   #.#
#  #$.$$ #
# $.$$$.@#
# *...   #
# *$$*$###
# ....$. #
##########
Solution: undefined

;15
########
#@     #
#$.$.$.#
# $.$. #
# $.$. #
#.$.$$.#
#      #
########
Solution: r5d5l5u1r1d1r1u2d2r2u1l1r2u4d3u1l1d1r1d2l2u1l1u1r1d1r1u1r1u3l2d3l1d2l2u2r1l1d2r4u2l1u2r1u1l3r2d3r1d2l2u1r1d1r1u1l1d1l3u1r1d1r2u5l2d1r1l1d1l1d2r1u2d3r2u3l1r1l1u2l2d3u1r1

;16
############
#...#  #   #
#.*.### $ ##
#...#    $ #
#+  $  #$  #
#  ##      #
#    $#$$$##
#  ##      #
## #   # $##
#   #  #   #
############
Solution: r2l1u2l1u1r1d5r2l2u2r3d3r2l2u2r4l1r2u2l1d2l4d2r4u2l4u2r1d1l1d3r4u2l3r3d2l4u2r1u1l3u1l2d2r1u2l1u1r1d2r4d1r4u2l1d1r1d1l4,5-6u1,6-4l3,2-5u1,1-3r1,7-7u1,8-5l2,5-6u1,6-4l3,2-5u3,5-9u4,6-4l3,2-5u2,9-6l1d1l1u1,8-5l2,5-6u1,6-4l3,2-5u1,9-3l1r1l1d1r1d1l3,5-6u1,6-4l4,1-5u3,8-1d3,9-5l3,5-6u1,6-4l4,1-5u2,6-3r1,8-2d2,9-5l3,5-6u1,6-4l4,1-5u1,9-9u3,10-5l4,5-6u1,6-4l4

;17
############
#...#  #   #
#.*.### $ ##
#...#    $ #
#+. $  #$  #
#  ##      #
#    $#$$$##
#  ##      #
##  $  # $##
#   #  #   #
############
Solution: undefined

;18
############
#...#      #
#.*.# #$$ ##
#...#    $ #
#+. $  #$  #
#. ##      #
#    $#$$$##
#  ##      #
##  $  # $##
#   #  #   #
############
Solution: undefined

;19
############
#...#      #
#.*.#$#$$ ##
#...#    $ #
#+. $  #$  #
# .##      #
#    $#$$$##
#. ##      #
##  $  # $##
#   #  #   #
############
Solution: undefined

;20
############
#...#      #
#.*.#$#$$ ##
#...#    $ #
#+. $  #$  #
# .## $    #
#    $#$$$##
#. ##      #
##  $  # $##
# . #  #   #
############
Solution: undefined

;21
############
#...#      #
#.*.#$#$$ ##
#...#    $ #
#+. $  #$$ #
# .## $    #
# ...$#$$$ #
#. #$      #
##  $ $  $##
# . # #    #
############
Solution: undefined

;22
############
#  .#   #  #
#  ##.... ##
## # . $.  #
#  # .*.*  #
## $  $$####
# $$$$$ .  #
#@  $      #
#   # # #  #
############
Solution: r1u5d5r5l2u4r2l2d4r2u4l1u1r1l1d1l1d4r2u4l2d2r1l1d3u1r2u4d2l1u2d1l1d3r1u2l1u1r1d2r3l4d1l3u2r2u1r2d2l1u2d3l2u1l1u1r2l1d2r2u2l3u3l1u1r1,9-7l5u1l1u1r2d1r1u1l4d3r1u1l1u1r5

;23
############
# ..   .   #
#  ##.*..$##
##*#.. $.  #
#  # **.*  #
#  $  $$####
# $$$#$ .. #
#@$ $    $ #
#   #   #  #
############
Solution: undefined

;24
############
# ..   .   #
#  ##.*..$##
# *$.. $.  #
#$ #.**.*  #
#  $  $$####
# $$$#$ .. #
#@$ $ . $$ #
#.  #   #  #
############
Solution: undefined

;25
############
# ..   .   #
#$ #$.*..$ #
#.*$.. $.$ #
#$ #.**.*. #
#  $  $$####
# $$$#$ .. #
#@$.$ . $$ #
#.  #   #  #
############
Solution: undefined

;26
##########
# #    # #
# . ..$  #
# $$.*$  #
#.$.*..$ #
#$$..*.# #
# .$.$ $ #
# $$+$## #
#        #
##########
Solution: undefined

;27
##########
# #    # #
# . ..$. #
# $$.*$$ #
#.$.*..$ #
#$$..*.# #
# .$.$ $ #
# $$+$## #
#        #
##########
Solution: undefined

;28
##########
#*#    #*#
# $.*..$ #
#.$ $.$. #
# $.*..$ #
# *.$$$. #
# *$$@$$ #
# . .$..##
#*#    #*#
##########
Solution: undefined

;29
##########
#*      *#
# $.*..$ #
#.* $.$. #
# $.*..$ #
# *.$$$. #
# *$$@$$ #
# . .$.* #
#*      *#
##########
Solution: undefined

;30
############
#@  #.  $ .#
# $.$..*.$ #
#.$...$$.. #
# $$$$.$.$ #
# ...$...$ #
# .$$*$$$$ #
#*         #
############
Solution: undefined

;31
############
#@  #.  $ .#
# $.$..*.$ #
#.$...$$.. #
# $$$$.$.$ #
# ...$...$ #
# .$$*$$$$ #
#*   #     #
############
Solution: undefined

;32
############
#@  $. $ . #
# $..$...$ #
# $$$.$$$$ #
# .$...$.. #
# .$$..$$. #
# $..$$..$ #
#          #
############
Solution: undefined

;33
############
#@. $. $ . #
# $..$...$ #
# $$$.$$$$ #
# .$...$.. #
# .$$..$$. #
# $*.$$..$ #
#    #     #
############
Solution: undefined

;34
   #####
 ###   #
## *  $####
#    .$   #
#$*#$##.# #
#  # @$ $ #
#.$##.# ###
#  . .. #
####   ##
   #####
Solution: undefined

;35
   #####
 ###   #
## *  $####
#    .$   #
#$*#$##.# #
#  # @$ $ #
#.$##.# $##
#  . ... #
####   ###
   #####
Solution: undefined

;36
   #####
 ###   #
## *  $####
#    .$   #
#$*#$##.#.#
#  # @$ $ #
#.$##.# $$#
#  . ...  #
####   ####
   #####
Solution: undefined

;37
  #####
  #   ##
### #$ #
#@* .. #
# $$# ###
# # .   #
#  $# # #
#  .* * #
###$# ###
# # $ # #
# . # * #
# $.. * #
#   #   #
#########
Solution: undefined

;38
####
#. #
#*@####
#.* $.#
#.* * #
#.* $ #
#.$ * #
# $ $ ##
# $ .$ #
# $$.. #
#      #
########
Solution: undefined

;39
 ############
 #@.$ .$ .$ #
##  . .$. $ #
# . * *  *. #
# $*$*$*$*$ #
# . * *  *. #
## .$. $. $ #
 # .$ .$ .$ #
 ###   #    #
 ############
Solution: undefined

;40
 ############
 #@.$ .$ .$ #
##  . .$. $ #
# . * *  *. #
# $*$*$*$*$ #
# . * *  .. #
## .$. $.$$ #
 # .$ .$ .$ #
 ### # #    #
 ############
Solution: undefined


