;1
##############
#     #. #   #
#@$$$$#. #   #
#     #..    #
# $$$$# .#   #
#     #..#####
# $$$$#..#
#     #..#
#       .#
#     #  #
#######  #
      ####
Solution: 5-5d2,4-8r3,8-10u6,7-3r3,12-3l4,7-2d4,4-5d2,2-8r5,8-9u5,7-2r1l1d1r3,12-3l4,7-2d3,5-3d4,3-8r4,8-9u5,7-3r3,12-3l4,7-2d2,5-1d6,4-8r3,8-9u5,7-3r3,12-3l4,7-4u2,4-3d4,3-8r4,8-9u5,7-3r3,12-3l4,7-4u1,4-1d6,3-8r4,8-9u5,7-3r3,12-3l4,3-5d2,2-8r5,8-9u5,3-3d4,2-8r5,8-9u4,3-1d6,2-8r5,8-9u3,1-4r3,5-3d4,4-8r3,8-9u2,2-5d2,1-8r6,8-9u1,2-1d6,1-8r6

;2
##############
#     #. #   #
#@$$#  . #   #
# $   #..    #
# $$$ #..#   #
# $   #..#####
# $$$ #..#
# $ $ #..#
# $     .#
#     #  #
#######  #
      ####
Solution: 3-7r1,5-6d1l1d1r3,8-9u5,7-3r3,11-4u1,12-2l1,1-8r6,8-9u5,7-3r3,11-4u1,4-5d2,3-8r3,7-9u5,1-7r3u1r1d1l1d1r2,7-4u2,7-9u3,4-3d4,3-8r3,7-9u1,7-6u3,8-2l1,7-9u2,3-5d2l1d1r5,8-9u5,7-4r1l1u1r3,12-3l4u1l1r1d3l1d1u1r1u3l1d3,1-6r3u1r1d2l1d1r3,8-9u5,7-3r3,12-3l4u1l1d2,11-1d1r1d1l4,7-2d1,10-1d1r1d1l3,5-2r1,1-5r3u1r1d3l1d1r3d1r1u5,1-3r3,5-2d5,4-8r3,8-9u4,2-3d4l1d1r6d1r1u3,2-1d6l1d1r6d1r1u2,3-3d4l1d1r5d1r1u1,3-1d6l1d1r5

;3
##############
#     #. #   #
#@$$#. . #   #
# $   #..    #
# $$$ #..#   #
# $   #..#####
# $$$ #..#
# $ $$#..#
# $  $. .#
#     #  #
#######  #
      ####
Solution: 4-8r3,8-9u5,7-4r1,7-3r3,11-4u1,12-2l1,5-6d1,4-8r3,8-9u5,7-3r3,11-4u1,1-8r6,8-9u5,7-3r3,3-7r1,5-6d1,4-8r2,7-9u7,4-5d2,3-8r3,7-9u6,8-2l1,12-3l4,7-2d4,1-7r3,5-6d1,4-8r3,8-9u5,7-3r3,12-3l4,7-2d3,3-5d2,2-8r5,8-9u5,7-3r3,12-3l4,7-2d2,11-1d1,12-3l4,7-2d1,10-1d1,11-3l3,5-2r1,4-3d4,3-8r4,8-9u5,1-6r3,5-5d2,4-8r3,8-9u4,1-5r3,5-4d3,4-8r3,8-9u3,3-3d4,2-8r5,8-9u2,1-4r3u1r1d4l1d1r3,8-9u1,3-1d6l1d1r5,1-2r1u1r1d6l1d1r3,1-3r3,5-4u1

;4
##############
#     #. #   #
#@$$#. . #.$ #
# $   #..  $ #
# $$$.#..#   #
# $   #..#####
# $$$ #..#
# $ $$#..#
# $  $. .#
#     #  #
#######  #
      ####
Solution: u1d8r3u1r1l2d1l2u8r4d1r3d8u8l3u1l4d8r4u1r1l3d1l2u8r4d1r3d7l1u7d1r3d1r2u1l4d1l1u1r1u1l1r1d1r4u2l1d1r1d1l4u1l1d4r1d2l5d1l2u1r6d1r1u5l1u1r3u1r2d1l4u1l1d3r1d3l7u7r4d6u6l4d8r3u1r3d1r1u5l1u1r3u1r2d1l4u1l1d2r1d4l3u3l2d2r1d2l2u1r5d1r1u5l1u1r3u1r2d2l1u1l3d5l5u3r1d2l1d1r4d1r1u5l1u1r3d1r2u1l1d1l1u1l2d5l4u3r1u2l2d4r1d2l2u1r5d1r1u5l1u1r3d1r2u1l4u1l1d1r5u2l1d1r1d1l4d5l4u2r1d1l1d1r3d1r1u5d4l4u3l1u2r2u1r1l1u1l2d6r1d2l2u1r5d1r1u4d3l7u2r3u1r1d2l1d1r3d1r1u3d2l7u3r3l1u2r2d4l1d1r3d1r1u2d1l5u3l2u2r1l1u2r2d6u1l2d2r6d1r1u1l5u2l1d1l1d1r6l4u5r1d4l1d1r2l4u4r3d1r1u2l2u2l1d2l1d1r3

;5
    ######
   ##    ###
  ##       #
 ##       $##
## $$$$  #.@#
#     #  #$ #
#.. ###  $. #
# . #  $$$ ##
#. ##     ##
# ..#..  ##
###    ###
  ######
Solution: d2l3d1l1u1d3r1u6d3r2d1l1u1l1u3l5d2r2u2l1u1r1d3l3d2r1u1l1u2r1u1r2d2l2u1l1d4l1d1r1u4r3u1l1u1l1d1r1d1l1u1l1d1r1d1l1u1l1d2u2r4u2r2d1l3u1l1d1r1d1l1u1l1d1r1d1l1r1u3r4u1l1u1l1d2r1d1l2u1l1d1r1d1l1u1l1d4u4r6d2l1u1r1u1l4u1l1d1r1d1l1u1l1d2u2r5d3u4r2u1l3u1l1d2r1d1l2u1l1d1r1d1l1u1l1d1u1r5d4l2u1r1d1r1u2r2d1l1u1l1d2r1d1l2r2u5l1d4r1d1l1r1u3r3u2l1d1r1d1l1d1l2u1r1l1u4r2d1

;6
  #######
 ## #. .###
##  #. .  ##
##  $..... #
#   #$ .  ##
# #  $ . ##
## .  ####
#    #  @###
# ##.  . ..##
#  #$$# $#  ##
#   $   $ $  ##
## ## $ #. . ##
#   $ $ $ ## #
#   #$$$$$  ##
##          #
 ############
Solution: l1d3u2l3u1l3d3r1d4r7l2u5d5l5u5l1u2r3d1r2u1r2d1r2d2l1d1r1u3l2u1l2d1l2u1l3d3r1d4r5u4r2d1r1u2d1l3d4r2u2d2l7u5l1u2r3d1r2u1r2d1l1d2r1u1l1u1r1d2l1d4l5u5l1u2r3d1r2l2u1l3d2r1d5r5u4l2u1d1l1u3l1u4r3d1r1u2d2u1l4d2r2u1d1l2u2r3d1r1u1d1l2d1l2d2r1u1l1u1r1d1r1u2d1l2u2r2u1r1d1l1d1r1l1d1r1l2d4u1d2r3d4l2u3d3r2u5r1u2l2d1l1d1l1u3l1u1r1d1r1u2d1l2u2r5l5d4r1d1r2u1r2d3l1d4l2u5d1r3u3l2d1l1d1l1u3l1u1r1d1r1u2d1l2u2r4l2d3l2d1l2d3r3l2d4r3u5d1r3u3l2d1l1d1l1u3l1u1r1d1r1u2d1l2u2r3l1d3l1d4l2d2r2l1d2r2u5d1r3u3l2d1l1d1l1u3l1u1r1d1r1u2d1l2u2r2d3l1d4r3d2l1r1d2l2u5d1r3u3l2d1l1d1l1u3l1u1r1d1r1u4d4l1d4r3d1l1d1l1u3d1r3u3l2d1l1d1l1u3l1u1r1d1r1u3d3l1d4r1d4r1u3r1u1l1d1l1u2d1r3u3l2d1l1d1l1u3l1u1r1d1r1u2d2l1d4r3d4r2u2l3d1l1u4d1r3u3l2d1l1d1l1u2l1u2r2d1l1d4r3d4r2u1l3d1l1u5d1r3u3l2d1l1

;7
  #######
 ## #. .###
##  #. .  ##
##  $..... #
#   #$ .  ##
# #  $ ..##
## .  ####
#   $#   ###
# ##.  .$..##
#  #$$# $#@ ##
#   $   $  $ ##
## ## $ #. . ##
#   $ $ $ ##.#
#   #$$$$$  ##
##          #
 ############
Solution: r1d1l1d1r1u1r1d1u1l2u2l2u1l2d1r3l2d2r3u1r1d1l3u1l1u1r1l4u1l1u2r4l4u2r3d1r1u2d3l2u1d1l2u2r3d1r1u1d2l4d2r1u1l1u1r1d1r1u2d1l2u2r2u1r1d1l1d1r1d1l1d1l1d1l3r3d1r3d2l2u1d1l1u4l1u1r1d1r1u2d1l2u2r5l3d3l1d3r1d1r2u2l2d1l1u3l1u1r1d1r1u2d1l2u2r4l2d3l3d1l1d3r1d4r3u5d1r2u2l2d1l1u3l1u1r1d1r1u2d1l2u2r3l1d3l1d1l3d3r3l2d4r3u5d1r2u2l2d1l1u3l1u1r1d1r1u2d1l2u2r2d3l1d4l2d2r2l1d2r2u5d1r2u2l2d1l1u3l1u1r1d1r1u4d4l1d4r3d2l2d2l2u2r1l1d2r2u5d1r2u2l2d1l1u3l1u1r1d1r1u3d3l1d4r3d1l1d1l1u3d1r2u2l2d1l1u3l1u1r1d1r1u2d2l1d4r1d4r4u2l3r3d2l4u5d1r2u2l2d1l1u3l1u1r3l2d5r1d4r1u3r1u1l1d1l1u2d1r2u2l2d1l1u2l1u2r2d1l1d4r2d4r2u1r1u1l3d1l1u4d1r2u2d2l3r3u2l2r2d4l1d2r1u5

;8
#######
#    @#
#$.$$ #
#.$.$ #
#.$.$ #
##  ..#
 #. $ #
 ######
Solution: d4l3r1u1l1u1d2r3u4l4d1u1r4d5l2r2u5l2d3l1d1r2l1u4r2d3l1r1u1l1r1u2l1d3

;9
  #########
  #@.   $ #
###  $.#  #
# . $$.$$ #
# #$.#$.$ #
# ..$...$ #
###   #   #
  #########
Solution: r1d2l3d2r2d1r2u1l2u2r1u2l1d1r1d1l1u2r3d2l2u1l1d2u1r3d1r1d1l1u2l2u1r1d1r1d1r1d2r2u2l1r1d1l2r2u3l1d2r1d1l1u2l1r2u2l4

;10
  #########
  #@.$. $ #
###  $.#$ #
# . $$. $ #
# #$.#$.$ #
# ..$...$ #
###   #   #
  #########
Solution: r1d2l3d2r2d1r2u1l2u2r1u2l1d1r1d1l1d2r4u2l3u1l1d2u1r3d1r1d1l1u4l1r1d2l2u1r1d1r2d3r2u2l2u1l1d1r3u3l2r2d2l2r2d2l1r1u4l1d2r1d1l1

;11
  #########
  # .$. $ #
###. $.#$ #
# . $$.@$ #
# #$.#$*$ #
# ..$...$ #
###   #   #
  #########
Solution: l1u2l1r1d2u1l2d1l3d2r2d1r2u1l2r3u2l3d1u1r3d2r1d1r2u1l3r3u2l2r1d1r1d1l2r2u4l2r1d3r1d1l1

;12
###########
#         #
# $####$# #
#@ $  . . #
# ##.##$$ #
# #.$#  ###
# . $.$. .#
# # $ $#$.#
#   #..$. #
# $      .#
###########
Solution: d3r2d3r2u3l2r2d3r4u3l1r1d2l2r2u2l1d1r1d2l6u1l2u7r8d2l2r2u2l8d7r2d1r6u3l3r3d3l6u1l2u7r8d2l2d2l1d1r2l1u3r2d1u1l2d2l1d1l1d3r2u1r1d1r1u1l1u1d2l3u1r1l1u2r1d1u1l2r1d3l2u3r3u1r1u2r2d1l1u1l1d2l1d2l1d2r3u3l2r1u3r2u2l2d4l1d2l1d2r1u1r1l2d1l2u1l2u7r6d4l1d2l1d2r2u1l1d1l3u2r2l2d1l2u7r6d4l1d2l3d1l2d1r7l7r2u3r1u1d2l1d1l2u5r6l6u2r1d1l1d1r4

;13
###########
#         #
# $####$# #
#@ $  . . #
# ##.##$$ #
# #.$#  ###
# ..$.$. .#
# # $ $#$.#
# $ #..$. #
# $ .  $ .#
###########
Solution: undefined

;14
 ########
 #      ##
 #  $$   ##
## $.$.$  #
# .*.#... #
#  $+$.$.##
### $$$. #
  #     ##
  #######
Solution: undefined

;15
 ########
 #      ##
 #  $$$. ##
## $.$.$. #
# .*.#... #
#  $+$.$*##
### $$$. #
  #     ##
  #######
Solution: undefined

;16
 ########
 #      ##
 #  $$$. ##
## $.$.$. #
# .*.#.*. #
#  $+ .$*##
### $$$. #
  #     ##
  #######
Solution: undefined

;17
        ######
        #    #
######### ## #
# @$ $ $ $   #
# $ $ $ $ ####
#            #
### # # # ## #
#........    #
##############
Solution: d1l1d1r1u1r1d2u1r2d2l3r5u2l2u1l2d1l2u2r1d1l1d1r1u1r1d2u1r2d2l2u3r2d1r2u1l4d1l2u2r1d1l1d1r1u1r1d2u1r6u1l6d1l2u2r1d1l1d1r7u1r1d2u1r3d2l7r4u4r3u2l3d5u2d1r3d2l6r1u2l1u2r3u2r3d2l2r2u2l3d5u1r3d2l5u2l3u2r5u2r3d2l2r2u2l3d5u1r3d2l4r1u2l8u2r8u2r3d2l2r2u2l3d5u1r3d2l3

;18
        ######
        #    #
######### ## #
# @$ $ $ $   #
# $ $ $ $ ####
#  $ $ $  .  #
### # #.#.## #
#........    #
##############
Solution: undefined

;19
     #######
 #####     #
 #      #  #
## $ $ $#$ #####
# . . .    $.*.#
#  #$$#$#  $+$ #
# .#. . .# $.$.#
##     #########
 #######
Solution: d1r1l1u2r1l1d2r1u1l1u1l2d2r1l1u1r1u1l1u3l4d3r5l4d1u1l5d3r4u1r1u2l2d1u1r2d2l1d1l2u1r1u2l1d1u2l1u1l1d3u3r4d1l3u1l1d1r4u1r1d1u2r3d3l5r5u2l1d1r1d1l3

;20
      ####
     #    #
    #  $.$ #
   # $ .$.  #
  # $ $$+$ $ #
 # $.. ...$ . #
#    $ $.$    #
######$### ####
   # ..   ..#
   ##########
Solution: d1r2l4d2u2r4d3l4r4u3r1d1r2u1l1d1l1r1u2l1u1l1d4,9-8r1,10-3u1l1u1l3d2r2d3r1,10-7u2r1u2l1d1r1d2l3u1l2d1r3,11-5l1d2,8-5r1,4-6r1u1r1d2,11-5l2,8-4d1,10-4l1,8-3d1,9-6l2,7-5r1,5-6r2,7-3d1r1d1u1r2d2l4u1l2d1l2u1r1u1r1u1r1d1r2u1r1d1l3u2r1d1l1d1r2l1u3r1d1l1d1l2d1l1d2r4

;21
      ####
     #    #
    #  $.$ #
   # $ .$.$ #
  # $ $$+$ $ #
 # $.. ...$ . #
#    $ $.$ .  #
######$### ####
   # ..   ..#
   ##########
Solution: d1l2d2u2r4d3l4u3r2d1r1u1r1d2u1l2u1l2d3r4l4u2r3u1r1d2u2l6d1r1u1r1d2u1r4u1d1r2u1d1l1r1u1l1d1l6r3u3r1d2l2r3d1l1u1d1r3u2l1d1l5d1l4u1r9u2d2l3u2l2d1l1d1r1u2r1l1u1l1d2u1l1d1r2u1r3d2r2u1l2u1l1d1u1l2u2r3d3u1l3d1r1u1r2d1r2u1l1u1l1u1l2d1

;22
      ####
     #    #
    # $ .$ #
   # $ .$.$ #
  # $ $$+$.$ #
 # $.. ...$ . #
#    $ $.$ .  #
######$### ####
   # .. $ ..#
   ##########
Solution: undefined

;23
#############
#@# # # #   #
#   . . #   ##
# .$*$$$*$*. #
##.$. $ . * ##
# .$. ..* *. #
#  $$$. $$$.##
##. . . . .  #
# $$$$$$$$$$ #
#  . . . . . #
#   #  #  #  #
##############
Solution: undefined

;24
#############
#@# # # #   #
# . . . # $ ##
# .$*$$$*$*. #
##.$. $ . * ##
# .$. ..* *. #
#  $$$.$$$$.##
##. . . . .  #
# $$$$$$$$$$ #
#. . . . . . #
#   #  #  #  #
##############
Solution: undefined

;25
#############
#@# # # #   #
# . . . # $ ##
# .$*$$$*$*. #
##.$. $ . * ##
# .$. ..* *. #
#  $$$.$$$$.##
##. . . . .  #
# $$$$$$$$$$ #
#.$. . . . ..#
#   #  #  #  #
##############
Solution: undefined

;26
#########
#.      #
#*@$ ## #
#.* $.# #
#.* * # #
#.* $ # ##
#.$ * #  #
# $ $ ## #
# $ .$ # #
# $$.. . #
#      # #
##########
Solution: 3-3u1,3-3l1,3-4l1,3-10u1,1-9r3,3-7d1,3-3r1,6-8l1,5-4l2,5-6l1u1,4-9l1,3-7u3,4-3l1,3-6l1,1-7u1,1-9r1d1r2u1r2l1d1l3u1r2l1u4r2d2l1u1l1d2u2l2d3r2l2u1r1d1r1u2l1d1l1u1r1u1r1u4r1u1l2

;27
#########
#.      #
#*@$$## #
#.* $.# #
#.* * # #
#.* $ # ##
#.$ * #  #
# $ $ ## #
# $ .$.# #
# $$.. . #
#      # #
##########
Solution: 3-3u1,4-1l1,4-8r1,3-3l1,3-4l1,3-6l1u2,1-7u1,3-8l1u3,2-10u4,1-9u2,5-6l1,3-5d2,2-9r2,3-7d1l1,4-6r1d1u1l1d1l1u4d3r2u1l1,3-4d1,3-3r1d2,4-1d2,3-5d1,4-9r2,2-9r2,3-6d2,2-9r1,3-1l1

;28
#########
#.   .  #
#*$$$## #
#.*@$.# #
#.* * # #
#.* $ # ##
#.$ * #  #
# $ $ ## #
# $ .$.# #
# $$.. . #
#      # #
##########
Solution: undefined

;29
#########
#.   .  #
#*$$$## #
#.*@$.# #
#.* * # #
#.* $ # ##
#.$ * #  #
# $ $ ## #
# $ .$.# #
#.$$..$. #
#      # #
##########
Solution: undefined

;30
#########
#.   .  #
#*$$$## #
#.*@$.# #
#.* * # #
#.* $ # ##
#.$ *.#  #
#.$ $ ## #
#$$ .$.# #
#.$$*.$. #
#      # #
##########
Solution: undefined

;31
  #############
###.   .   .@ #
#  $   $   $  #
# $ $.$.$.$ $ #
#  $   $   $  #
# .$. .$. .$. #
## .   .   .  #
 ## ##   ######
  ### ####
Solution: 2-2d1,3-3u1,2-5r1,6-4u2r1u1l1,10-4u2,11-1l1,12-4l1d1,10-3d1,12-2d2,11-1d1,8-1r2,8-5l1,7-3d2,9-3l1,8-1d3,4-1r2,2-3d1,3-3d2,3-3r1,12-3l2

;32
  #############
###.   .   .@ #
#  $   $   $  #
# $#$.$.$.$#$ #
#  $ $ $ $ $  #
# .$. .$. .$. #
## . . . . .  #
 ## ##   ######
  ### ####
Solution: undefined

;33
  #############
###.   .   .@ #
#  $ $ $ $ $  #
# $#$.$.$.$#$ #
#  $ $#$#$ $  #
# .$. .$. .$. #
## . . . . .  #
 ## ##. .######
  ### ####
Solution: undefined

;34
  #############
###.   .   .@ #
#  $ $ $ $ $$ #
#  #$.$.$.$#  #
# #  $#$#$  # #
# .$.$.$.$.$. #
## . . . . .  #
 ## ##.$.######
  ### ####
Solution: undefined

;35
  #############
###.   .   .@ #
#  $ $ $ $ $$ #
#  #$.$.$.$#  #
# # $$#$#$ .# #
# .$.$.$.$.$. #
## . . . . .  #
 ## ##.$.######
  ### ####
Solution: undefined

;36
##########
#@       #
# $#$$$$ #
# $....$ #
# $$#.$$ #
 #...#.# #
#   ..   #
##########
Solution: undefined

;37
############
#@       # #
# $#$$$$   #
# $....$ # #
# $$#.$$ # #
 #...#.# # #
#   ..$.   #
########  ##
       #  #
       ####
Solution: undefined

;38
############
#@       # #
# $#$$$$ . #
# $....$ # #
# $$#.$$ # #
 #...#.# # #
#   ..$. $ #
########  ##
       #  #
       ####
Solution: undefined

;39
############
#@       # #
# $#$$$$ . #
# $....$ # #
# $$#.$$.# #
 #...#.#$# #
#   ..$.   #
########$ ##
       #  #
       ####
Solution: undefined

;40
#############
#@          #
# .$#.$# $# #
#   #  #  # #
# $$$$$$$ $ #
#   #  #.#$ #
# ......... #
##         ##
 ###########
Solution: undefined

;41
#############
#@          #
# .$#.$#$$# #
# $ #$.#..# #
# $  $ $$   #
# $ #$ #.#$ #
# ......*.* #
##         ##
 ###########
Solution: undefined

;42
   #######
  ##  @  #
  # $$$ ##
### .$.  #
# $$.$.$ #
# # #.#. #
#   . .$###
### . .$  #
  ##     ##
   ##### #
       ###
Solution: undefined

;43
   #######
  ##  @  #
  # $$$$##
### .$.$ #
# $$.$. .#
# # #.#. #
# . . .$$##
### . .$  #
  ##      #
   ##### ##
       ###
Solution: undefined

;44
   #######
  ##  @  #
  # $$$$##
### .$.  #
# $ .$.$.#
# # #.#. #
# .$. .$$##
### .$.$. #
  ##      #
   ##### ##
       ###
Solution: undefined

;45
######## ########
  #    # #    #
  #    # #    #
  #  $## ##$  #
  #  $ # # $  #
  #  $ ### $  #
  ##$   .   $##
  # $  . .  $ #
  # $#.#+#.#$ #
  # $.......$ #
  # $ . . . $ #
  #           #
  #############
       ###
Solution: u2r2u2r1l1d2r1u1r1u2r1u1l1d3l2u1r1d1r1u2d2l2d1l5r2l1u2l1r1d2l1u1l1u2l1u1r1d3r2u1l1d1l1u2d2r2d6l3u2r3l3d1r2d1r8u3d1l3r3u2l2u1l1d3r1d1l2r1u1r3d1l2u1l1u2l2d2u2l2d2l3u2r2l2d3r2u1r1u2l2d1l1d1r2l1u2r1u2l1d3l1d1r1,10-9l1,12-7d1,13-9l3,12-5d3,13-9l1,12-1d3,13-5l2,10-4d4,10-2r1d4,12-7l1u1l1d1,6-5d2,4-1d2l1r1d1l1d1r2u1r1d2l1d1r2,8-6d1,13-2l1u1l1d5,12-7l3,7-7r1,6-2l1d4,4-7r2,4-1d3l1d1r2u1r1d1l1d1r2

;46
######## ########
  #    # #    #
  #    # #    #
  # $*## ##*$ #
  #  $ # # $  #
  #  $ ### $  #
  ##$.  .  .$##
  # $  .$.  $ #
  # $#*#*#*#$ #
  # $....+..$ #
  # * . . . * #
  #           #
  #############
       ###
Solution: undefined

;47
######## ########
  #    # #    #
  # .$ # # $. #
  # $*## ##*$ #
  # .$ # # $. #
  #  $ ### $  #
  ##$.$ + $.$##
  # $  .$.  $ #
  # $#*#*#*#$ #
  # $.......$ #
  # * . . . * #
  #           #
  #############
       ###
Solution: undefined

;48
######## ########
  #    # #    #
  # .$ # # $. #
  # $*## ##*$ #
  # .$ # # $. #
  #  $ ### $  #
  ##$.$ + $.$##
  # $  .$.  $ #
  #.$#*#*#*#$.#
  # $.......$ #
  #.*$.$.$.$*.#
  #           #
  #############
       ###
Solution: undefined

;49
######## ########
  #    # #    #
  # .$ # # $. #
  # $*## ##*$ #
  # .$ # # $. #
  #  $ ### $  #
  ##$.$ + $.$##
  # $  .$.  $ #
  #.$#*#*#*#$.#
  # $.......$ #
  #.*$.$*$.$*.#
  #     .     #
  #############
       ###
Solution: undefined

;50
######## ########
  #    # #   ##
  # .$ # # $. #
  # $*## ##*$ #
  # .$ # # $. #
  #  $ ### $  #
  ##$.$ + $.$##
  # $  .$.  $ #
  #.$#*#*#*#$.#
  # $.......$ #
  #.*$.$*$.$*.#
  #     .     #
  #############
       ###
Solution: undefined

;51
      #
 ###########
 #.#.#. .#.#
 # . # #$# #
 #  $  # * #
 #  $  . # #
## $$$$$ # ##
 #   #@  $ #
 # # #$  $ #
 # #$. $ $ #
 # # # # . #
 #. .#.#.#.#
 ###########
      #
Solution: u4d4r2u4d6u1d1r1l1u2r1d1r1u5d7u2d1u1l1d1u1l2u1l1d3u1r1u1r1d2u1l2u4l1u1l2d1l1u2d4r1l1u3r3d1l1u1l2d3r2u4d7u4l1u2l1d6u4r3u1r1d3r1d1l1r1u3

;52
      #
 ###########
 #.#.#. .#.#
 #...#.#$# #
 # $$  # * #
 #  $  . # #
## $$$$$ # ##
 #   #@  $ #
 # # #$$ $ #
 #$#$. $ $ #
 # # # # . #
 #. .#.#.#.#
 ###########
      #
Solution: undefined

;53
      #
 ###########
 #.#.$. . .#
 #...#.$$#.#
 # $$  # *.#
 #  $  . # #
## $$$$$ # ##
 #   #@  $ #
 # #$#$$ $ #
 #$  . $ $.#
 # #$#$# ..#
 #. . . .#.#
 ###########
      #
Solution: undefined

;54
      #
 ###########
 #.#.$. . .#
 #...#.$$#.#
 # $$ $# *.#
 #  $  . # #
## $$$$$ # ##
 #   #@ .$ #
 # #$#$$ $ #
 #$  . $ $.#
 # #$#$# ..#
 #. . . .#.#
 ###########
      #
Solution: undefined


