;1
##     #
###  ####
#+####. #
#  #    #
#.$$ $* #
# .$.  ##
#. $ $.#
# $$$  #
#.  # .#
########
 ##
Solution: 2-3d1r1,2-6r1u1,6-5u2,3-5l1,1-6u3,4-3d1,5-5l3,1-6u1,3-8u1l1,1-6d1,5-7l2,2-8u1,3-5d1l1,4-4r1,6-3d4,5-8u2,3-5r2,6-3d1,6-4d1,2-4r3,4-7l1,2-8u2,4-7u1

;2
##     ######
###  ####   #
#+####. $   #
#  #    #   #
#.$$ $* #.  #
# .$.  #### #
#. $ $.#. . #
# $$$  $ $  #
#.  # .#    #
#############
 ##
Solution: undefined

;3
##     ######
###  ####   #
#+####. $  ##
#  #    #  ##
#.$$ $* #. .#
# .$.  #### #
#. $ $.#. . #
# $$$  $ $$ #
#.  # .#    #
#############
 ##
Solution: d4u3r1d1l1d2r1u1r3d1r1l2u2d2u1l3d3u5d3r2l2d2r1u1l1u2r2d1l1d1l1u4r1d2r1d1l1u1l1d2u1r2u1r1u1l2r2d1r1d1l3d2r1u2r1u1l1r1u2r1d1u1r2d1l2u1l1d1l1d2u1d1r3u3d3l1u1r1u2l2d1r1d2r1d2l1u1r1u2l1u1l2d2r2l2r2u3r2u1r2d2r2d4l3u1l2d1l1u2l2d1u3r1u1r3d1l1d3u1l3u2r2d1u1l2d2r2d1r2l2u4r2u1r2u1r1d2u1l3d1l2d4r3u1r3u2l1r1d4l1u1l1d1l1u1l3u1l2d1r7d1r1u3

;4
##     ######
###  ####   #
#+####. $   #
#  #    # $##
#.$$ $* #. .#
# .$.  #### #
#. $ $.#. . #
# $$$  $ $$ #
#.  # .#   .#
#############
 ##
Solution: undefined

;5
##     ######
###  ####   #
#+####. $   #
#  #    # $##
#.$$ $* #. .#
# .$.  #### #
#. $ $.#. . #
# $$$  $$$$ #
#.  # .#.  .#
#############
 ##
Solution: undefined

;6
##     ######
###  ####   #
#+####. $   #
#  #    # $##
#.$$  * #. .#
#$.$.$ #### #
#.$$  .#. ..#
# $ $  $$$$ #
#.  # *#.  .#
#############
 ##
Solution: undefined

;7
##     ######
###  ####   #
#+####. $   #
#  #    # $##
#.$$ $* #. .#
#$.$.$ #### #
#.$$  .#. ..#
# $ $  $$$$ #
#. .# *#.  .#
#############
 ##
Solution: undefined

;8
   #######
####  #  ####
#  # $$$ #  #
#     #     #
#  *  #  *  #
#*#*## ##*#*#
#  * . . *  #
# #$ $#$ $# #
# . $.+.$ . #
#    . .    #
#############
Solution: undefined

;9
#########
#@ #  # #
# $$  ..####
# $  #*.   #
#    $..$$ #
##$$#$.. ###
# .... . #
# ....#  #######
# $$ $ $ $ $ $ #
#  #   #       #
################
Solution: undefined

;10
#########
#@ #  # #
# $$ $..####
# $  #*.   #
#    $..$$ #
##$$#$.. ###
# ...... #
# ....#  #######
# $$ $ $ $ $ $ #
#  #   #       #
################
Solution: undefined

;11
#########
#@ #  # #
# $$ $..####
# $  #*.   #
#   .$..$$ #
##$$#$.. ###
# ......$#
# ....#  #######
# $$ $ $ $ $ $ #
#  #   #       #
################
Solution: undefined

;12
#########
#@ #  # #
# $$ $..####
# $ .#*.   #
#  ..$..$$ #
##$$#$.* ###
# ......$#
# ..*.#  #######
# $$ $ $ $ $ $ #
#  #   #       #
################
Solution: undefined

;13
#########
#    #  #######
##$..$. #  #  ##
# $  $  # .$ . #
#  . ..##  $.$##
##  .   ##.  * #
# $..$. #  .   #
# $  $  $$.  * #
#   #  $ @$ $ ##
#########  # ##
        ######
Solution: undefined

;14
#########
#    #  #######
##$..$.$#  #  ##
# $  $ $...$ . #
#  . ..##  $.$##
##  .   ##.  * #
# $..$. #  .   #
# $  $  $$.  * #
#   #  $ @$ $ ##
#########  # ##
        ######
Solution: undefined

;15
#########
#    #  #######
##$..$.$#  #  ##
# $  $ $...$ . #
#  . ..##. $.$##
##$$.$ .##.$ * #
# $..$. #  . . #
# $  $  $$.$ * #
#. .#  $ @$ $ ##
#########  # ##
        ######
Solution: undefined

;16
#########
#    #  #######
##$..$.$#  #  ##
# $  $ $...$ . #
#  .$..##. $.$##
##$$.$ .##.$ * #
# $..$. #  . ..#
# $  $  $$.$ * #
#. .#  $ @$ $ ##
#########  # ##
        ######
Solution: undefined

;17
#########
#    #  #######
##$..$.$#  #. ##
# $  $ $...$ . #
#. .$..##. $.$##
##$$.$ .##.$$* #
# $..$.$#  . ..#
# $  $  $$.$ * #
#. .#  $ @$ $ ##
#########  # ##
        ######
Solution: undefined

;18
#########
#    #  #######
##$..$.$#  #. ##
# $  $ $...$ . #
#. .$..##. $.$##
##$$*$ .##.$$* #
#.$..$.$#  . ..#
# $  $  $$.$ * #
#. .#  $ @$ $ ##
#########  # ##
        ######
Solution: undefined

;19
#########
#    #  #######
##$..$.$#  #. ##
# $  $ $...$ . #
#. .$..##. $.$##
##$$.$ .##.$$* #
# $..$.$#  ....#
# $  $  $$.$ * #
#. .#  $ @$$$ ##
#########    ##
        ######
Solution: undefined

;20
###################
#@    #     #     #
#     #     #     #
# .#$.#.$#. #$.#. #
# .$ .#. $. # .$. #
#  $  #  $  #  $  #
# .# .#  #  #  #  #
#  $  $  $  $  $  #
# .$ .$ .$ .$ .$  #
###################
Solution: undefined

;21
###################
#@    #     #     #
#     $     $     #
# .#$.#.$#. #$.#. #
# .$ .#. $..# .$. #
#  $  # .$ .#. $  #
# .# .#..# .#. #  #
# $$$ $ $$$ $ $$$ #
# .$ .$ .$ .$ .$  #
###################
Solution: undefined

;22
###################
#@ #  #  #  #  #  #
#     $     $     #
# .#$.#.$#. #$.#. #
# .$ .#. $..# .$. #
# $$.## .$$.#. $$ #
# .# .#..# .#. #. #
# $$$ $ $$$ $.$$$ #
# .$ .$ .$ .$ .$  #
###################
Solution: undefined

;23
###################
#@ #  #  #  #  #  #
#.$   $     $     #
# .#$.#.$#. #$.#. #
# .$ .#. $..# .$. #
# $$.## .$$.#. $$ #
# .# .#..# .#. #. #
# $$$ $ $$$ $.$$$ #
# .$ .$ .$ .$ .$  #
###################
Solution: undefined

;24
   #######
  ##     ######
### . . . #   #
#   $.$. $. $ #
# ..$$$$$ #.$.#
# $$..$...#$$ #
###   @   #   #
  #############
Solution: undefined

;25
   #######
  ##     ######
### .$. . #   #
# . $.$. $. $ #
# ..$$$$$ #.$.#
# $$..$...#$$ #
###   @   #   #
  #############
Solution: undefined

;26
   #######
  ##  .  ######
###..$.$. #   #
# . $+$.$$. $.#
# ..$$$$$ #.$.#
# $$..$.*.#$$ #
###   .   $   #
  #############
Solution: undefined

;27
#################
#    #.         #
#    #.         #
#   $$          #
#   @#######    #
#    #     #$$  #
#    #.$.$.# ####
#### #  $  # .. #
#  .  .$.$.#    #
# .$ #     #    #
# $$$#######    #
# .$.           #
#    #######    #
#################
Solution: undefined

;28
#################
#    #. . .     #
#    #. . .     #
#   $$     $$   #
#   @#######    #
#    #     #$$  #
#    #.$.$.# ####
####$#  $  # .. #
#  .  .$.$.#    #
# .$ #     #  . #
# $$$#######$$  #
# .$.           #
#    #######    #
#################
Solution: undefined

;29
#################
#    #. . .     #
# $$ #. . . $.$.#
# ..$$     $$$$ #
# $$@#######    #
# . .#     #$$  #
#    #.$*$.# ####
####$#  $  # .. #
#  .  .$.$.#    #
# .$ #     # .. #
# $$$#######$$  #
# .$.        .. #
#    #######    #
#################
Solution: undefined

;30
#################
#    #. . .     #
# $$ #.$.$. $.$.#
# ..$$ . . $*$$ #
# $$@####### . .#
# . .#     #$$  #
#  $ #.$*$.# ####
####$#  $  # .. #
#  .  .$*$.#.$$ #
# .$ #     # .. #
# $$$#######$$$ #
# .$.   .    .. #
#    #######    #
#################
Solution: undefined

;31
###
#@##
#  ##
# $ ##
#  $ ##
#  .$ #
#  $.$##
# $$.$ #
# ...$.####
#  $$$.$. #
#  ....$. #
#         #
###########
Solution: undefined

;32
###
#@##
# .##
# $ ##
# .* ##
# *.$ #
# .$.$##
# $$.$ #
# ...$.####
# $$$$.$. #
# $.*..$* #
#         #
###########
Solution: undefined

;33
###########
#@##      #
# .##.$*$ #
# $ ##  . #
# .* ##.$ #
# *.$ #*  #
# .$.$## ##
# $$.$ #  #
# ...$.## #
# $$$$.$. #
# $.*..$* #
#         #
###########
Solution: undefined

;34
###########
#@##      #
# .# .$*$.#
# $ # .$. #
# .* # .$ #
# *.$ # . #
# .$.$# $$#
# $$.$ #  #
# ...$.## #
# $$$$.$. #
# $.*..$* #
#         #
###########
Solution: undefined

;35
###########
#@##      #
# .# .$*$.#
# $ # .$. #
# .* #..$ #
# *.$ $ . #
# .$.$# $$#
# $$.$ #  #
# ...$.## #
# $$$$.$. #
# $.*..$* #
#         #
###########
Solution: undefined

;36
######################
#          @         ###
#.**$ .***$.**$ .***$  #
#.$ .$.$ .$.$ .$.$  .$ #
#.$ .$.$ .$.$ .$.$  .$ #
#.**$ .$ .$.$ .$.****$ #
#.$   .$ .$.$ .$.$ .$  #
#.$   .***$.**$ .$  .$ #
#         .$           #
#.$.$ .$.***$.***$######
#.$.$ .$.$ .$.$   #****#
#.$.*$.$   .$.$   ###*##
#.$.$.*$   .$.*$  ##*###
#.$.$ .$.$ .$.$   #*####
#.$.$ .$ .*$ .***$#****#
#                 ######
########################
Solution: undefined

;37
#########
#@$   . #
# #.$ $ #
#.# $ # #
# .$$## #
# .  .  #
#########
Solution: undefined

;38
############
#@$   .    #
# #.$ $ $$ #
#.# $ #$#  #
# .$$##... #
# .  .  ####
#########
Solution: undefined

;39
############
#@$   .    #
# #.$ $ $$ #
#.# $ #$#  #
# .$$##...$#
# .  .. $# #
#######$ $ #
     #. . .#
     #######
Solution: undefined

;40
############
#@$   . .  #
# $.$.$ $$ #
#.# $$ $#. #
# .$$ $.. $#
# . $.. $# #
#######$.$.#
     #. . .#
     #######
Solution: undefined

;41
    ####
    #  ### ####
    #    ###  ###
  ###+.   .$ . .#
###..###.# $    ##
#  $ . $ #.$ . . #
#  $.#$$$#  ######
#  $ # $ . ##
### .#.###$####
  #    . .  $ #
  #         $ ##
 ##$$$$### $$  #
##.   .# ##    #
#      #  #   ##
########  #####
Solution: undefined

;42
    ####
    #  ### ####
    # $  ###  ###
  ###..   .$ *$.#
###..###.# $ $  ##
# .$ . $ #.$ . . #
#  $.#$$$#  ######
# .$ # $ . ##
### .#.###$####
  #  $ . .  $ #
  #  $      $ ##
 ##$$$$### $$  #
##. . .# ##  @ #
# . . .#  #   ##
########  #####
Solution: undefined

;43
    ####
    #  ### ####
    # $  ###  ###
  ###..   .$ *$.#
###..###.# $ $  ##
# .$ . $ #.$ . . #
#  $.#$$$#  ######
# .$$# $ . ##
### .#.###$####
  #  $ . .  $ #
  #  $    $.$.##
 ##$$$$### $*  #
##.$.$.# ##.$+ #
# . . .#  #   ##
########  #####
Solution: undefined

;44
    ####
    #  ### ####
    # $  ###  ###
  ###..   .$ *$.#
###..###.# $ $  ##
# .$ . $ #.$ . . #
#  $.#$$$#  ######
# .$$# $ . ##
### .#.###$####
  #. $ * .  $ #
  #  $    $.$.##
 ##$$$$### $*  #
##.$.$.# ##.$+ #
# . . .#  #   ##
########  #####
Solution: undefined

;45
#############
#@          #
#           #
#   $$###$  #
#   #. . $  #
#  $#.$.#.  #
#   $$*     #
#  .#.$.#.  #
# # $...#   #
#   ###$$ # #
#           #
#############
Solution: undefined

;46
#############
##         @#
##  $$#$#$  #
##  #. . $. #
## $#.$.#.  #
##  $$* ..###
## .#.$.#.  #
### $...# $ #
#   #$#$$ # #
#           #
#############
Solution: undefined

;47
#############
##         @#
##  $$#$#$$ #
##  #. . $. #
## $#.$.#.$ #
##  $$* ..###
## .#.$.#.  #
### $...# $ #
#  .#$#$$.# #
#           #
#############
Solution: undefined

;48
#############
##         @#
## .$$#$#$$ #
## .#. . $. #
## $#.$.#.$ #
##  $$* ..###
## .#.$.#.$ #
### $...# $ #
# $.#$#$$.# #
#           #
#############
Solution: undefined

;49
##########
##@   #  #
#  *$. .##
# ## $   #
# * .##$.#
#  .$.$. #
#  $  $  #
## # $####
#  #  .  #
##########
Solution: undefined

;50
##########
##@   #  #
#  *$. .##
# ## $   #
# * .##$.#
#  .$.$. #
#  $  $  #
## # $#$##
#  #  . .#
##########
Solution: undefined


