;1
#######
#   ..#
#.#$# #
#. *  #
# #$# #
#$  # #
#  $  #
## @ ##
 #####
Solution: undefined

;2
#########
#  .....#
#@  # $ #
### #$# #
  # $ # #
  #$# $ #
  #     #
  #######
Solution: r2u1r4d5l4u4d4r4u5l4d5r2u4d4r2u5l2r2d5l4u5r2l2d1l2u1r2d5r2u4r1l1d4r2u4d3l1d1l1u4d2l1r1d2l2u4

;3
#########
# ... #@#
# ## $# #
# ## $. #
#  $ $  #
# ####  #
#       #
#########
Solution: 4-4r1,6-3d1,6-3d1l1r1u1l1d1l1u1,5-1d1,4-3u1r1u1l2r1d3r2u1l1d1l1u2r1u1l1d2r3d3l6u2r3l3d2r5u2r1u1l2r1d3l5u2r4l1u2d2l3d2r5u2

;4
###########
# ......  #
# #$###  @#
#   $  $###
# # # # #
# $$#$# #
#       #
#########
Solution: 7-4u2r1u1l5,3-3u1d1r3,7-4u2,8-1l3,5-6u2,4-3r2,7-4u2,8-1l2,3-6u2,2-3r4,7-4u2,8-1l1,1-5r1,3-6u2,2-3r4,7-4u2

;5
#########
#  .. *.##
#  .# #  #
##   $ # #
 # # # # #
 # $$  $@#
 ###   ###
   #####
Solution: u3l1u1l4d2u2r4d1r1d3u3l1u1l4d2l1d1u1r1u2r3l1r2d1r1d3l2d1l2u1d1r2u3l2r1u2l1r1d2r1d3l2u1r2l1r1u2l1u2l2d1l1d3r2d1r2u3l3u1l2u1r2d2r3l1r1d3l2u1l2u3d1r4d3l2u2d2r2u3l3r3d3l1r1u1l1d1l1u1r2u2l1u2r2d1r1d3l2u2l3u2r3l3d1l2u1r4l2d2r3d3l2u1l2u2r1u2l2d1r1d3r2u1d2r2u3l3r1d2l2u3l1u1r2l1d4r2d1r2u1l1d1l1u2d1r2u2l3r1d2l2u3l1u1r1

;6
#########
#.  #  .#
##. $ .##
#.  $  .#
###$@$# #
  # $ # #
  ## ## #
  # $   #
  #    ##
  ######
Solution: d1r1u2l3r4u2d2l1r1u2l1d1l2d1l1u1r1u1l1r1d1r1d2r1u1l1u1r1d1r1u1l1u1r1l1d4l2u2r1u1l1r2d1r2d4l2d1l2u1r1u4r3d4l1d1u1l1d1l1u4l1u2r2l2d1r3

;7
#######
#   . #
# #$# #
# $@$ #
# # #.#
# .   #
#######
Solution: u1d3r2u4l2d4l2u2r1l1d2r4u4l2d3u3r2d4l2u2r1l1u2r2d2l4u2r2

;8
#######
#..#..#
#  .  #
# $.$ #
# # # #
# $@$ #
# # # #
# $ $ #
#  #  #
#######
Solution: u2d4l1d1l1u6d1r1l1d4r3d1r1u6d5l2u4d4r2u4l1u1l1,2-3u1,3-4u1l1u1r1d1r1u1,5-5l1,3-6u3,1-5r1l1d2r2u3

;9
########
#.   @ #
#.#$$$ #
#.   $ #
#.# # ##
#.  $ #
# # ###
#   #
#####
Solution: r1d2l1d2l2r1l2r1d2l2u4d2r4u2r1u2l3d3u3r3d2l1d2l3r1d2l2u2r4u3r1u1l4r3d1l1u1l1d3u2r2d1l3r3d2l3

;10
#########
#.      #
# ##$##.#
# #  $ .#
# # # #.#
#  $@$  #
### #$  #
  #.  ###
  #####
Solution: undefined

;11
########
#.     #
#.##$$ #
#.## $@#
#  # $ #
#   $  #
#. .####
#####
Solution: d2l3d1l2u2r1d1l1d1r1u1r4u4l2d3,5-5l3d1l1u3,6-4l1,4-3d1r1d1l3d1l1u2,6-3l1u1r1u1l4r2d3r1d1l3u1l1d1

;12
#########
#. ##   #
# $ $   #
#  # ####
# @# #
# $#$###
#.   ..#
########
Solution: u1l1u2r1d1r3l1d3u3l3d4r4l4u2r1d1l1d1r3u4r1u1r2d1l5u1l1d3r1u1l1u1r4u1r2d1l5d1l1u1d3

;13
##########
#. ##.  .#
# $ $ $  #
#  # # ###
# @# # #
# $#$# #
#.    .#
########
Solution: undefined

;14
##########
#  . . . #
#  # # # #
## #$$$# #
 # $ # $ #
 #  .@.  #
 #########
Solution: l1r2l2r3l1u3,5-1r1,8-4l1,6-3d1,5-5r1,4-4u2,3-1r1,6-3l1,4-2d2l1,2-5u3,1-1r1,8-5l1

;15
##########
#  . . . #
#  # # # #
## #$$$# #
 # $ # $ #
 # # @ # #
 # # # # #
 # .   . #
 #########
Solution: undefined

;16
###########
#  . . .  #
#  # # #  #
## #$#$# ##
 #   $   #
 # # @ # #
 #   $   #
## #$#$# ##
#  # # #  #
#  . . .  #
###########
Solution: undefined

;17
##########
#.      .#
# #$##$# #
# $ ## $ #
#        #
##  ..####
####..  ##
#        #
# $ ##@$ #
# #$##$# #
#.      .#
##########
Solution: undefined

;18
#########
#.     .#
# ## ## #
# ##$## #
#  $ $  #
#$ #.# .#
#. #.# $#
#  $@$  #
# ##$## #
# ## ## #
#.     .#
#########
Solution: undefined

;19
#########
# $ .  @#
#.#$#   #
# $ $ ###
# # #.#
# .   #
#######
Solution: undefined

;20
#######
#.   .#
# # $ #
# $ # #
# #  $#
# #$# #######
#.   .@.   .#
####### #$# #
      #$  # #
      # # $ #
      # $ # #
      #.   .#
      #######
Solution: undefined

;21
#######
#.   .#
# # $ #
# $ # #
# # $ #
# #$# #######
#.  . @ .  .#
####### #$# #
      # $ # #
      # # $ #
      # $ # #
      #.   .#
      #######
Solution: undefined

;22
#############
#.   .#.   .#
# # $ # $ # #
# $ # # # $ #
# # $   $ # #
# #$# # #$# #
#.   .#.   .#
### ##### ###
#.   .#.   .#
# #$# # #$# #
# # $   $ # #
# $ # # # $ #
# # $ # $ # #
#.   .#.   +#
#############
Solution: undefined

;23
#############
#.   .# .  .#
# # $ # #$# #
# $ # # $ # #
# # $ # # $ #
# #$# # $ # #
#.  . #.   .#
####. @   ###
   # $#$#.#
   #    $ #
   # #$## #
   #.    .#
   ########
Solution: undefined

;24
#############
#   . #     #
# #$# #.#$# #
# $ $ #   $ #
# # #.# #$#.#
# .   @ .   #
####.# # ####
   # $ $ #
   # #$#.#
   # .   #
   #######
Solution: undefined

;25
#############
#   . #    @#
# #$# #.#$# #
# $ $ #   $ #
# # #.# #$#.#
# .   * .   #
####.# # ####
   # $ $ #
   # #$#.#
   # .   #
   #######
Solution: undefined

;26
##########
# $ .#   #
# $ .$$$ #
# $ .# # #
#  #.# # #
#  #.#   #
##  .#@###
 #######
Solution: 6-1d2u1l2d2u3l1d1r1d4l2u1l1u3r2u1r1d4u3l3r1d1r1u1r1d2u1l3d2r1u1l1u1r2u1r1d1u1l3u1r2d1r3u1r2d1l5u1l1d2u1r2l3d3r1u1l1u1r2u1r5d3l2u2d2r2u3l3

;27
   #######
   #   . #
   #.#$# #
   # $ $ #
#### # #.####
#  .  *   . #
#.#$# # #$# #
# $   @   $ #
# #$# # #$#.#
# .   *  .  #
####.# # ####
   # $ $ #
   # #$#.#
   # .   #
   #######
Solution: undefined

;28
   #######
   #   . #
   # #$# #
   # $ $ #
#### # #.####
#  . . .    #
#.#$# # #$# #
# $   @   $ #
# #$# # #$#.#
#    . . .  #
####.# # ####
   # $ $ #
   # #$# #
   # .   #
   #######
Solution: undefined

;29
    #######
    #   . #
    # #$# #
    #.$ $ #
##### # #.#####
#   .  *   .  #
#.#$#  #  #$# #
# $   *@*   $ #
# #$#  #  #$#.#
#  .   *  .   #
#####.# # #####
    # $ $.#
    # #$# #
    # .   #
    #######
Solution: undefined

;30
    #######
    #   . #
    # #$# #
    #.$ $ #
##### # #.#####
#   .* *   .  #
#.#$#  #  #$# #
# $   *@*   $ #
# #$#  #  #$#.#
#  .   * *.   #
#####.# # #####
    # $ $.#
    # #$# #
    # .   #
    #######
Solution: undefined

;31
#########
#  ...  #
#  # #  #
# $$@$$ #
#  #$#  #
#  .*.  #
#########
Solution: undefined

;32
########
#.     #
#  .#  #
## $$$ #
 # .#  #
 #  #. #
 # $$$ ##
 #  #.  #
 ####@ .#
    #####
Solution: r1u4l1u1r1u2l3d2r2l2u2r3d6l1d1r1l1u2r1u3l4d2r1u2l1d4r1u2l1u2r4d3l1u1,3-6r1,5-5d1r1u3l1d1u2r1u1l4

;33
########
#@     #
#  .#. #
## $$$ #
 # .#. #
 # $*$ #
 # .#. #
 # $$$ ##
 # .#.  #
 #      #
 ########
Solution: undefined

;34
 ######
## ...##
# $ # .#
# $  #.#
# $#  .#
# @$$$ #
##    ##
 ######
Solution: 4-6u1d1r1u1r1u3l1u1l2d2r1d1u1l1u2r2d1r1d3l1d1l3u1l1u2d1u1,4-4r1d1r1u2d1,1-2r1,3-3u1,2-1r2,4-6u1,2-5r2,5-6u1,4-3d1r1,6-5u1,3-5r1,5-6u1,4-4r1,1-3r1l1d2r1u2l1u1r1l1d2r1d1r2u2l1u1l1u1r1l1d1l1d2r1u1l1u1r1d1r1u1

;35
###########
#.  $     #
#.##$###  #
#.  $ ##  #
#.     #  #
#.# # $$$ #
#.#    #  #
#.  $  #  #
#. #$###  #
#.  $    @#
###########
Solution: l1u6,5-9l3u2r1u1r2u2r1d1r1,8-4d3,6-7l1u4l3d1l1u1r1,5-1l3r2d2r1d4l3r1u3l2d3r2u1r2u2l3u1l1d2u1r1,4-9u1,5-7l3,6-7u1,7-5l1,5-6u1,6-4l4,1-3d1,8-1d3,9-5l3,5-6u1,6-4l2,3-5u1,4-3l2,8-9u3,9-5l3,5-6u1,6-4l4

;36
   ########
   #@     #
####$#### #
#   $  ## #
#.#     # #
#.#.## $$ #
#.      # #
#.   $  # #
#.###$### #
#         #
###########
Solution: 7-4d1,3-3r1,4-1d2,5-4l1u1l1d2,4-6l1,6-3l1,4-2d1,3-6l1,1-7u2,5-4l1,3-3d3,4-7l2,1-6d1,6-7l1,5-9u2,6-6l4,1-7u1,3-7r1,5-8u1,6-6l4,9-5l2,6-4d1,7-7u1l3,3-5d1,4-7l2,8-5l1,6-4d1,6-7u2,7-4l3,3-3d1

;37
###########
#   @     #
# ##$#### #
#.  $   # #
#.#    $$ #
#.#.#$  # #
#.#     # #
#.    $ # #
#.####$## #
#         #
###########
Solution: undefined

;38
############
#          #
# ######## #
#. $ $ $ $ #
#.##   # # #
#.#### # # #
#.#  # $ $ #
#.     # # #
#.###### # #
#         @#
############
Solution: undefined

;39
############
#          #
# ######## #
#.  $  $ $ #
#.#   ## # #
#.# #### # #
#.#$ $ $ # #
#.       # #
#.######## #
#         @#
############
Solution: undefined

;40
###########
#         #
# ####### #
# $     $ #
# #$$@$$# #
# # ### # #
#.#  #  #.#
#.  . .  .#
###########
Solution: undefined

;41
#############
#           #
# ######### #
#.$       $ #
#.#$$@$$#$# #
#.# ### # # #
#.#  #  # # #
#.   .     .#
#############
Solution: undefined

;42
     ######
   ###    #
####   ## #
#.  $#$  .#
#.#$ @ $#.#
#.  $#$  .#
# ##   ####
#    ###
######
Solution: l1d1u1r2u1d1l2d1l3d2r2l2u2r2u1d1l2d2r3u1r2u1r3u2l2d1u1l1d1l3d1l2d2r3u1r2u1r2l2d1l2d1l3u2r2u1r3u1r3u2l3d3,6-6u1,7-5u1d1l1d1l2d1l3u2r2u1r3u1r2l2u2r3d2u2l3d4r1u1l1u1r2l2d3l2u1d1r2u2l2r2u2l2d1l2r2l1d1u1r1u1r2d4l2u1l2r2d2l3u2r2u1,5-4l1u1l1d1r1d1l2

;43
####         ####
#  ###########  #
# $ .   +   . $ #
# #$#$ $#$#$ $# #
# # # # # # # # #
# # # # # # # # #
# #   # #   # # #
#.    . . .    .#
#################
Solution: l3r8l2r2l4d4r1d1l5r4u5l4d1u1r2l2r4d5l4u1l2d1r6u5l4d4u4r4d5l4u1l2d1l2u6d1r3,7-2d4,8-7l1,15-2l6,13-4u1,12-2r2,15-1d5,11-4u1,10-2r1,4-2r1,3-4u1,4-2l2,1-1d5,7-2l2,5-7r2,3-7r2

;44
####
#. #########
#. #   #   #
#.$ $  $   #
#. # ####$##
#.## ##   #
#.  $ $ $ #
#  #  #   #
####.@#####
   ####
Solution: u1l1r1u1d1l1u1l3u2r1u1r2u1r2d1r2l2u1l2r2l2d4u4r2d1l1u1l1d1l3u2r1d1l1d1r3u1r2d1l4d1l1u2d4r3u2d2l3u3r3u1r2d1l4d1l1u1r3d3r1d2l1u1r1u1l3d1l1u2d1r3u3r4u1r2d1l4r3d2l2d1l5d1l1u1d1r1u1r2u4r2d1l1u1l1d5r1u1r2d1r2u3d2l7r2u3r4u1r2d1l8

;45
####       ####
#. #########. ##
#. #   #   #   #
#.$ $  $   $   #
#. # ### ### ###
#.## ##   #   #
#.  $ $ $ $ $ #
#  #  #   #  .#
####.@#########
   ####
Solution: 4-7u1l3u2r1u1r2u1r2d1r2u1r2d1r2d2l1d2r1u5d1l2u1l2d3r1d1r3u1r1d1l4u1l2d1r4,5-6r2,4-4d3,6-3l1,4-2d1,2-1d1,1-3r4,7-3l5,1-4u2,4-5u1,5-3l3,1-4u1,9-6l7,1-7u2,13-6l11,1-7u1,10-3l8,14-3l5u1l1d3r1d1l7

;46
####
#. #
#. #########
#.$        #
#. ####$## #
#. #     $ #
#. $     # ##
# @##$####  #
####      $ #
   #     ####
   #######
Solution: u4r8d4r1d1l4r3u5l3d2l1d1l4u3l1u2r1d1l1d1r1,4-3l2d1l1u2d1,8-6l1,10-5l2,7-6u2,8-3l6,1-4u1,1-7u3,7-6l5,1-7u2,5-8l1r1u1,6-6l4,1-7u1,7-8l1,5-9u2,6-6l4

;47
####
#..#
#..##########
# $        .#
#  ####$##  #
#  #   $ $$ #
# $$     #  #
#.@##$####..#
#### $   $..#
   #     ####
   #######
Solution: u1r2l3u2r1u2,6-6l4,1-7u5,10-8l2,10-6u2,11-3l9u1l1d4,8-5l2r1u1,6-3r4,8-5r1,10-4d2,10-8u3,6-8r4,4-8r2l1,2-6u2,3-3l1,1-4u1,4-5r1,10-3d2,5-5r1,7-6u2,8-3l5,2-4u1,5-8u2l1u1r1,6-8r3,10-5d1,5-5r5,11-4d2

;48
############
#.        .##
#  ####$## .#
#  #   $ $$ #
# $$     #  #
#.@##$#### .#
#### $    .##
   #.   .###
   #######
Solution: u1r1l1u1d1r2u1r2d1l4u1l1d1r1u1d1r6u1l2,10-2d1l2,4-6r2,5-4d2,4-7r3,8-6l2,5-5d1,6-7l1,10-3d2,6-3r4,11-2d2,7-1d1,6-3r4,11-4u1,4-3r2,7-4u2,6-1r3,2-3u1,3-1l1

;49
############
#.        .##
#  ####$##  #
#  #.  $ $$ ##
# $$    .#  .#
#.@##$####$  #
#### $    $  #
   #.   .#. .#
   ###########
Solution: undefined

;50
     ######
   ###    #
#### $ ## #
#. $ # $ .#
#.#  @  #.#
#. $ # $ .#
# ## $ ####
#    ###
######
Solution: undefined

;51
############
#@......   #
# #$#$## # #
# #    $ # #
# $    # # #
# ##$#$# # #
#          #
############
Solution: 4-6u2,6-3r1,8-4u2,7-1r1,5-3u1,4-1r1,3-3u1,2-1r1,5-1l2,7-1l2,3-3r4,10-1l3,8-4u2,9-1l1,1-4r2,4-5u1,5-3l1,3-4u2,6-6u2,7-3l1,5-4u2

;52
#######
#.   .#
# ### #
#  $  ####
# ### #  #
# $ $    #
#.#@#.#$.#
# $ $    #
# ### #  #
#  $  ####
# ### #
#.   .#
#######
Solution: undefined

;53
########
#  #   #
#.$ $  #
#.@# ###
#. $$ #
#. #  #
####  #
   ####
Solution: l1u2r1d1r2d2u2l3d2r1l1u2r3d2l2r2u2l3d2r1u1d1r2u2l2u1l1d1r3u1r2d1l4r2d2r1d2l1u1r1u1l3

;54
############
#  #.  $   #
#.$ $  #  .#
#.@# ###  ##
#. $$  $$ #
#. #  ##  #
####  ##. #
   ########
Solution: l1u2r1d1r2u1r4d3u3l1r1d4u4l4d3r3l3u3r4l4d3r4d1r1u1l5u2l3d2r2l2u3r1d1r2u1r4d3l6u1l1d1u2d2r3u2l2u1l1d1r1d1u1r2u1r2d1l4r2d2r1d2l1u1r1u1l3r7l1u2r2u1l5r3d3r1u1l1u1r1

;55
##### ###
#  .###.#
# #. $ .#
# #.$@$.#
# ##$ $ #
#  # $  #
##     ##
 #######
Solution: d1r1d1r1u3d3l1d1l2u1r1d1r1u1r1l2d1l1r1l1,4-2r1,3-3r1,5-2r1,5-4u1r1,6-2l2,3-3u1,4-5u2,5-2l1,7-4l2,4-5u1,5-3l1

;56
### ###
#.###.#
#..$..#
# $ $ #
# $ $ #
## $  #
 # @ ##
 #####
Solution: l1u1r1u2l1d1l1u2d1r1d1r2l1d2r1u1r1u3l3r1d1r1l1d2r1u1r1u1d1l1u1d3l2u3

;57
#######
#.#@#.#
#..$..#
# $ $ #
# $ $ #
#  $  #
## $ ##
#. $ .#
# $ $ #
#. * .#
#######
Solution: d1l2d3r1d2l1d2r3l1u1l1u1l1d1r1u1d1r1d1r1l2u4r1u1l1d1l1u3d2r2u1l1d1l1u1r2d1r1l2d5r2l2u5r2l1d1l1d2r2l1d2u2r1u1l1u1l1d1r1d1l1d1r1u4l1u2d2r2d1u1d1r1u3d2l2u1r1d1r1u1l3u1r1d5r1u3r1u1l2d1l1u1d5r1d1r1u4r1u1l1u1l1d5

;58
#######
#.#@#.#
#..$..#
# $ $ #
# $ $ #
#  $  #
## * ##
#  $  #
# $ $ #
# $ $ #
#..$..#
#.###.#
### ###
Solution: undefined

;59
#######
#.#@#.#
#  $  #
# $.$ #
# $.$ #
#  $  #
##. .##
### ###
#  $  #
# # # #
#  $  #
#.###.#
### ###
Solution: d1l2d3r1d1r1d2l2d2r3l3u2r4d2l2r2u2l2d1u1r2d2l3r1u2l2d2u2r2u2r1u1l1u2d1l1d1l1u3r3l1d3r2u3d1l1d2u3l1d1u1l2d1r1

;60
   ### ###
   #.###.#
   #..$..#
#### $ $ ####
#..  $ $  ..#
##.$$ $ $$.##
 #$  $@$  $#
##.$$ $ $$.##
#..  $ $  ..#
#### $ $ ####
   #..$..#
   #.###.#
   ### ###
Solution: undefined

;61
#######
#.#@#.#
#  $  #
# $.$ #
# $.$ #
#  $  #
##. .##
 #####
Solution: d1l2d3r1d1r2u1l1u1l1d1l1u3d2r2u1d1l2u2r3l1d3r2u3d1l1d2u3l1d1u1l2d1r1

;62
########
#    . #
#.# ## #
# # $  #
# $ @# #
# ##$#.#
#      #
########
Solution: l1u3r3d2l2d1l1u1r3d3l2u2l1u1r1d1l1u1r2,6-2d2,3-3u1,2-1r2,3-4l1,1-5u2

;63
########
#    . #
#.#$#  #
# #  $ #
# $ @# #
# ##$#.#
# .    #
########
Solution: l1u1r2u2l4d5r5u3l3u1d2u1,2-1r1,3-4l1,1-5u2,4-4d1,5-6l2,6-1d3,3-1r1

;64
 ############
##   ....   #
#  $ $ $ $  #
# # # ### #.#
#  $  $  $ .#
# # ### # #.#
#  $ $ $ $  #
##   ....  @#
 ############
Solution: l3u1r1,6-6r1,4-6r1,2-6r1,10-4l1u2,6-2r2,4-2r2,2-2r2,10-1l6,3-3d1,5-3u1,8-2l2,4-1r2,5-3u1,6-1r1,4-1r2,10-2l4,5-3u1,4-1r1,2-1r2,7-4r3,11-5u1,5-4r5,9-6r1,11-7u1,7-6r1,9-5d1,5-6r1,7-5d1,3-4d2r3,8-7l1,7-5d1,2-7r2,10-7l1

;65
#############
#    ...    #
#  $ $ $ $  #
#.# # # # #.#
#. $ $ $ $ .#
#.# # # # #.#
#@ $ $ $ $  #
#    ...    #
#############
Solution: 4-6l1,6-6l1,8-6l1,10-6l1,4-2l1,6-2l1,8-2l1,10-2l1,9-6u2,7-6r3,11-7u3,9-2d3,8-6r1,7-2r1,9-3u1,10-1l1,5-2r4,3-2r4,1-2r4,9-1l5,7-3d3,6-7r1,9-6r1,11-7u1,3-3d1r7,3-6l1,1-7u3,3-6u1,4-4l2,5-6l3,1-7u1,7-6l1,5-5d1,4-7r1,9-7l1,7-2l1,5-1d5,9-2l1,7-3u1,11-2l5,5-3u1,4-1r1,2-1r2

;66
#########
#... ...#
#  # #  #
##$ $ $ #
#  # #  #
# $ $ $##
#  # # #
##  @  #
 #######
Solution: 2-4u2l1u1r3d2r2u2l4,2-6u4,6-6u1l2u3,5-1r1l2,6-5u3,7-1l1,7-4u2,2-5r3,6-6u4

;67
###############
#             #
# # # # # # # #
# $ $ $ $ $ $ #
# # # #.# # # #
# $ $ $+$ $ $ #
# # # #.# # # #
#  .........  #
###############
Solution: d2l6u2r1,3-4d2,2-7r1,5-5r1,7-4d2,8-7l1,7-5r1,9-4d2,10-7l1,9-5r1,11-4d2,12-7l1,5-5l1,3-4d2,3-3r1,5-2d4,13-5l1,11-4d2,11-3l1,9-2d4,9-3l1,7-2d4,5-3r1,7-2d3,1-3r5,7-2d2,13-3l5,7-2d1

;68
###############
#             #
# # # # # # # #
#  $ $   $ $  #
# # # # # # # #
#  $ $ + $ $  #
# # # # # # # #
#   .......   #
###############
Solution: 3-2d1,4-3r1,5-4d2,4-7r1,2-5r1,3-3d3,2-7r1,3-5r1,5-4d2,11-2d1l2d3,10-7l1,12-5l1,11-3d3,12-7l1,11-5l1,9-4d2,9-3l1,7-2d4,5-3r1,7-2d2

;69
#######
# .   #
# #$  #
# # #.#
# $@$ #
#.#$# #
#   . #
#######
Solution: u2,2-1r1,3-4r1,5-5u1,3-4d1,2-6r1,3-4l1,1-3d1,5-1l2

;70
#######
# .   #
# #$$.#
#.  # #
# $@$ #
# #$#.#
# .   #
#######
Solution: u2d1l2r2d1u2,4-1l1,3-4l1,1-5u1,3-4d1,4-6l1,3-4r1,5-3d1,3-2r1

;71
#######
#.   .#
# # $ #
# # # #
# $@$ #
# #$# #
#.   .#
#######
Solution: l1,1-5u3,3-4d1,4-6l2,3-4r1,5-3d2,3-2r1,5-3u1

;72
#######
#. . .#
# $ $ #
# # # #
# $@$ #
# #$# #
#.   .#
#######
Solution: l1r1u3l2d3u3r2d1l1r1d2l2u2r2u1r2d1l1u1l2d1l1d2r2u2d2l2d1u1r2u2r2d4l2u2r1l3u2r4d3u3l3u1r2d1r1d2l2u2

;73
#########
#      .##
# #####. #
# $ $ $. #
# # # #. #
# $ $ $. #
#   . # @#
##########
Solution: undefined

;74
#########
#      .##
# #####. #
# $ $ $. #
# # # #. #
# $ $ $. #
#     # +#
##########
Solution: undefined

;75
#########
#      .#
# #####.#
# $ $ $.##
# # # #..#
# $ $ $. #
#     # @#
##########
Solution: undefined

;76
  #####
 ##   ##
##. $ .##
#  $@$  #
# $#$#$ #
# .. .. #
#########
Solution: undefined

;77
###### ###
#.   # #.#
# # $### #
# ## @$  #
#  $  ## #
# ###$ # #
# ###  # #
#.      .#
##########
Solution: undefined

;78
########
# .. ..#
#  # # #
##$#$#$##
## $@$  #
#.  $  .#
#########
Solution: r1d1l3r5u1l1d1l4u3l1u1r3d3l1d1l1u3l1u1r1d3r3d1r2u1l4d1l1u3d3r4u3

;79
###########
#. . + . .#
# $#$#$#$ #
#  $ $ $  #
#    #    #
###.   .###
  #######
Solution: l4d3r2l1r1l2u3r3d3u1,5-5l1,6-1d3,5-5r1,8-3u1,7-1r1,8-3l1,6-4u2,5-1r1,6-3l1,4-4u2,3-1r1,4-3l2u1l1u1r1,1-4u2

;80
###########
#. . + . .#
# $# # #$ #
#  $ # $  #
#   $#$   #
##   $   ##
 ##.   .##
  ##   ##
   #####
Solution: 6-3d2,5-6r1,4-3d2,5-6l1,8-3u1,7-1r1,8-3l1,6-4u2,5-1r1,2-1d2,4-3l2,2-5u1,6-5l1,4-6u1,1-4u1r1,1-1d1,4-5u3,3-1r1,4-3l1,2-4u2,1-1r1,1-4u2

;81
###########
# .. . .. #
#  # # #  #
#.$ $ $ $.#
#  $ $ $  #
### $#$ ###
 #.  $  .#
 ##  +  ##
  #######
Solution: l1u1r3u2l1d1r1d1l4r2,6-2d4,7-7l1,8-4u2,9-1l1,2-2d1r2d1,4-6u4,3-1r1,3-5u1,4-3l1,1-4r1u2,1-1r1,6-3r1,8-4u2,4-3r4,3-5u1,4-3l2,6-4l2,3-5u1,4-3l1,2-4u2

;82
 ########
##      #
#  $.$  #
#.## ##.#
# $ @ $ #
#.## ##.#
#  $.$  #
#      ##
########
Solution: d2l1r1u2r2,7-3d1,4-2r2,7-1d1,3-4l1,1-5u1,2-2r1u1r1d3,4-6u3,3-6l1,1-7u1,6-6l1

;83
  #######
###     #
#  $.$  #
#.## ##.#
# $ @ $ #
#.## ##.#
#  $.$  #
#     ###
#######
Solution: undefined

;84
#########
#  .    #
# ##$##.#####
# $   $     #
# #  +# #   #
#.#$#$# #####
#   .   #
#########
Solution: undefined

;85
#########
# .     #
# ##$## #####
# $ + $     #
#.#   #.#   #
# #$#$# #####
#   .   #
#########
Solution: undefined

;86
      ####
      #  #
      #  #
      #  #
    ####$####
    #   *   #####
#####  #.#  #   #
#   $$..@..$$   #
#   #  #.#  #####
#####   *   #
    ####$####
       #  #
       #  #
       #  #
       ####
Solution: undefined

;87
  #####
 ##   ##
##  $  #####
#  #.# #   #
# $.+.$    #
#  #.# #####
##  $  #
 ###$###
   #  #
   #  #
   #  #
   ####
Solution: undefined

;88
      ####
      #  #
      #  #
      #  #
    ####$####
    #   *   #####
#####  #.#  #   #
#   $$..@..$$   #
#   #  #.#  #####
#####   *  ##
    ####$###
       #  #
       #  #
       #  #
       ####
Solution: undefined

;89
#########
# .     #
# #$# #.#
# #@# $ #
# # # # #
# $   # #
#.###$# #
#     . #
#########
Solution: 5-3r1,7-4u1,5-5d1,4-7r1,3-5l1,1-4d1,3-3u1,4-1l1

;90
#########
#       #
# ###$# #
# #   # #
# *   *.#
# #   # #
#@###*# #
#       #
#########
Solution: undefined

;91
#########
#       #
# ###*# #
# $   # #
# ##@ ..#
# $   # #
# ###*# #
#       #
#########
Solution: 5-7u2,4-4r2,5-1d2,4-4r1,1-3r3,5-4u1,1-5r3,5-4d1

;92
##########
#  #     ##
# $#$ $ @ #
#  # $#$# #
# $#$ $   #
#........ #
###########
Solution: undefined

;93
#####
#@  #####
###.    #
# .##$$ #
# .   # #
# * $   #
###*### #
  #     #
  #######
Solution: undefined

;94
###########
#   ...   #
# ##$@$## #
# $  #  $ #
# #  #  # #
# #     # #
# #$###$# #
#   ...   #
###########
Solution: undefined

;95
######
#.  .#
# $# #
#  # #
#@$# #
# $  #
# $# #
#. #.#
######
Solution: undefined

;96
#########
#.  .  .#
# $# #$ #
#  # #  #
#@$# #$ #
# $ . $ #
# $#.#$ #
#. #.# .#
#########
Solution: undefined

;97
###########
#.       .#
# #$####  #
# #    @# #
# $ ### # #
# #   $$  #
# ###   # #
# ####### #
#.       .#
###########
Solution: undefined

;98
#########
# ..... #
# $   $ #
# $#@#$ #
#   $   #
# ##$## #
#   .   #
#########
Solution: undefined

;99
#########
#.     .#
# $   $ #
# #$@$# #
# $ # $ #
##.. ..##
 #######
Solution: undefined

;100
#########
#.     .#
# $   $ #
###$ $###
# $ # $ #
# ..@.. #
#########
Solution: undefined

;101
#######
#    .##
#.## $ #
#.#@ # #
#.$$$$ #
#     .#
########
Solution: undefined

;102
#########
#@ .....#
#  ######
## #    #
 # #    #
 # #$$$$##
 # $     #
 #  ##   #
 #########
Solution: undefined

;103
###########
# ...     #
# ##$ #$# #
# $  @  $ #
# #$# $## #
#     ... #
###########
Solution: undefined

;104
#########
#.. . . #
# $ $ $ #
#@$##$# #
# $ $ $ #
# . . ..#
#########
Solution: undefined

;105
#########
#.. . . #
# $ $ $ #
#*@$#$#*#
# $ $ $ #
# . . ..#
#########
Solution: undefined

;106
####
#  #####
#      #
#.###$ #
#.#  $ #
#+#  $ #
#.#  $ #
#.###$ #
#      #
#  #####
####
Solution: undefined

;107
  #####
###   #
#   $ #
#   $ #
##### #
  #.#$##
  #.# @#
  #   .#
  #   ##
  #####
Solution: undefined

;108
    #####
    #   #
    # # #
##### # #
#   $   #
#  $#$######
### $ @....#
 #  ########
 #  #
 #  #
 ####
Solution: undefined

;109
 #########
##...... #
#   # $  #
# # $ #  #
# $ #  $ #
###  $  ##
  #$  ###
  #@###
  ###
Solution: undefined

;110
#######
#.   .#
##$$$##
 # $ #
 #.@.#
 #####
Solution: undefined

;111
###########
#.   #   .#
##$ $# $ ##
## $ #$ $##
#.   #   .#
###  *  ###
  ##.@.##
   #####
Solution: undefined

;112
 #####
##   #
# $  #
# #$.#
#.$@##
# #$.#
# $  #
#.  .#
######
Solution: undefined

;113
#######
#.   .#
# $#$ #
#  $ ##
#.#@ ##
# #$#.#
# $ $ #
#.   .#
#######
Solution: undefined

;114
 #######
##     ##
#    $  #
# $###  #
#  # # ##
##$# # #
 # ### #
 # $ # ##
 #    $ ##
 ##@.....#
  ########
Solution: undefined

;115
    #######
#####     #
# $   ### #
# ###   $ #
# $   ### #
# ###   $ #
# $   ### #
# ### ... #
# ..      #
##### @####
    ####
Solution: undefined

;116
 #####
 #   #
 # # ####
 # $ $  #
#### ## #
# .* *. #
#   @   #
##  #  ##
 #######
Solution: undefined

;117
  #####
  #@  ###
  # $   #
####$## #
# .* .* #
#       #
##  #  ##
 #######
Solution: undefined

;118
   ########
   #@  #  ##
   # $  $  #
####$##$## #
# .* .* .*.#
#          #
##  #  #  ##
 ##########
Solution: undefined

;119
    ###
#####.#
#   $@#
#.# #$#
#   $ #
# ###.#
#     #
#######
Solution: undefined

;120
   #####
#### . ##
#   $@$ #
# #.#$#.###
#   $ $   #
### # # # #
  #.   .  #
  #########
Solution: undefined

;121
##########
#..      #
#######  ##
 #   $    #
 # $ ##$  #
 # # @$ # #
 # #$##  .#
 #.  ### .#
 ##### ####
Solution: undefined

;122
     ####
 ##### .#
 #   $  #
 #.  #  #
###$##$###
#.  #   .#
#   *   ##
##@ ###$##
 #### #  #
      #  #
      #  #
      ####
Solution: undefined

;123
####### #######
#@ ...# #...  #
#  #### ####  #
## #  ###  # ##
 # #       # #
 # #   #   # #
 # #$$$#$$$# #
 #     #     #
 #     #     #
 #############
Solution: undefined

;124
#######
#.#  .#
# #$# #
# #@$ #
# $ # #
#    .#
#######
Solution: undefined

;125
 #######
 #. @ .#
 #$# #$#
## # # ##
# $   $ #
#  . .  #
#########
Solution: undefined

;126
######
#. $.#
#  $ #
# #$ #
#  @ #
### $##
  # $ #
  #...#
  #####
Solution: undefined

;127
  ####
  # @#
  #  #
###$.#
#  $.#
# #$.#
#    #
#   ##
#####
Solution: undefined

;128
#### ###
#@ ###.#
#  $   #
#  $ $ #
#####$ #
  #.. .#
  ######
Solution: undefined

;129
####
# @#
#  ###
#  $ ##
#   $ #
###$  ###
  #  $$ #
  #.....#
  #######
Solution: undefined

;130
############
#   #     @#
# $ $ $ ####
# #####  #
#       .#
####### .#
      ##.#
       ###
Solution: undefined

;131
##########
#  ... ..#
# $###$ ##
#    # @#
## $ #$##
 # ###  #
 #$  $  #
 #   # .#
 ########
Solution: undefined

;132
######
#.#  ###
#.#  $ #
#.# #$ #
#.#  $ #
#.   # #
# ##$$ #
#     @#
########
Solution: 6-2l2u1l1d3r1d1l2r1u3r3d5l5u5d5r5u3l2r2u2l3d2r1d1l2r1u1r3d3l5u4d2r3u1r2u2l1d1r1d1l2r2u2l3d2r1d1l2r1u1r3d3l5u3d3r3u2d2r2u3l2r1u2l2d2r1d1l2r2d2l3u2r3u1r2d2l1d1l1u2d2r2u3l2r1u2l2d2r1d1l2

;133
#########
#  .. . #
#  ## # #
## #  $ #
 # $$$# #
 # #  $ #
 # # ## ###
 #.      .#
 #######@ #
       ####
Solution: undefined

;134
 #########
##   @   ##
# $.$.$.$ #
# .# # #. #
# $.$.$.$ #
##       ##
 #########
Solution: undefined

;135
 ##########
 # ....   #
 #@#####  #
 # $ $ # ##
 # # # # #
 # $ $ # #
## # # # ###
#          #
#   ####   #
#####  #####
Solution: undefined

;136
    ####
#####  ##
#   $   #
# #$#$# #
#.#   # #
#.### # #
#.  # # #
# # # # #
#       #
#@ ######
####
Solution: undefined

;137
########
#@ ... #
# $#$#$##
##      #
 #  #   #
 #  #####
 ####
Solution: undefined

;138
########
#..    #
#..# # #
#  # $ #
# $$$# #
#    # #
###  #@#
  ######
Solution: undefined

;139
############
#   #     @#
# $ $ $ ####
# #####$ #
#     $ .#
####   $.#
   ##  #.#
   #...###
   #####
Solution: undefined

;140
#########
#.     .#
# ##$## #
# .#  # #
# $$  $ #
#  #  # #
#@## ## #
####$## #
  #.   .#
  #######
Solution: undefined

;141
#########
#.  #  .#
#. $ $ .#
#.  $  ##
###$@$##
  #   #
  #####
Solution: undefined

;142
############
#....... @ #
########$# #
#  $     $ #
# # #$  $###
# #$#  # #
#   $ ## ##
##   ###  #
 ##### #  #
       #  #
       ####
Solution: undefined

;143
########
#@ ... #
# $  #$##
## # #  #
 #  $   #
 ##  ####
  ####
Solution: undefined

;144
    #####
#####. @#
#  ###  #
#  $ . ##
# $#$# #
##   # #
 #   . #
 #######
Solution: undefined

;145
     #####
     #.#@#
  ####.#$#
  #  #.# #
###  #.# #
#  $ #.  ####
#  $   $    #
#  $  # #   #
#####   #####
    #####
Solution: undefined

;146
    ###
    #.# ####
 ####.# #  #
 #  #.###  #
##  #.     #
#  $# # # ##
# $ $     #
#  $ # #  #
####  @####
   #####
Solution: undefined

;147
######
#.  .#####
#@#$$$ $ #
#.   # # #
### .    #
  ########
Solution: undefined

;148
#######
#.    #
#.#$$ #
#.#@# #
#.# # #
#.$$$ #
#     #
##  ###
 ####
Solution: undefined

;149
########
#....  ##
#####   #
# $   # #
# #$# # #
# $     #
# #$#####
#  @#
#####
Solution: undefined

;150
#########
#   .   #
# $ @ $ #
##$#$#$##
 #  $   #
 #..... #
 ########
Solution: undefined

;151
######
#.   ###
# $   .#
##$#$#@#
# $   .#
#.   ###
######
Solution: undefined


