;1
#############
#  . . . .  #
#  #$#$#$#  #
# $# . $ #$ #
#  . $ + .  #
# $#$#$#$#$ #
#  . . . .  #
#############
Solution: l1u1l2d1l2u1d1r2u1r2d1r2d1u1l2u1l2r2d1r2l2u1l2d1l3d2r7u2l2d1u2l2d1l3d2r5u3l2d2u1l3d2r3u3r2d1r4l2u2d2l2u1l2d1l3u3r7d3l2u2d1l2d1l3u3r5d2l2u1d2l2u1l1u2r3l3d3r1d1l1d1r1l1u1r1u3l1u1r1d3r2u1r2d1l2r4u1l2r1d1r4d2l1u1r1u1l3r3u2l1d1r1d1l1

;2
     #####
  ####   ####
###         ###
# $ $##.##$$  #
#             #
#######.#######
#   $ $$* $ #
#.  . .+. . #
######   ####
     #####
Solution: u3l3r6l7u2r8d1u1l8d2r8l10u1r1d1r9u2l8d1u1r8d2l8r4u1d2u1d3l2u1l2r1d1r3u3d3l2u1r1d1r1u3l4u2r4d4l1d2r2u1l3r1u1l3d1l2u1r5d1r1u3l4u2r4d4l1d2u1l4r4d1r2u1l4r2d1r2u1r1u1l3r1d1r4u1l3d1l1u3l4u2r4d4l1d1r3l2u3d2u2r4u2l3u1l1d5l1d1r1l3r2d1u2r3d1l1u1l2d1l2u1r3l5d1r1u1r3d2r2u1d1l2u1l2r2d1r2u1r1u1l3r1l1d1l1r1l2u1l2d1r1u1r2d1r1d1r2u1d1l2u1l2r2d1r2u2l2r5d1l2u1l3d2r2u1d1l2u2r2l1r1d1r2u1l1d1l1d1l2u1r3l5u1r2d1r1u3l4u2r4d4l1d2r2u1l2r1u5r3d1r1d1l3r2u2l3d4l1d1r1l1u1l2d1r1u1l3d1r1u1r4u2l4u1d1r3l2r3d2l2d1l1r1u1r2u2l4u1l2r2d1r4d3l1u1r1u2r1l5u1l2d1r5l3u2r4d4l1d2r1u5d1r3u1r3d1l5r2u2l3d4l3d1r1l1u1l2d1r1u1r4u2l4u2r1d1l1d1r4u2r3d2l2r2u2l3d2l3u2r2u1r1d1

;3
     ####
######@ #
# $ $ $ #
# * * * #
#.# #.# #
# * . $ #
#.#$#.# #
#       #
#########
Solution: undefined

;4
#############
#           #
# #$###$### #
# #       $ #
# # #$### # #
# $ #...# # #
# # $..+#$# #
# # #....   #
# # #$### # #
# $       # #
# ###$### # #
#           #
#############
Solution: undefined

;5
   ########
   #      #
   #$ *..$#
#### *#+# ####
#    $...$   #
# $#### # #$ #
#            #
##############
Solution: undefined

;6
############
#          #
# ######## ##
# $ $ $ $   #
#  . . . * .#
# ########+ #
# # . . . . #
#  $ $ $ $$ #
# ######## ##
#          #
############
Solution: undefined

;7
  #######
  #     ##
  # #.#. ###
###$..#$$$ #
# @$*... # #
# #$ ## $# #
# #. .#. # #
#  $ $$$ . #
####     ###
   #######
Solution: undefined

;8
######
#    ##
# $$  ##
#..#.. #
# *#.$##
# .#.$ #
#  # $ #
# *#.$ #
#$.#.$ #
#.*##* #
#$ $ $ #
#  @   #
########
Solution: undefined

;9
######
#    #
#    #
# .########
# $$.#. .##
#  # $ $  #
#  . . #$ #
# $#$###@ #
#  . # ####
##.#$#
 #   #
 #####
Solution: undefined

;10
     ####
     #  #
   ###  #
   #    #
####$#$ #
# ...   ###
#.*$###$  #
##.   $ $ #
 # ..#$ ###
 ####@* #
    #   #
    #####
Solution: undefined

;11
      ######
#######@   #
# $.$.$$#$ #
# . .      #####
#######.#$##   #
  #   $ *  $$$ #
  ## ###.#.#.# #
  #    *    .. #
  #    #   ##  #
  ##############
Solution: undefined

;12
       ####
########  #
#         #
#  $*#$#  #
#### #@#$ #
   # # #  #
   # # #$.#
   # *    #
   #... ###
   #### $ #
      #.  #
      #####
Solution: undefined

;13
 #####
 #   ######
 #   ##   #
 ##  $    #
  # # # ###
### # #$###
#   # #   #
#    .$   #
#####.#####
    #*$@$ #
    #.    #
    #.#####
    #.#
    ###
Solution: undefined

;14
 ##########
 #        ##
##. . . .  #
#  $#$#$#  #
# $. .@. . #
# $#$#$#$# #
##         #
 ###########
Solution: undefined

;15
  #######
  #     #
  #$#.#.#
  # .   #
  #$#+# #
  #  $. #
###$#.#.#
# $ $ $ #
#       #
#########
Solution: undefined

;16
##### #########
#.+.# #       #
#...# #$ $ $  #
#...###  # #$ #
#        $$$  #
#  #  #$$# ####
#          #
############
############
Solution: undefined

;17
###############
#             #
# #$#$#$#$#$# #
#      @      #
####$## ##$####
   # $   $ #
   #  ...  #
   ###...###
     #...#
     #####
Solution: undefined

;18
  #################
  #     #        ##
  #     # $ $$ $  #
### #  ## ### $   #
#    # ##   #$ $  #
#.  .# ##$# # $ $@#
#....#      #$ $  #
#....#$## ### $   #
#....#    ###    ##
###################
Solution: undefined

;19
 ########
##      #
#  **##*###
#      .$@#
# $$$###$ #
#$.$.# #.##
#.* .# ###
#.####
###
Solution: undefined

;20
   ###
 ###.#
 #.#.###
 #   *@#
## $$$##
#.* $  #
## $   #
 #. ####
 ####
Solution: undefined

;21
   ###
   #.#
   #.#
   #.#####
   #.$   #
 ###.$$  #
## $     #
# .$  $$ #
#@#####. #
###   ####
Solution: undefined

;22
     ####
 #####  #
## $ $  #
#@*     #
###*$$ $#
  #.$ $ #
  #.##..#
  #.##.##
  ####.#
     ###
Solution: undefined

;23
      #####
 ######  .#
##@$    # #
# $*$##.# #
#  $ $ .  #
# $* $##  #
# ..*.#####
###. ##
  ####
Solution: undefined

;24
#################
#       #       #
# $$#$$   $$#$$ #
#   $   #   $   #
# $$#$$ # $$#$$ #
#       #       #
## ####### ### ##
#       #.......#
# $$#$$ #.......#
#   $   #.......#
# $$#$$ #   .   #
#       # ..+.. #
#################
Solution: undefined

;25
#######################
#    #     #          #
# #     #             #
#   # #    #  # #  #  #
#   #    # #          #
##     #   # # # #  # #
#    #     #       ## #
#  #   # # #  # #     #
#    #     #      #   #
##     #   # #      # #
#  #     # #   # #    #
#          #          #
##### ############## ##
#          #          #
# ........ # $$$$$$$$ #
# .      . # $      $ #
# .      . # $      $ #
# ........ # $$$$$$$$ #
#     @    #          #
#######################
Solution: u1l1u8r1u5r1u1r2u1r3d9r9l1d2r1d5l4u2r2u1l2d3r4u3l1u4r1u1l2d1l1u1r1u1l4r1d2l2u2r1u1l2r1d2l2u7r1u1l3u1l1d1r1d1l2r1u2l2d2r1l1u1l2d2r2u1r1d7u1r2d2l4u1l1d6l1d1r4l3u8r1u1r4u6r2d9r9l2r1d2r1d5l4u4d4l5u5r7l2d5r4u3l1u4r1u1l2d1l1u1r1u1l4r1d2l2u2r1u1l2r1d2l2u7r1u1l3u1l1d1r1d1l2r1u2l2d2u1l2d2r2u1r1d7u1r2d2l4u1l1d5l1d1r4l3u6r2d1r3u9r2d9r8d2l3d2r1u1l1u1r2l1d1l1d4r4u4l1u3r1u1l2d1l1u1r1u1l4r1d2l2u2r1u1l2r1d2l2u7r1u1l3u1l1d1r1d1l2r1u2l2d2r1d1l2r1u2l2d2u2l2d3r2u1r1d6r1d1l1u1l1d4l1d1r4l3u4r5u9r2d9r8d2l2d2r1u1l1u1r1d1r1u3r1u1l2d1l1u1r1u1l4r1d2l2u2r1u1l2r1d2l2u7r1u1l3u1l1d1r1d1l2r1u2l2d2u1d1r1d1l2r1u2l2d2u2l2d3r2u1r1d6r1d1l1u1l1d3l1d1r4l3u3r5u9r2d9r8d3r1d2l1u5r1u1l2d1l1u1r1u1l4r1d2l2u2r1u1l2r1d2l2u7r1u1l3u1l1d1r1d1l2r1u2l2d2r1d1l2r1u2l2d2u2l2d3r2u1r1d6r1d1l1u1l1d6r1d1l3r3l1u8r1u1r4u6r2d9r8d3r1d4l1u7r1u1l2d1l1u1r1u1l4r1d2l2u2r1u1l2r1d2l2u7r1u1l3u1l1d1r1d1l2r1u2l2d2r1d1l2r1u2l2d2u2l2d3r2u1r1d6r1d1l1u1l1d5r1d1l3r2u5r5u9r2d9r9l2r1d3l2d2r1l2d2r3u7r1u1l2d1l1u1r1u1l4r1d2l2u2r1u1l2r1d2l2u7r1u1l3u1l1d1r1d1l2r1u2l2d2r1d1l2r1u2l2d2u2l2d3r2u1r1d6r1d1l1u1l1d4r1d1l3r2u4r5u9r2d9r8d7l1u4l1u1r1d1r1u3r1u1l2d1l1u1r1u1l4r1d2l2u2r1u1l2r1d2l2u7r1u1l3u1l1d1r1d1l2r1u2l2d2r1d1l2r1u2l2d2r1l1u2l2d3r2u1r1d6r1d1l1u1l1d3r1d1l3r2u3r5u9r2d9r8d7l2u4l1u1r2d1r1u3r1u1l2d1l1u1r1u1l4r1d2l2u2r1u1l2r1d2l2u7r1u1l3u1l1d1r1d1l2r1u2l2d2r1d1l2r1u2l2d2u2l2d3r2u1r1d6r1d1l1u1l1d6l1d1r3l2u6r5u9r2d9r8d5l5u1r4d1r1u5r1u1l2d1l1u1r1u1l4r1d2l2u2r1u2d1l2r1d2l2u7r1u1l3u1l1d1r1d1l2r1u2l2d2r1d1l2r1u2l2d2u2l2d3r2u1r1d6r1d1l1u1l1d6l1d1r2l1u8r1u1r4u6r2d9r8d7l8u3r7d1r1u5r1u1l2d1l1u1r1u1l4r1d2l2u2r1u1l2r1d2l2u7r1u1l3u1l1d1r1d1l2r1u2l2d2r1d1l2r1u2l2d2u2l2d3r2u1r1d6r1d1l1u1l1d6r1d1l2r1u6r5u9r2d9r8d7l8u2r7d1r1u6r1u1l2d1l1u1r1u1l4r1d2l2u2r1u1l2r1d2l2u7r1u1l3u1l1d1r1d1l2r1u2l2d2r1d1l2r1u2l2d2u2l2d3r2u1r1d6r1d1l1u1l1d5r1d1l1u1l1d1r1u5r5u9r2d9r8d7u3l7u1l1u1r7d1r1u3r1u1l2d1l1u1r1u1l4r1d2l2u2r1u1l2r1d2l2u7r1u1l3u1l1d1r1d1l2r1u2l2d2r1d1u1l1u1l2d2r2u1r1d7u1r2d2l4u1l1d4l1d1r1u1r1d2l1u5r5u9r2d9r8d4l6u1l1u1r6d1r1u3r1u1l2d1l1u1r1u1l4r1d2l2u2r1u1l2r1d2l2u7r1u1l3u1l1d1r1d1l2r1u2l2d2u1l2d2r2u1r1d7u1r2d2l4u1l1d6u6r3u1r2u7r2d9r9l1d4l5u1r4d1r1u4r1u1l2d1l1u1r1u1l4r1d2l2u2r1u1l2r1d2l2u7r1u1l3u1l1d1r1d1l2r1u2l2d2u1l2d2r2u1r1d7u1r2d2l4u1l1d3l1d1r3l2u3r5u9r2d9r8d4l8u2r7d1r1u3r1u1l2d1l1u1r1u1l4r1d2l2u2r1u1l2r1d2l2u7r1u1l3u1l1d1r1d1l2r1u2l2d2u1l2d2r2u1r1d7u1r2d2l4u1l1d3l1d1r1u1r1d1l1d1r1l1u4r5u9r2d9r8d7l4u4l1u1r4d1r1u3r1u1l2d1l1u1r1u1l4r1d2l2u2r1u1l2r1d2l2u7r1u1l3u1l1d1r1d1l2r1u2l2d2u1l2d2r2u1r1d7u1r2d2l4u1l1d3r1d1l2d2r4u1d1l3u5r5u9r2d9r8d7l5u4l1u1r5d1r1u3r1u1l2d1l1u1r1u1l4r1d2l2u2r1u1l2r1d2l2u7r1u1l3u1l1d1r1d1l2r1u2l2d2u1l2d2r2u1r1d7u1r2d2l4u1l1d3l1d1r2l1u3r5u9r2d9r8d7l6u4l1u1r6d1r1u3r1u1l2d1l1u1r1u1l4r1d2l2u2r1u1l2r1d2l2u7r1u1l3u1l1d1r1d1l2r1u2l2d2u1l2d2r2u1r1d7u1r2d2l4u1l1d3r1d1l1d2r3u1l1d1l1u1l1u4r5u9r2d9r8d7l7u4l1u1r7d1r1u3r1u1l2d1l1u1r1u1l4r1d2l2u2r1u1l2r1d2l2u7r1u1l3u1l1d1r1d1l2r1u2l2d2u1l2d2r2u1r1d7u1r2d2l4u1l1d3

;26
            #######
      #######     #
#######     #$$$$ #
#     # $ $       #
#....   $$$ #$$$$ #
#.... # $ $$#     #
#.... #     #######
#..+. #######
#######
Solution: u3r4u2r2d2l7u1l1d3u2r8u2r2d2l8u1l1d3u2r7u2l1d1r1d1l5u1l1d3u2r4u2r3d1r1d1l6u1l1d3u2r3d2r2u1l1d1l1u1r1u1l6u1l1d2u1r6u1r3d1l7u1l1d2u1r6d2r2u1l1u2r2d1l7u1l1d2u1r8u1r6u2l1d1r1d1l9u1l1d1r1d1l3u1l1d2u1r7u1r5u2l1d1r1d1l8u1l1d1r1d1l6u1l1d1r10u1r4u2l1d1r1d1l7u1l1d1r1d1l5u1l1d1r9u1r3u2l1d1r1d1l6u1l1d1r1d1l4u1l1d1r8u1r6d2l1u1r1u1l9u1l1d1r1d1l3u1l1d1r7u1r5d2l1u1r1u1l8u1l1d1r1d1l6r9u1r4d2l1u1r1u1l7u1l1d1r1d1l5r8u1r3d2l1u1r1u1l6u1l1d1r1d1l4r3d2r4u2l1u1r3u1r2d1l7u1l1d1r1d1l3

;27
     #####
######   #
#      @ #
#  ###...#
# $$ #...#
#  # #####
## $   #
 # $ $ #
 ### $ #
   #   #
   #####
Solution: l6d3r1u2l1u1r5u1r1d2r1d1l1u2l6d2r1d2r2u2l1r1d2l2u3l1u1r5u1r1d1r1d1l1u1l5d4r2d3r2u3l1r1d3l2u3l2d1r1u1r3d3l2u2d2r2u3l3d1l1u4l1u1r5u1r1d2u1l5d4r4d2l1u1r1u1l3d1l1u4l1u1r5u1r1d1l5d5r3d2l1u2r1u1l2d1l1u4l1u1r6u1r1d2u1l6d2r2d2r1d2l1u1r1u1l2d1l1u4l1u1r6u1r1d1

;28
       ####
       #  #####
       #      #
 ####  # ###  #
 #  ####  ## ##
 #        ## #
 # ######### #
 # ###       #
 # #+#  ###  #
 # #.## # ####
 # #..# #
 # #..# ##
 # #..#  #############
 # #..#  $           #
## #..# ####### $$$$ #
#       #     # $    #
#  #  # #     # $  $ #
## # ####     # $$$$ #
 #   #        #      #
 #####        ########
Solution: d7r3u2r8d5r5u5l12u1l1u5r5u5l4d3l6d10r5u7l1u1r5d1r1u5r1u1l4u1l1d3r1d1l6u1l1d11r2d3l2u2l1u1r2l1d3r2u9d6r3u2r13d2l1u1r1u1l12u1l1u5r5u5l4d3l6d10r5u7l1u1r5d1r1u5r1u1l4u1l1d3r1d1l6u1l1d11r2d3l2u2l1u1r2l1d3r2u8d5r3u2r12d2l1u1r1u1l11u1l1u5r5u5l4d3l6d10r5u7l1u1r5d1r1u5r1u1l4u1l1d3r1d1l6u1l1d11r2d3l2u2l1u1r2l1d3r2u7d4r3u2r11d2l1u1r1u1l10u1l1u5r5u5l4d3l6d11u1r5u7l1u1r5d1r1u5r1u1l4u1l1d3r1d1l6u1l1d11r3l1d3l2u2l1u1r2l1d3r2u6d3r3u2r10d2l1u1r1u1l9u1l1u5r5u5l4d3l6d10r5u7l1u1r5d1r1u5r1u1l4u1l1d3r1d1l6u1l1d11r2d3l2u2l1u1r2l1d3r2u5d2r3u2r13d5l3u4r1u1l10u1l1u5r5u5l4d3l6d10r5u7l1u1r5d1r1u5r1u1l4u1l1d3r1d1l6u1l1d11r2d3l2u2l1u1r2l1d3r2u4d1r3u2r10d5l2u3r1l1u1r1u1l8u1l1u5r5u5l4d3l6d10r5u7l1u1r5d1r1u5r1u1l4u1l1d3r1d1l6u1l1d11r2d3l2u2l1u1r3d1r1u5d4r2u2r10d4l1u3r1u1l9u1l1u5r5u5l4d3l6d10r5u7l1u1r5d1r1u5r1u1l4u1l1d3r1d1l6u1l1d11r2d3l2u2l1u1r2l1d3r2u3r3u2r9d5l1u4r1u1l8u1l1u5r5u5l4d3l6d10r5u7l1u1r5d1r1u5r1u1l4u1l1d3r1d1l6u1l1d11r2d3l2u2l1u1r3d1r1u4d3r2u2r9d5r2u4r1u1l11u1l1u5r5u5l4d3l6d10r5u7l1u1r5d1r1u5r1u1l4u1l1d3r1d1l6u1l1d11r2d3l2u2l1u1r3d1r1u3d2r2u2r13d3l4d1l1u3r1u1l8u1l1u5r5u5l4d3l6d10r5u7l1u1r5d1r1u5r1u1l4u1l1d3r1d1l6u1l1d11r2d3l2u2l1u1r3d1r1u2d1r2u2r13d5l1u4r1u1l12u1l1u5r5u5l4d3l6d10r5u7l1u1r5d1r1u5r1u1l4u1l1d3r1d1l6u1l1d11r2d3l2u2l1u1r3d1r1u1

;29
  ########
  #      #
  # $$ $ #####
  #  $$$ #  #
  #  $      #
  ##$$$$ #$ #
  #      #  ###
  # ######    #
  # ###### ## #
  #           #
  # ######## ##
### ....+### #
#   .......# #
#            #
##############
Solution: l5u5r5u5l5d3r1l1u3r5d3r2d4u1r3d2l9r6u5l2d2l5d5r1d2l2u1r5d1r1u1l5u6r5u5l5d3r7u1r1d3l1d3r3u2l2u1l1d2u1r3d2l9r6u5l2d2l5d5r1d2l2u1r4d1u1d1r1u1l4u6r4u1r1u4l5d3r7u1r1d3l1d3r3u2l2u1l1d2u1r3d2l9r6u5l2d2l5d5r1d2l2u1r7l6u6r1u1d1r4u5l5d3r7u1r1d3l1d3r3u2l2u1l1d2u1r3d2l9r6u5l2d2l5d5r1d2l2u1r6l5u6r2u1l1u1r6u1r1d3l1d3r3u2l2u1l1d2u1r3d2l9r6u5l2d2l5d5r1d2l2u1r5l4u6r3u1l1u1r5u1r1d3l1d3r3u2l2u1l1d2u1r3d2l9r6u5l2d1l2d1l3d5r1d2l2u1r4l3u6r1u2l1u3r1d2l1d1r7u1r1d3l1d3r3u2l2u1l1d2u1r3d2l9r7l1u5l2d2l5d5u2r9d4l10u1r3d1r1u1l3u6r1u5r2d2u2l2d3r6u1r1d3l1d3r3u2l2u1l1d2u1r3d2l9r6u5l2d2l5d5r1d2l2u1r3l2u6r1u4r1u1d2l1d1r6u1r1d3l1d3r3u2l2u1l1d2u1r3d2l9r6u5l2d2l5d5r1d2l2u1r2d1r1u1l2u6r1u5r2d2l1d1r5u1r1d3l1d3r3u2l2u1l1d2u1r3d2l9r6u5l2d2l5d5u1d1r1d2l2u1r2l1u3r1l1u3r1u4d1u1r3d1l1d1r4u1r1d3l1d3r3u2l2u1l1d2u1r3d2l9r6u5l2d2l5d5r1d2l2u1r1d1r1u1l1u6r4u5r1d2l1d1r3u1r1d3l1d3r3u2l2u1l1d2u1r3d2l9r6u5l3d2l4d5u2r9d4l11u1r2

;30
       ########## #########
       #        # #       #
    #### #$#$#  # # $ $#  #
    #  #       ## # $# $  #
#####    $ $ $ #  # $  # ##
#  ##  # ##### ## # $  $ #
#      #        ######   #
#    ### $ $ $           #
#### # ####### $ $ $ ### #
   # #       #######  $  #
   # #####         ####  #
  ##  ...#            ####
  #   ...#
  #   ...#
  ##.....#
   #..+..#
   #######
Solution: l1u4l1u5r1u2r3u1r2d1l4u1l1d2r1d1l3d1l2u2r1d1l1d1r2u1r1d5r1d2l2u1r4d1r1u1l4u6r2u2r4u1r2d1l6u1l1d2r1d1l3d1l2u2r1d1l1d1r2u1r1d5r1d2l2u1r3d1r1u1l3u6r2u2r4u1r4d1l8u1l1d2r1d1l3d1l2u2r1d1l1d1r2u1r1d5r1d2l2u1r2d1r1u1l2u6r2u2r2u3r2d2r1d1l5u1l1d2r1d1l3d1l2u2r1d1l1d1r2u1r1d6l1d1r4d1r1u1l4u7r2u2r2u3r4d2r1d1l7u1l1d2r1d1l3d1l2u2r1d1l1d1r2u1r1d6l1d1r3d1r1u1l2u1l1u6r2u2r8d3r4d1u1r2d2r3d1r1u7d4l6d1r1u1l3d1r1u1l3d1r1u1l1u1l2d1r1u1r2d2l1u3d1l6u3r6d2u1l6d2r2d1r1u1l3d1r1u1r4d1r2u1l6d1l1u2d1r6u2l8u1l1d2r1d1l3d1l2u2r1d1l1d1r2u1r1d6l1d1r2u1r1d2l1d1r2l2u4l1u5r1u2r3d2r3d1r2u1r2d1l1u1l2d1r1u1r2d2l1u1r1u1l6d1l1u2d1r6u2l8u1l1d2r1d1l3d1l2u2r1d1l1d1r2u1r1d6l1d1r3u1d1r1l3u7r2u2r2d3r5u1r2d2l1u1r1u1l6d1l1u2d1r6u2l8u1l1d2r1d1l3d1l2u2r1d1l1d1r2u1r1d7r1d2l1u1r1u2l2d1r2u1r1d1l1d1r2l3u8r2u2r8d3r10d2l4u1d1r4u2l10u1l2d1r1u1r2d2l1u1r1u1l6d1l1u2d1r6u2l8u1l1d2r1d1l3d1l2u2r1d1l1d1r2u1r1d6l1d1r1u1r1d2l1d1r2l2r1u4l1u5r2u2r8d3r3d1r2u1r5d2l4u1d1r4u2l9d1l1u1r1u1l6d1l1u2d1r6u2l8u1l1d2r1d1l3d1l2u2r1d1l1d1r2u1r1d6l1d1r2d1r1u1l2u7r2u2r2d2r7d2r4u1r5d2l4u1d1r4u2l9d1l1u1r1u1l6d1l1u2d1r6u2l8u1l1d2r1d1l3d1l2u2r1d1l1d1r2u1r1d6l1d1r1u1r1d2l1d1r1l1r1l1u9r2u2r8d3r10u4r1u2l3d5r1d1l8d1l1u1r1u1l6d1l1u2d1r6u2l8u1l1d2r1d1l3d1l2u2r1d1l1d1r2u1r1d6l1d1r1u1r1d1l1d1r2l1u1l1u7r2u2r8d3r10u4l1r2u2l3d5r1d1l8d1l1u1r1u1l6d1l1u2d1r6u2l8u1l1d2r1d1l3d1l2u2r1d1l1d1r2u1r1d6l1d1r1u1r1d1l1d1r1l1u8r2u2r8d3r10u2l1r1u2l2d3r1d1l8d1l1u1r1u1l6d1l1u2d1r6u2l8u1l1d2r1d1l3d1l2u2r1d1l1d1r2u1r1d6l1d1r3l2u7r2u2r8d3r10l2u6l3d1r2u1r1d5r1d1l8d1l1u1r1u1l6d1l1u2d1r6u2l8u1l1d2r1d1l3d1l2u2r1d1l1d1r2u1r1d6l1d1r2l1u7r2u2r8d3r8u6l3d3r2l2u2r3d4r1d1l8d1l1u1r1u1l6d1l1u2d1r6u2l8u1l1d2r1d1l3d1l2u2r1d1l1d1r2u1r1d6l1d1r1u1r1d2u1l1u7r2u2r8d3r8u3l3d1r2u1r1d2r1d1l8d1l1u1r1u1l6d1l1u2d1r6u2l8u1l1d2r1d1l3d1l2u2r1d1l1d1r2u1r1d6l1d1r1u1r1d1l1u7r2u2r8d3r9u2l4u3r1d2l1d1r2u1r1d2r1d1l8d1l1u1r1u1l6d1l1u2d1r6u2l8u1l1d2r1d1l3d1l2u2r1d1l1d1r2u1r1d8u8r2u2r8d3r10u4r1u2l1d1r1d1l2r1u2l2d5r1d1l8d1l1u1r1u1l6d1l1u2d1r6u2l8u1l1d2r1d1l3d1l2u2r1d1l1d1r2u1r1d7

;31
       #####
       #   #
      ##   ##
     ## $ $ ##
    ##       ##
   ##   #*#   ##
  ##   #. .#   ##
 ##   #.   .#   ##
## $ #.  $  .# $ ##
#    *  $@$  *    #
## $ #.  $  .# $ ##
 ##   #.   .#   ##
  ##   #. .#   ##
   ##   #*#   ##
    ##       ##
     ## $ $ ##
      ##   ##
       ## ##
        ###
Solution: undefined

;32
       #####
       # + #
      ##   ##
     ##     ##
    ##   $   ##
   ##   $*$   ##
  ##   $*.*$   ##
 ##   $*...*$   ##
##   $*..$..*$   ##
#.  $*..$ $..*$  .#
##   $*..$..*$   ##
 ##   $*...*$   ##
  ##   $*.*$   ##
   ##   $*$   ##
    ##   $   ##
     ##     ##
      ##   ##
       ##.##
        ###
Solution: undefined

;33
       #####
       #.+.#
      ##...##
     ##.   .##
    ##.  $  .##
   ##.  $$$  .##
  ##.  $$ $$  .##
 ##.  $$   $$  .##
##.  $$  $  $$  .##
#.. $$  * *  $$ ..#
##.  $$  $  $$  .##
 ##.  $$   $$  .##
  ##.  $$ $$  .##
   ##.  $$$  .##
    ##.  $  .##
     ##.   .##
      ##...##
       ##.##
        ###
Solution: undefined

;34
     #######
     ## + ##
     ##   ##
    ##. $ .##
   ##. $$$ .##
  ##. $$.$$ .##
 ##. $$. .$$ .##
##. $$. $ .$$ .##
#. $$. * * .$$ .#
##. $$. $ .$$ .##
 ##. $$. .$$ .##
  ##. $$.$$ .##
   ##. $$$ .##
    ##. $ .##
     ##. .##
      ##.##
       ###
Solution: undefined

;35
     ####################
     ####               #
     #  #$#$#$#$#$#$##  #
     #               #  #
     #  ##$#$#$#$#$#$#  #
######  #               ######
#    #  #$#$#$#$#$#$##  #    #
#    #               #  #    #
#    #  ##$#$#$#$#$#$#  #    #
#                       #    #
#    ################# ##    #
#    ####............        #
#        ......+.....####    #
##############################
Solution: l11u3r3u2r3d1u1l3d2r14l16r1u6r14l13d6l3d3r16u1r2u3r1u2l1d4u1l18d3r16u1r5u1r2d1l17r12u2l12u2r2d1u1l2d2r11l17d3r16u1r2u3r1u2l1d4u1l18d3r16u1r5u1r2d1l16r11u2l10u2r8d1u1l8d2r9l17d3r16u1r2u2r1u2l1d3u1l18d3r16u1r5u1r2d1l15r10u2l2u2l2d1u1l6d2r9l17d3r16u1r2u2r1u2l1d3u1l18d3r16u1r5u1r2d1l14r9u6l9r10d4l3u2l6d1u1l2d2r9l18d3r17u1r2u3r1u2l1d4u1l18d3r16u1r5u1r2d1l13r8u2l2u2l4d1u1l2d2r7l17d3r16u1r2u2r1u2l1d3u1l18d3r16u1r5u1r2d1l12r7u6l13d1u1r13d4l2u2l12r2d2l4u3r1d2l1d1r15l19d3r18u1r2u3r1u2l1d4u1l18d3r16u1r5u1r2d1l11r6u2l12u2l1u2r2d1u1r11d4l2u2l12r2d2l4u3r1d2l1d1r15l18d3r17u1r2u3r1u2l1d4u1l18d3r16u1r5u1r2d1l10r5u6l3d1u1r3d4l2u2l12r2d2l4u3r1d2l1d1r15l17d3r16u1r2u3r1u2l1d4u1l18d3r16u1r5u1r2d1l9r4u6l5d1u1r2d2l11r2d2l4u3r1d2l1d1r15l17d3r16u1r2u3r1u2l1d4u1l18d3r16u1r5u1r2d1l8r3u2l2u2l1u2l4d1u1r2d2l9r2d2l4u3r1d2l1d1r15l1u2l1u2r3d5u1l18d3r16u1r5u1r2d1l7r2u6l9d1u1r2d2l7r2d2l4u3r1d2l1d1r15l1u2l1u2r3d5u1l18d3r16u1r5d1r1u1l4u6l9d2l6u4r3d1u1l3d4r2u2r12l2d2r1d2r2u2r1u3l1d4r1d1l19u1l1d3l1d1r17l16u2r1u1r2u6r6d1u1l2d2r11l2d2r1d2r3u5l1d4r1d1l19u1l1d3l1d1r16l14u3r17l1u2l3u2l5u2r2d1u1l2d2r9l2d2r1d2r2d2r5u2l1d1r1d1l6r1u2r1u5l1d4r1d1l19u1l1d3l1d1r15l13u3r13l1u2l1u2l1u2r2d1u1l2d2r7l2d2r1d2r3u5l1d4r1d1l19u1l1d3l1d1r14l12u3r15l1u2l1u2l1u2r2d1u1l2d2r5l2d2r1d2r3u5l1d4r1d1l19u1l1d3l1d1r13l11u3r16u2l1u2l1u2r2d1u1l2d2r3l2d2r1d2r3u5l1d4r1d1l19u1l1d3l1d1r12l10u3r10u2r5u2r3u4l13d1u1r13d4l2u2l13u1l1d6r1d1l3u1l1d3l1d1r11l9u3r3u6r2u2r2d1u1r11d4l2u2l13u1l1d6r1d1l3u1l1d3l1d1r10l8u3r6u2l1u2r1u2r1u2r2d1u1l2d2r1d2r2u2l7u1l1d6r1d1l3u1l1d3l1d1r9l7u3r2u6r5u2r4d1u1l2d2r1d2r2u2l9u1l1d6r1d1l3u1l1d3l1d1r8l6u3r2u6r9u2r2d1u1l2d2r1d2r2u2l11u1l1d6r1d1l3u1l1d3l1d1r7l5u3r3u6r2u2r10d1u1r4d4l3u2l13u1l1d6r1d1l3u1l1d3l1d1r6

;36
    ####################
    #  #               #
    #  #$#$#$#$#$#$##  #
    #               #  #
    #  ##$#$#$#$#$#$#  #
    #  #               #
    #  #$#$#$#$#$#$##  #
#####               #  #####
#   #  ##$#$#$#$#$#$#  #   #
#             $        #   #
#   ################# ##   #
#   ####............       #
#       ............#  #   #
##### ########+####### #####
#   #  #............       #
#       ............####   #
#   ## #################   #
#   #         $            #
#   #  #  $ $ $ $ $  # #   #
#####   #  $ $ $ $  #  #####
    #    #  $ $ $  #   #
    #  $  #  $ $  #  $ #
    #  $   #  $  #   $ #
    #  $    #   #    $ #
    #  $     ###     $ #
    #                  #
    ####################
Solution: undefined

;37
#################
#               #
# $$$$$$$$$$$$$ #
#               #
# ######### $ $ #
# . + .   # $ $ #
# #.#.# # # $ $ #
# . . .   # $ $ #
# #.#.# # # $ $ #
# . . . # # $ $ #
#       # ### ###
#### #### ### ###
#    ####      #
# ## #### #### #
# #  #### #  # #
# #          # #
# #  ####### # #
# ####......   #
#     ......   #
################
Solution: undefined

;38
        #####
       ## + ##
      ##  *  ##
     ##  * *  ##
######  * * *  ##
#      * * * *  ##
#   # * * * * *  #
### #* * *$* * * #
#   # * * * * *  #
#      * * * *  ##
######  * * *  ##
     ##  * *  ##
      ##  *  ##
       ##   ##
        #####
Solution: undefined

;39
       #####
       #   #
       # # #
      ## + ##
     ##  *  ##
    ##  * *  ##
   ##  * * *  ##
####  * * * *  ####
#    * * * * *    #
# #.*$*$* *$*$*.# #
#    * * * * *    #
####  * * * *  ####
   ##  * * *  ##
    ##  * *  ##
     ##  *  ##
      ## . ##
       # # #
       #   #
       #####
Solution: undefined

;40
         #############
         # .         #
         # # ######  #
        ## * ##   # ##
       ##  *  ##  # #
      ##  * *  ## # #
    ###  * * *  ### #
######  * * * *  ## ###
#      * * * * *      #
# #.#**$*$*@*$*$**#.# #
#      * * * * *      #
### ##  * * * *  ######
  # ###  * * *  ##
  # # ##  * *  ##
  # #  ##  *  ##
 ## #   ## * ##
 #  ###### # #
 #         . #
 #############
Solution: undefined


