;1
####
#  ########
# $  #@ $.#
# $  $    ##
#    ###...#
###### #####
Solution: 9-2l1,6-3l2,3-4u1,1-3r7,9-2d1,8-4r1,2-1d1,1-3r7,9-2d1,6-2r2,4-2l1,2-1d1,1-3r6,8-2d1


