;1
 ##########
 #. ## ...#
## $# .   #
#   $$  ###
# $  $ ##
#   # @#
########
Solution: undefined

;2
        ####
    #####..#
##### $    #
# $    #.  #
#@$ $$.#  ##
####$ ##. .#
   #     ###
   #######
Solution: undefined

;3
###  #######
#.#### $.  #
#.@ *  .#  #
#    #$$   #
##  $     ##
 ######   #
      ##  #
       ####
Solution: 3-4r4,3-2r3d1r1,6-1r1,7-4l1,7-1d1,6-4l2,9-4l3,7-2d1,6-4r1,9-3l2,6-4u1,7-2l5,1-3u1,9-4l1,7-5u1,8-3l1,6-4u1,7-2l3,4-4r2,4-2l2,7-5u1,8-3l1,2-4r4u1,7-2l2,7-5u2

;4
####    #####
#. ######.  #
#    $   $  #
# * ..$ *  ##
#  ####  ###
####  # #####
      #$    #
      # @   #
      #######
Solution: undefined

;5
#########
#....  .##
######   ####
     #@$$#  #
#######$ $  #
# $         #
#     ###  ##
####### ####
Solution: u1r2d2r1d1l4r6u1l1d1l5d1l2u1r6d1r1u1l2u3l2d1r1d1r1d1l3r6u2l1d1l2d1l1u2d1r2d2r1u1r1u1l1d1l5d1u1r2u2l1u2r1d1r1d2l1d1r2d1r1u1l3u2r1u1l1d1l1u1r1u1l5r5d4r4u2l1d1l2d1l1u2r1u1l1d1l1u1r1u1l4r4d3r4d1l1d1l1u1r1u1l2d1l1u2r1u1l1d1l1u1r1u1l3r3d4l2d1l2u1r6d1r1u1r1u1l3d1l1u1d1u2r1u1l1d1l1u1r1u1l2r2d4l4d1l2u1r8d1r1u1r1u1l3d1l1u3

;6
#####   ######
#   #  ## .  #
# $ #### +.  #
#      $ # .##
###  $$$ . ##
  #   #    #
  ##########
Solution: undefined

;7
################
# .$.   $.$.$.@#
#.   $ ##    $ #
#########$. *$.#
        #.   $ #
        ########
Solution: undefined

;8
########  ####
#. .#  #  # @#
#.    *####  #
#         $$ #
##### *### $ #
    #  # #   #
    #### #####
Solution: undefined

;9
########
#. .#@ #  ####
#.    *####  #
##   $     $ #
 #### *## $  #
    #  ###   #
    #### #####
Solution: undefined

;10
     ##########
######....    #
#  ##   #.    #
# $  $    #  ##
#     #  #    #
########  $$$ #
       #  #@###
       ######
Solution: undefined

;11
     ###########
     #..#      #
 #####* $      #
## . #       # #
#.    #$###    #
# @ .    ### $##
#  # # # $ $   #
#    #   #     #
################
Solution: undefined

;12
          ######
####### ###    #
#.    ### $ $  #
##.#    . ##$  #
#      #@##  $##
#    #     .   #
#      #       #
##     ####  ###
 #######  ####
Solution: undefined

;13
######      ####
#.  .########  #
#   . #     $  #
## ##     ###$ #
#      # ###  ##
# .@ ### $     #
##   # #  # $  #
 ##  # ####  ###
  ####    ####
Solution: undefined

;14
            ####
 ############ @#
 #          # $#
 #         $ $.#
 ##        # $ #
##. .  .       #
#         ##   #
#      #########
########
Solution: undefined

;15
###############
#       ## .. #
# ##       #  #
# #     #     #
#         ##$###
### @###$#. .  #
  ### $   $    #
    #     ######
    #######
Solution: undefined

;16
 ###     #######
##.###  ##     #
#.  .####      #
##       *  @  #
 ## $$## $     #
  ###   # #   ##
    ###      ##
      ####  ##
         ####
Solution: undefined

;17
####### ########
#  #  # #   #  #
#     ###      #
#  # .#  ## #  #
# $. ##       ##
####$      ##  #
#        @     #
#   #########  #
#####       ####
Solution: undefined

;18
 #####
##   ######
# $ $   $ #
#  $#.*.*.#
##    * $.#
 ## $..# @#
  ##  ##  #
   ########
Solution: undefined

;19
      ####
#######..#####
#. .  $  #   #
##*$ #     # #
#@ $$#    #  #
# $  .      ##
#############
Solution: undefined

;20
       #######
  ######.... #
  #   ##     #
### $ #.     ##
#  # $ @      #
#    $  #     #
#  $ $        #
#####  ###    #
    #### ######
Solution: undefined

;21
##### ##########
#@  ###.    #  #
# $$#.         #
##$ #  ### .   #
 #   # # ## #  #
 #$    ###   ###
 #         #   #
 ## #   .##    #
  #.$         ##
  #############
Solution: undefined

;22
          #####
########  #.*.#
#   @  #### # #
# $ $ $   #.  #
##$####       #
#          #  #
#       ##    #
#        #    #
#. #  #       #
###############
Solution: undefined

;23
###############
#.....##      #
#      #   #$$##
####     #   $ #
   ##@#     $$ #
    #   #      #
    ############
Solution: undefined

;24
###############
#..   ##      #
#.     #$  #  #
# ## $ $ ##@$ ##
#.###      $   #
#.# ##  ####   #
###  ####  #####
Solution: undefined

;25
###############
#.    ##      #
#.     # $ # $#
#.## @$   # $ ##
#.###  # $     #
#.# #####  #   #
###     ########
Solution: undefined

;26
###############
#.    ##      #
#      #$ ##  #
#  # $ $ ##@$ ##
#. ##      $   #
#...##  ####   #
#########**#####
Solution: undefined

;27
         ####
##########  #
#@ $   $.   #
###  . .$#$ #
  #####*   .#
      #   * #
      #######
Solution: undefined

;28
     #######
     #     ###
### ##$$ #  .#
#@###        ##
#   $  #   #*.#
#### $ ##     #
   #  ####. . #
   ####  ######
Solution: undefined

;29
  #######
###.$+ .#
# $  # .##
# #$$ $$ #
#. .     #
##########
Solution: undefined

;30
  ####
  #  ####
### *@. #
# $. #  ##
# #$* *  #
#.     $ #
##########
Solution: undefined

;31
#######
#@   .#######
### #.$     ##
  #.   *.#$$ #
  ##### $    ###
      # .## $  #
      #  ##    #
      ##########
Solution: undefined

;32
     ##########
   ###.##@#   #
#### $ $  $ # #
#  $ #$##$  $ #
#...  ...   ###
##############
Solution: undefined

;33
          ######
   ########*+* #
   #  # $  $ $ #
#### $   ...$$ #
#.. $ ####   . #
#######  #######
Solution: undefined

;34
        #######
#########@ *. #
#.# $  ..   * #
# $ ##    ##  #
#  $   $    $ #
#.$ ######## .#
#####      ####
Solution: undefined

;35
###########
#  $   ...####
#.$@$ $  $  .#
######## .$.$#
       # $.  #
       #######
Solution: undefined

;36
        ########
#########   .  #
#  . $    .    #
#  $$        ###
# # #     .   #
# $  $ ###. # #
#   #### # @  #
#####    ######
Solution: undefined

;37
#######  #######
# ..  ####@##  #
#     . ##   $ #
##.#  #   $$#  #
 ####.   #  $$ #
    #          #
    ############
Solution: undefined

;38
      ####
 ######  #
##.   $* #
# $#.  . #
#    ### #
###  $  *#
  # .$  @#
  ########
Solution: undefined

;39
      ####
 ######. #
##.   $$ #
# $#..   #
#    ### #
###  $@ *#
  # .$   #
  ########
Solution: undefined

;40
          #####
 ##########. .#
##+#  ## $ $  #
#.    # $    ##
#  #$*$ .  ###
#     #  ###
##########
Solution: undefined

;41
 ######    #####
##... ######. .#
#.  #$ ## $ $  #
#  $@$ # $    ##
## ##$   .  ###
 #    ##  ###
 ##########
Solution: undefined

;42
          ######
###########    #
#@ $.$  .  $ $.#
##.$ $ #. .*$  #
 #.   ###   #  #
 ###### ########
Solution: undefined

;43
#############
#  .#.## .#.###
#.$ $$$ $$$$$ #
#. ..  .   .$@#
###############
Solution: undefined

;44
############
#.#.*.     #
#$$ $.*$ $ #
#@$  .$.  .#
############
Solution: undefined

;45
###########
#.$. .$@$ #
# $  $ ** #
#.  $ .  .#
###########
Solution: undefined

;46
 #########
 #. *+$..#
 ## *#*$##
  #.*    #
###$#  $ #
#  $ $#  #
# .   .$ #
##########
Solution: undefined

;47
   #######
####.. ..#
#.## **$$#
#   *  $ #
# $$#  #@#
##. $.#.##
 #  * $$#
 ###    #
   ######
Solution: undefined

;48
    ########
#####.* #  #
#.   $ .$. #
###** ** * #
  # $   # .#
  #.##$$ #$#
  # .    $@#
  ##########
Solution: undefined

;49
  ########
### . #  #
#  $ *$. #
#* $*... #
#@$   # .#
#*##$$ # #
# .    $ #
##########
Solution: undefined

;50
########
#..*  .#
#.$.$  #
#    $##
#*.$$$ #
#   .$@#
########
Solution: undefined

;51
########
#+*....#
# **$$ #
##$ $  #
# *  $$#
#.     #
########
Solution: undefined

;52
      #########
   #### . ##  #
#### $ $$$ $  #
#.  ..     #  #
########    @ #
     #.      ##
     #########
Solution: undefined

;53
           ###
           #.#
           # #
        ####$##
        #. #  ##
    ##### $##  #
#####  $ $ $ $ #
#..+..$        #
######### ## $ #
        #.##   #
        ########
Solution: undefined

;54
###     ### ###
#.#     #.# #.##
#.#######$###$ #
#  # $ $ $   $ #
#......    $$$ #
#  ######### $ #
####       #@  #
           #####
Solution: undefined

;55
###
#.#         ####
#.###########  #
#.## $ $ $ $ $ #
#.*.  .        #
# @######### $ #
####       #   #
           #####
Solution: undefined

;56
      ###    ###
####  #.######.#
#  ## # # .  . #
# $ ###.$$  $$ #
#     ..  .$@$ #
#   ##$ ########
######  #
     ####
Solution: undefined

;57
            ###
  ###########.#
###.....   #  #
#. $ $ ## $   #
## $ ####*#$  #
 ##.##  #@$  $#
  ###   ###$  #
          #   #
          #####
Solution: undefined

;58
          ####
  ######### .#
  #+  $     $#
  #  ##$ $   #
### ###  #####
# $*.##$ .##
#        ..##
##########  #
        ##  #
        #.$ #
        #####
Solution: undefined

;59
           ###
###       ##.##
#.# ####### ..#
# # #  ##  . ##
#$### $##$#$  #
#+$. .        #
######### $$$ #
        #   ###
        #####
Solution: undefined

;60
        #####
       ##.#@#
      ##....#
 ###### $$ ##
 #   ##$  ###
## $$$  $ $ #
#. .    *.  #
#############
Solution: undefined

;61
###
#.#
#.#############
#.     ... .$.#
#$#$########  #
#       ####  #
# $ $$$ ##.$$##
##.   $ ###@$.#
 ######## #####
Solution: undefined

;62
###
#.#         ###
# ###########.#
#.     . ...* #
# $$########  #
#  $   #####  #
# $  $$ ##.$$##
###     ###  @#
  ####### #####
Solution: undefined

;63
###         ###
#.###########.#
#      ... .$.#
# $$########  #
#   $ ######  #
# $ $   ##.$$##
##.$    ###  @#
 ######## #####
Solution: undefined

;64
     ###
### ##.##
#.###...##
#+*   .$ #
#  $##   #
# $ $  $ #
###  $####
  #  $ #
  ##   #
   #####
Solution: undefined

;65
###############
# *......  $  #
# @* $*##$#   #
#####$ $     ##
    #   $##  #
    ##   #####
     #####
Solution: undefined

;66
      #####
 ###### ..#
##.##.#...#
#.$##     #
# $       #
# #  $$ # #
#$@#$ $ $ #
#  #   ####
########
Solution: undefined

;67
       #####
  ######+..#
  #.##.#**##
 ##$##  $  #
 #.. $ $$  #
## #  $$ ###
#   #.$  #
#   #   ##
#########
Solution: undefined

;68
     ######
######. ..#
#   .# * $#
# $ ###   #
# . . $ $###
#######$ *@#
     # $  ##
     #    #
     ######
Solution: undefined

;69
      #####
 ######.$.#
##  .##   #
# $$### $ #
#....    ###
#######$   #
     # $$* #
     #@$  .#
     #######
Solution: undefined

;70
      ######
  #####..  #
###  ## $. #
#. $ ### $ #
##..   $  ###
####.###$ $ #
#  $.## $$ .#
#. $ ##@    #
#############
Solution: undefined

;71
        #####
  #######..+#
 ##.  ##   ##
 # $ * #$$ #
 # ..  . $###
 ### ###$   #
## $.## $ $ #
#. $ ##     #
#############
Solution: undefined

;72
     #######
  ####...*.#
 ##  .# $  #
 # $$### $ #
 #  . ..  ###
 ### ###$ $ #
## $.##@$$  #
#. $ ##     #
#############
Solution: undefined

;73
       #####
 #######...#
 #   ##  $##
 #$ * #$$@#
 #..  . $###
###.###$   #
# $.##   $ #
#   ##   $.#
############
Solution: undefined

;74
  ###      ####
  #.########@ #
### #... #..$$#
#. $.$$    $$ #
##$$ $ ##$.#  #
 #    .##  ##.#
 ##############
Solution: undefined

;75
#############
# . *. $@$ .#
# #$  *.#$  #
#    ####.$$#
#  .        #
#############
Solution: undefined

;76
#######
#.##  ######
# # ..$. *@#
# # $.  $$$##
# .$$####   #
#        .  #
#############
Solution: undefined

;77
###    #######
#.######. .. #
#.   ## $#$#@#
#  $ # $  . *#
# $$ #   $   #
### .   ######
  #######
Solution: undefined

;78
####   #######
# .## ##.  . #
#.  ### $#.# #
#  $ #   $.$*#
# $  #$$     #
#@# .   ######
#########
Solution: undefined

;79
       #######
##### ##     #
#+  ### $#.# #
#. $ #.  $*..#
# $  #$$$    #
### .   ######
  #######
Solution: undefined

;80
     ######
     #....#
  ####    #
###. ###. ##
#@$  $.    #
# $$$ $ $  #
##   $.#####
 ###   #
   #####
Solution: undefined

;81
       ###
     ###.#
    ##...#  ####
  ### $+ ####  #
 ##   $ #      #
## $ $$## ###  #
# $ $  $  # ####
#.. .    ##
##########
Solution: undefined

;82
       ###
     ###.#
     # ..#######
  ####$.   ##  #
  #     #.     #
### $  ## ###  #
#@ $$$$$ .# ####
# *.      #
###########
Solution: undefined

;83
      ###
    ###.#
   ## ..#
  ## *  #
### $  ##
# $.$ ####
#.$ $  $ #
#.     *@#
##########
Solution: undefined

;84
    #####
   ##...###
  ## *    #
### $  #$ #
#  *  ##@##
#$.  $  $#
#. * $ . #
##########
Solution: undefined

;85
        ######
       ##....#
      ## . ###
      # $  #
      # $ ##
##### # #$#
#   ### #@#
#     $  $#
# # $$.   #
#.#  ######
######
Solution: undefined

;86
        ######
       ##....#
      ##  .###
      # $  #
      # $ ##
####### #$#
# .  ## #@#
#   $ *  $#
#     $   #
###  ##  ##
  ########
Solution: undefined

;87
  ####
  #. ####
### $$  #
#.#@$   #
#. #$  ##
#.* $   #
#.  .$  #
#########
Solution: undefined

;88
    #####
   ##   ##
  ##.$.  #
  #.   $.#
#####$*$$#
#.     *@#
##########
Solution: undefined

;89
######
#....######
###   ## @#
  #  . $$$##
  ## $  $  #
   #####*  #
      #  $ #
      #   ##
      #.###
      ###
Solution: undefined

;90
######
#....######
## .*.##  #
 ##  * $  #
  ##     $##
   #####$$ #
     ##    #
     # $$  #
     #  @###
     #####
Solution: undefined

;91
######
#....######
## ...##  #
 ##.    $ ##
  ## $ $   #
   #####$$ ##
     ##@$   #
     # $ $  #
     #   ####
     #####
Solution: undefined

;92
###
#.#    #####
#+######   ##
#.#.$     $ #
#.*. #$$  $ #
#.$* $  ### #
###         #
  ###########
Solution: undefined

;93
###    #####
#.######   ##
#.# $@$ $$  #
#.. $#$$    #
#...*   ### #
###.  $     #
  ###########
Solution: undefined

;94
 ###
 #.#    #####
 #.######   ##
 #.# $   $   #
##.*. #$     #
#@ *.$ $$### #
####.$       #
   ###########
Solution: undefined

;95
###    #####
#.######   ##
#.# $   $$  #
#** .# $    #
#@*.*   ### #
### *. $    #
  ###########
Solution: undefined

;96
##########
#......  ###
# *$##.$ $ #
#     ##   #
## #$      #
 #  $$#$####
 #### @ #
    #####
Solution: undefined

;97
      ####
 ######. #
## .....$###
# *.##   $ #
#     ## $ #
## #   $ $@#
 #  $$# ####
 ###    #
   ######
Solution: undefined

;98
##########
# .....  ###
# *.##  $  #
#   $@##$  #
## #$$     #
 # $  ######
 ##   #
  #####
Solution: undefined

;99
  #############
 ## $.#.#     #
## .....  #   #
#  *## * ######
#  $@$ $ $ #
###### $ $ #
     ##    #
      ######
Solution: undefined

;100
  #####
 ##   #
## . .##
# *.** #
#    $@#
####$$ #
   #   #
   #####
Solution: undefined

;101
     #####
    ##  .#
    # .*.#
   ##$#..#
   #   **#
####$ $*@#
# $  $  ##
#      ##
#   ####
#####
Solution: undefined

;102
   ###   ***
####.#  *
#. *$# *
#.$*@#*
#  $ #
#    #
######
Solution: undefined

;103
  #########
  #.* #   ###
  #.$  $ $ @#
###.## # $ ##
#  *.   $ ##
#   * #####
##  .##
 ##  #
  ###
Solution: undefined

;104
   ######
 ###  #.######
## ...*.##   #
#  # $ * $ $ #
# $$  #.$@#  #
##    ##     #
 #############
Solution: undefined

;105
     #########
######       #
#  .... ###$ #
#  # .*... $ #
# $ $$# $$$  #
##    ## @#  #
 #############
Solution: undefined

;106
    ####
#####  #####
#    $ $@$ #
#   *..**..#
###  $$. $ #
  #### .#  #
     #######
Solution: undefined

;107
 #####
##   ######
# $ $ $.$@#
#   #....*#
##$ $  .  #
 #  ####  #
 ####  #  #
       ####
Solution: undefined

;108
 #####
##   ######
# $  $ $@ #
#  $# ..**#
##  $ *.* #
 #  #.*#  #
 #### .#  #
    #######
Solution: undefined

;109
 #####
##   ######
# $  *  $ #
#@$ #*....#
##$ $.$  $#
 #  #..#  #
 #######  #
       ####
Solution: undefined

;110
 #####
##   ######
# $  $    #
#  $#.**..#
##   .$@* #
 ## $..#$ #
  ######  #
       ####
Solution: undefined

;111
   ####
   #  ######
   #.......#
   #*.  $ ##
#### $#####
# $  $@#
# # $$ #
#  $ $ #
##     #
 #######
Solution: undefined

;112
   ####
   # .######
   # .*.*+.#
   #.*  $ ##
####* #####
# $  $ #
# #$   #
#  $ $ #
##     #
 #######
Solution: undefined

;113
   ####
   # .#####
   # .....#
   #$. .$ #
#### *#####
# $  $ #
#@# $$ #
# $  $ #
##     #
 #######
Solution: undefined

;114
    ###  ###
 ####.####.#
##.## # $  ##
#.  #@$   $ ###
# $$.$ # #   .#
##   $##     ##
 ####        .#
    ###########
Solution: undefined

;115
      ######
      #.#. #
     ## #. #
 ##### .   #
 #.##  $#.##
## # .$$ $ #
#   $$$ $  #
#   #@ #. ##
###########
Solution: undefined

;116
         ###
  ########.#
 ## *.##.. #
 # $.$ .$  #
## $$ $$   #
#.@$  . ####
#########
Solution: undefined

;117
########
#.##.* #
# $  $@#
#$ $.* #
#.  .$ #
########
Solution: undefined

;118
#########
#.. ##+ #
##$   $ #
 # $$** #
 #.   * #
 ########
Solution: undefined

;119
###############
#.     $.$ *. #
########    $ #
       #$  **+#
       #.   $ #
       ########
Solution: undefined

;120
########
#.$.$. #
#    $ #
#$  **.#
#.   $@#
########
Solution: undefined

;121
########
#.$.$. #
#    $ #
#$. *$.#
#.   $@#
########
Solution: undefined

;122
################
#*.     $.$.$.@#
#   #####    $ #
#####   #$. *$.#
        #.   $ #
        ########
Solution: undefined

;123
################
# .     $.$.$. #
#.$ #####    $@#
#####   #$. *$.#
        #.   $ #
        ########
Solution: undefined


