;1
##############################################
#   #######  #  ### ###    ###    ############
#   #.  ###  .  ###  .#  $ #.# $$ #.  ###  .##
#   ##.  #  .#.  #  .## $ ##.## $ ##*  #  *###
#   @#.$ # $.#.$ # $.#  $ #. .#    #.  #  .# #
#    ##.   .###. $ .## $ ##.$.## $ ##* $ *## #
#     #.   .# #.   .#    #. $ .# $  #.   .#  #
#  $ $##. .## ##.$.## $ ##.#$ .##   ##. .##  #
####   #. .#   #. .# $  #.......# $  #. .# $ #
#**# $ ##.##   ##.##   ##.$ $ $.## $ ##.## $ #
#.*# $$ #.# $ $ #.# $$ #.       .# $  #.#  $ #
# ## $  ### $ $ # # $  ##### ##### $  # #  $ #
#    $ $ $ $ $ $ $ $ $ $ $ $ $ $ $ $ $ $ $ $ #
#                                            #
##############################################
Solution: 39-13u5,36-4u1,37-2l1,37-6u2,38-3l1,42-4u1,41-2r1,41-6u2,40-3r1,38-5r2,41-6u1,40-4r1,39-8u2,40-5l2,37-6u1,38-4l1,42-12l2,39-13u7,40-5l2,44-12l4,39-13u7,38-5r2,44-11l2,41-10d1,42-12l2,39-13u5,40-7l1,38-6d1,44-9l1d2,44-12l4,39-13u5,38-7r1,40-6d1,43-7d4,44-12l4,39-13u6,40-6l1,38-5d1,42-8d3,43-12l3,39-13u6,38-6r1,40-5d1,36-12r2,40-12l1,37-4d1,41-4d1,37-12r1,39-13u7,40-5l2,34-12r4,39-13u7,38-5r2,34-10r1d1,34-12r4,39-13u3,34-9u1,36-9d2,35-12r3,39-13u2,29-6l2,28-6u3,28-8u4,28-10u4,29-5l1,26-10u2,31-9l2,28-10u5,29-4l1,30-12l1,28-13u3,28-8d1,29-10l4,32-12l3,28-13u3,28-8d1,27-10r4,34-12l5,28-13u4,27-8r1,29-9u4,26-12r1,28-13u4,27-8r1,29-9u3,35-8d3,36-12l7,28-13u4,27-8r2,30-9u2,34-6d5,35-12l6,28-13u4,27-8r2,30-9u1,32-5r1,34-4d7,35-12l6,28-13u4,29-8l3,32-6r1,34-5d6,35-12l6,28-13u4,27-8r3,31-1d1r1,33-1d4,32-6r1,34-5d6,35-12l6,28-13u4,29-8l2,31-4u1r1,33-2d3,32-6r1,34-5d6,35-12l6,28-13u4,27-8r2,30-2r2,33-1d4,32-6r1,34-5d6,35-12l6,28-13u4,29-8l1,24-12r3,28-13u4,22-12r5,28-13u3,27-9r1,29-10u1,20-12r7,28-13u3,29-9l3,18-12r9,28-13u3,27-9r3,16-12r1,7-5u1,8-3l1,6-4u1,7-2l1,12-4l1,10-3d1,11-5l3,7-6u2,8-3l1,15-5u1,16-3l1d1l1u1r1u1l3u1l1d2r1d1l1u1l1d1r1d1l3d1l1u1r1u1l1,18-5l2d1l1u2r1u1l1d1l1u1r1u1l3u1l1d2r1d1l1u1l1d1r1d1l3,19-5u1l1u1r1d1r1u1l1u1r1,17-8u2r1u1l2d1l1u2r1u1l1u1d2l1u1r1u1l3u1l1d2r1d1l1u1l1d2r1d1l3,19-12l1d1l1u7r1u1l2d1l1u2r1u1l1d1l1u1r1u1l3u1l1d2r1d1l1u1l1d3l1d2r1u1l1u2r2d1l2u1l1d2,21-9d2r1d1l4d1l1u7r1u1l2d1l1u2r1u1l1d1l1u1r1u1l3u1l1d2r1d1l1u1l1d2r1d1l2u1l1d1,19-10r1d1,21-12l3d1l1u7r1u1l2d1l1u2r1u1l1d1l1u1r1u1l3u1l1d2r1d1l1u1l1d2r1d1l1u1l1d4,21-9d2,22-12l4d1l1u7r1u1l2d1l1u2r1u1l1d1l1u1r1u1l3u1l1d2r1d1l1u1l1d2r1d1l1u1l1d3,21-7d4,22-12l4d1l1u7r1u1l2d1l1u2r1u1l1d1l1u1r1u1l3u1l1d2r1d1l1u1l1d4,22-6d5,23-12l5d1l1u7r1u1l2d1l1u2r1u1l1d1l1u1r1u1l3u1l1d2r1d1l1u1l1d3,24-5l1,22-4d7,23-12l5d1l1u7r1u1l2d1l1u2r1u1l1d1l1u1r1u1l3u1l1d1r1d2l2u1r1,26-2l2,23-1d4,24-6l1,22-5d6,23-12l5d1l1u7r1u1l2d1l1u2r1u1l1d1l1u1r1u1l3u1l1d2l1d1r1,25-3l1,23-2d3,24-6l1,22-5d6,23-12l5d1l1u7r1u1l2d1l1u2r1u1l1d1l1u1r1u1l3u1l1d4,25-4l1,23-3d2,24-6l1,22-5d6,23-12l5d1l1u7r1u1l2d1l1u2r1u1l1d1l1u1r1u1l3u1l1d3,14-12r2d1r1u7r1u1l2d1l1u2r1u1l1d1l1u1r1u1l1,12-12r4d1r1u7r1u1l2d1l1u2r1u1l1,15-10l1d1,13-12r3d1r1u7r1u1d1l2u1r2d1r1u2l1u1r1,10-12r6,17-13u7r1u1l2d1l1u1r1u1l1,13-9d2,12-12r4d1r1u6r1u1l1u1l1d2,11-10r1d1,11-12r5,17-13u6l1u1r1u1r1d2,13-9d2,12-12r4,17-13u6r1u1l1u1l1d1,8-12r8,17-13u6r1u2l2d1u1r2d1l2,6-12r10,17-13u6r1u2l2d1r1d1r1u1l1u1r1d1r1u1l1u1r1,4-12r12d1r1u6r1u2l2d1r2,6-9d2,5-12r11d1r1u6r1u2l2d1r1u1r1d1,4-10r1d1,4-12r12d1r1u7r1u1l2,5-8d3,4-12r12d1r1u7l1u1r2,6-9d2,5-12r11,17-13u3,5-6d5,4-12r12,17-13u2,2-7r1,4-6d5,5-12l3,1-13u2

;2
##############################################
#     ##################### @#################
#     #.  #  .#   #...#   #......####   #...##
#     #.* $ *. #  # . #   #.$ $  .###   # . ##
#     #.$. *#. #  # . #   #*###$ #.##   # . ##
#     #.##. $.#   ##.##   #.# #  $ .#   ##.###
#     #.#####.#   ##.##   #.# #  $ .#   ##.###
####  #.#   #.#   # . #   #*###  #.##   # . ##
#**#  #*#####.#   # . #   #.  $  .###   # . ##
#.*#  #.#   #.#   #...#   #.*....####   #...##
# ##  ###   # #   ## ##   ## ########   ## ###
#                                          # #
#           #  #####  #### #  ########     # #
########################## ########  #  #### #
#  ##   #  #                         #  #    #
#   *   #  #  ############ ##### ### ## #    #
# *### ##  ## #          # #   # ## $   #    #
##  ## ###### # $$$ $$$$$# *   # ## ### ######
### ##        # $ $ $ $  ####*## ## ### ##  ##
##  ##### ##  # $ $ $ $ $ ###  #   $ ##     ##
##$ ##### ####### $ $ $ $ #    # #   #####  ##
##  # #  $  $ $ $ $ $ $ $ $ #  # ## ######*###
##$ $     # $ $ $ $ $ $ $ $ ####         # ###
#        ## $ $ $ $ $ $ $ $    # $ $ $ # *  ##
#        #                     ##  ######   ##
##############################################
Solution: l1d4u3r2d1l1u1l1d2u2r4d1l3u1l1d1u1r5d3l1u1r1u1l4r4d2r2l2d1r2l3d3l2u1r1d1r1u5r1u2l2d1r2l1d5l4d1r1u1r3u4d4l3d3l15u9l2r2d3l2u1l2u2l2d6u6r2d1l1u1l1d5u4r2d1l1u1l1d3u3r1d1r3d1r2u3l2d1l3u1l1d3u2r4u1r2d1l5u1l1d2u1r6d2l2u1d1r2u2l5u1l1d1r6d8r26d8r2l2u8l13d3r6d5r2d1r2u1l1u3r3l2u2l4d8r8d1r1d1r2u1l1u3r1u2l1d1l3u7r1u1l38d1l1u2d1r38d5l4d3l2r2d3l3u7d4r3d3r5d1r1d1r2u1l1u3r1u2l1d1l3u8l13d3r9u1r1d2u1l4d5r3u3r3l3d6r5d1r1d1r2u1l1u3r1u2l1d1l3u7r1u1l11d1l1u3l1u1r3d1r1u5r1u2l2d1r1u1r1d2l1d1r2d1r1u1l3d3l3d3r14l3d5l4d6l1d2l1u1r1u1l1d1l1u8d7r8d1r1d1r2u1l1u3r1u2l1d1l3u8l13d3r9u1r1d2u1l4d5r3u3r3l3d6r5d1r1d1r2u1l1u3r1u2l1d1l3u7r1u1l11d1l1u3l1u1r3d1r1l1u1r1d1r1u3r1u1d1l2u2r1d1l1d1r2u1r1d1l3d2l3d3l2d3r7l1d8r4d1l2d1l1u1r1u1l1d1l1u8d7r8d1r1d1r2u1l1u3r1u2l1d1l3u8l13d3r9u1r1d2u1l4d5r3u3r3l3d6r5d1r1d1r2u1l1u3r1u2l1d1l3u7r1u1l11d1l1u3l1u1r3d1r1u6r1u1l4r3d5,38-23l4d1l1u1r1u1l1d1l1u8,40-23r1d1r2u1l1u3r1u2l1d1l3,31-14r4u1r1d2u1l4d5r3u3r3l3d6r5d1r1d1r2u1l1u3r1u2l1d1l3u7r1u1l11d1l1u3l1u1r3d1r1u6r1u1l3,26-17r2u1r2d1l1d2r1d2l1u1l2d4l16u3l2d1l2u1r1d1r1u3d3l2d1l4u6l1u1l1u2r1d1r3u1r2d1l1d3r6d1r1u4l1u1r23u1r1d2u1l4d5r3u3r3l3d6r5d1r1d1r2u1l1u3r1u2l1d1l3u7r1u1l11d1l1u3l1u1r3d1r1u6r1u1l2,26-17r2u1r2d1l1d2r1d2l1u1l2d4l16u3l4d2l4u1r4d1r1u1l1u1r1d1r1u3d3l6u5l1u1l1u2r1d1r3u1r2d1l1d3r6d1r1u4l1u1r23u1r1d2u1l4d5r3u3r3l3d6r5d1r1d1r2u1l1u3r1u2l1d1l3u7r1u1l11d1l1u3l1u1r3d1r1u6r1u1l1,26-17r2u1r2d1l1d2r1d2l1u1l2d4l16u3l3d1l5u1l1d1r1d2l2u1r6d1r1u2l1u1r1d1r1u3d3l6u5l1u1l1u2r1d1r3u1r2d1l1d3r6d1r1u4l1u1r23u1r1d2u1l4d5r3u3r3l3d6r5d1r1d1r2u1l1u3r1u2l1d1l3u7r1u1l11d1l1u3l1u1r3d1r1u6,26-17r2u1r2d1l1d2r1d2l1u1l2d4l16u3l2d1l6u3l1d2r1l1d1r1d2l2u1r6d1r1u2l1u1r1d1r1u3d3l6u5l1u1l1u2r1d1r3u1r2d1l1d3r6d1r1u4l1u1r23u1r1d2u1l4d5r3u3r3l3d6r5d1r1d1r2u1l1u3r1u2l1d1l3u7r1u1l11d1l1u3l1u1r3d1r1l1u1r1d1r1u6,26-17r2u1r2d1l1d2r1d2l1u1l2d4l14u3l4d1l2u1r1d1r1u3d3l6u5l1u1l1u2r1d1r3u1r2d1l1d3r6d1r1u4l1u1r23u1r1d2u1l4d5r3u3r3l3d6r5d1r1d1r2u1l1u3r1u2l1d1l3u7r1u1l11d1l1u3l1u1r5l4,26-17r2u1r2d1l1d2r1d2l1u1l2d4l14u1l1d1l1u2d1r2u2l4d1l2u1r1d1r1u3d3l6u5l1u1l1u2r1d1r3u1r2d1l1d3r6d1r1u4l1u1r23u1r1d2u1l4d5r3u3r3l3d6r5d1r1d1r2u1l1u3r1u2l1d1l3u7r1u1l11d1l1u3l1u1r3d1r1u4d1r1l1d2,26-17r2u1r2d1l1d2r1d2l1u1l2d4l14u2l1d1l1u1r1u1l3d1l2u1r1d1r1u3d3l6u5l1u1l1u2r1d1r3u1r2d1l1d3r6d1r1u4l1u1r23u1r1d2u1l4d5r3u3r3l3d6r5d1r1d1r2u1l1u3r1u2l1d1l3u7r1u1l11d1l1u3l1u1r4d1r1u2l1u1r1l1d2l3d3l2d6r2u1r2d1l1d2r1d2l1u1l2d4l12u3l6d1l2u1r1d1r1u3d3l6u5l1u1l1u2r1d1r3u1r2d1l1d3r6d1r1u4l1u1r23u1r1d2u1l4d5r3u3r3l3d6r5d1r1d1r2u1l1u3r1u2l1d1l3u7r1u1l11d1l1u3l1u1r4d1r1u2l1,27-17r1u1r2d1l1d2r1d2l1u1l2d4l13r1u2l3d1l1u1r1u1l3d1l2u1r1d1r1u3d3l6u5l1u1l1u2r1d1r3u1r2d1l1d3r6d1r1u4l1u1r23u1r1d2u1l4d5r3u3r3l3d6r5d1r1d1r2u1l1u3r1u2l1d1l3u7r1u1l11d1l1u3l1u1r3d1l2r2,27-17r1u1r2d1l1d2r1d2l1u1l2d4l12u1l3d1l1u2r1u1l3d1l2u1r1d1r1u3d3l6u5l1u1l1u2r1d1r3u1r2d1l1d3r6d1r1u4l1u1r23u1r1d2u1l4d5r3u3r3l3d6r5d1r1d1r2u1l1u3r1u2l1d1l3u7r1u1l11d1l1u3r1u1l1r1d1r3u2l1d1r1d1l2r1u4r1u2l1d5r1d1l1u4r1d3u3r2d1l2u1l1d3l3,27-17r1u1r2d1l1d2r1d2l1u1l2d4l10u3l8d1l2u1r1d1r1u3d3l6u5l1u1l1u2r1d1r3u1r2d1l1d3r6d1r1u4l1u1r23u1r1d2u1l4d5r3u3r3l3d6r5d1r1d1r2u1l1u3r1u2l1d1l3u7r1u1l26d1l1u8r1u1l5d1l1u1r1u1l1,27-17r1u1r2d1l1d2r1d2l1u1l2d4l10u1l5d1l1u2r1u1l3d1l2u1r1d1r1u3d3l6u5l1u1l1u2r1d1r3u1r2d1l1d3r6d1r1u4l1u1r23u1r1d2u1l4d5r3u3r3l3d6r5d1r1d1r2u1l1u3r1u2l1d1l3u7r1u1l26d1l1u8r1u1l4d1l2u2r1d1,27-17r1u1r2d1l1d2r1d2l1u1l2d4l10u2l5d1l1u1r1u1l3d1l2u1d1u1r1d1r1u3d3l6u5l1u1l1u2r1d1r3u1r2d1l1d3r6d1r1u4l1u1r23u1r1d2u1l4d5r3u3r3l3d6r5d1r1d1r2u1l1u3r1u2l1d1l3u7r1u1l26d1l1u8r1u1l6,27-17r1u1r2d1l1d2r1d2l1u1l2d4l8u3l10d1l2u1r1d1r1u3d3l6u5l1u1l1u2r1d1r3u1r2d1l1d3r6d1r1u4l1u1r23u1r1d2u1l4d5r3u3r3l3d6r5d1r1d1r2u1l1u3r1u2l1d1l3u7r1u1l26d1l1u8r1u1l5,27-17r1u1r2d1l1d2r1d2l1u1l2d4l8u1l7d1l1u2r1u1l3d1l2u1r1d1r1u3d3l7r1u5l1u1l1u2r1d1r3u1r2d1l1d3r6d1r1u4l1u1r23u1r1d2u1l4d5r3u3r3l3d6r5d1r1d1r2u1l1u3r1u2l1d1l3u7r1u1l26d1l1u8r1u1l2u1l1d1r2d4,27-17r1u1r2d1l1d2r1d2l1u1l2d4l8u2l7d1l1u1r1u1l3d1l2u1r1d1r1u3d3l6u5l1u1l1u2r1d1r3u1r2d1l1d3r6d1r1u4l1u1r23u1r1d2u1l4d5r3u3r3l3d6r5d1r1d1r2u1l1u3r1u2l1d1l3u7r1u1l26d1l1u8r1u1l1,27-17r1u1r2d1l1d2r1d2l1u1l2d4l6u3l12d1l2u1r1d1r1u3d3l6u5l1u1l1u2r1d1r3u1r2d1l1d3r6d1r1u4l1u1r23u1r1d2u1l4d5r3u3r3l3d6r5d1r1d1r2u1l1u3r1u2l1d1l3u7r1u1l26d1l1u9,27-17r1u1r2d1l1d2r1d2l1u1l2d4l8u8l2d5r1d1l6d1l1u1r1u1l3d1l2u1r1d1r1u3d3l6u5l1u1l1u2r1d1r3u1r2d1l1d3r6d1r1u4l1u1r23u1r1d2u1l4d5r3u3r3l3d6r5d1r1d1r2u1l1u3r1u2l1d1l3u7r1u1l26d1l1u8,27-17r1u1r2d1l1d2r1d2l1u1l2d4l10u8l2r1l1d1r1u1r1d5r1d1l6d1l1u1r1u1l3d1l2u1r1d1r1u3d3l6u5l1u1l1u2r1d1r3u1r2d1l1d3r6d1r1u4l1u1r23u1r1d2u1l4d5r3u3r3l3d6r5d1r1d1r2u1l1u3r1u2l1d1l3u7r1u1l26d1l1u7,27-17r1u1r2d1l1d2r1d2l1u1l2d4l10u7l2d1r1u1r1d4r1d1l6d1l1u1r1u1l3d1l2u1r1d1r1u3d3l6u5l1u1l1u2r1d1r3u1r2d1l1d3r6d1r1u4l1u1r23u1r1d2u1l4d5r3u3r3l3d6r5d1r1d1r2u1l1u3r1u2l1d1l3u7r1u1l26d1l1u6,27-17r1u1r2d1l1d2r1d2l1u1l2d4l10u6l2d1r1u1r1d3r1d1l6d1l1u1r1u1l3d1l2u1r1d1r1u3d3l6u5l1u1l1u2r1d1r3u1r2d1l1d3r6d1r1u4l1u1r23u1r1d2u1l4d5r3u3r3l3d6r5d1r1d1r2u1l1u3r1u2l1d1l3u7r1u1l26d1l1u5,27-17r1u1r2l1r1d1l1d2r1d2l1u1l2d4l10r2u7l1u1l1d5r1d1l6d1l1u1r1u1l3d1l2u1r1d1r1u3d3l6u5l1u1l1u2r1d1r3u1r2d1l1d3r6d1r1u4l1u1r23u1r1d2u1l4d5r3u3r3l3d6r5d1r1d1r2u1l1u3r1u2l1d1l3u7r1u1l26d1l1u4,27-17r1u1r2d1l1d2r1d2l1u1l2d4l9r1u6l1u1l1d4r1d1l6d1l1u1r1u1l3d1l2u1r1d1r1u3d3l6u5l1u1l1u2r1d1r3u1r2d1l1d3r6d1r1u4l1u1r23u1r1d2u1l4d5r3u3r3l3d6r5d1r1d1r2u1l1u3r1u2l1d1l3u7r1u1l26d1l1u3,27-17r1u1r2d1l1d2r1d2l1u1l2d4l9r1u5l1u1l1d3r1d1l6d1l1u1r1u1l3d1l2u1r1d1r1u3d3l6u5l1u1l1u2r1d1r3u1r2d1l1d3r6d1r1u4l1u1r23u1r1d2u1l4d5r3u3r3l3d6r5d1r1d1r2u1l1u3r1u2l1d1l3u7r1u1l26d1l1u2,27-17r1u1r2d1l1d2r1d2l1u1l2d4l9u2r1u3l1d1r1d1l10d1l2u1r1d1r1u3d3l6u5l1u1l1u2r1d1r3u1r2d1l1d3r6d1r1u4l1u1r23u1r1d2u1l4d5r3u3r3l3d6r5d1r1d1r2u1l1u3r1u2l1d1l3u7r1u1l19d1l1u3r1u1l1u1l1d1r1d1,27-17r1u1r2d1l1d2r1d2l1u1l2d4l6u2l9d1l1u1r1u1l3d1l2u1r1d1r1u3d3l6u5l1u1l1u2r1d1r3u1r2d1l1d3r6d1r1u4l1u1r23u1r1d2u1l4d5r3u3r3l3d6r5d1r1d1r2u1l1u3r1u2l1d1l3u7r1u1l11d1l1u2,27-17r1u1r2d1l1d2r1d2l1u1l2d4l6u1l9d1l1u2r1u1l3d1l2u1r1d1r1u3d3l6u5l1u1l1u2r1d1r3u1r2d1l1d3r6d1r1u4l1u1r23u1r1d2u1l4d5r3u3r3l3d6r5d1r1d1r2u1l1u3r1u2l1d1l3u7r1u1l19d1l1u3r1u2l2d1r1u1r1d1l1,27-17r1u1r2d1l1d2r1d2l1u1l2d4l4u1l11d1l1u2r1u1l3d1l2u1r1d1r1u3d3l6u5l1u1l1u2r1d1r3u1r2d1l1d3r6d1r1u4l1u1r23u1r1d2u1l4d5r3u3r3l3d6r5d1r1d1r2u1l1u3r1u2l1d1l3u7r1u1l19d1l1u8r1u1l1d1l1u1,27-17r1u1r2d1l1d2r1d2l1u1l2d4l4u2l11d1l1u1r1u1l3d1l2u1r1d1r1u3d3l6u5l1u1l1u2r1d1r3u1r2d1l1d3r6d1r1u4l1u1r23u1r1d2u1l4d5r3u3r3l3d6r5d1r1d1r2u1l1u3r1u2l1d1l3u7r1u1l19d1l1u8l1u1r1d1r1u1,27-17r1u1r2d1l1d2r1d2l1u1l2d4l4u3l14d1l2u1r1d1r1u3d3l6u5l1u1l1u2r1d1r3u1r2d1l1d3r6d1r1u4l1u1r23u1r1d2u1l4d5r3u3r3l3d6r5d1r1d1r2u1l1u3r1u2l1d1l3u7r1u1l19d1l1u9,27-17r1u1r2d1l1d2r1d2l1u1l2d4l9u8r3d5r1d1l10d1l1u1r1u1l3d1l2u1r1d1r1u3d3l6u5l1u1l1u2r1d1r3u1r2d1l1d3r6d1r1u4l1u1r23u1r1d2u1l4d5r3u3r3l3d6r5d1r1d1r2u1l1u3r1u2l1d1l3u7r1u1l19d1l1u8,27-17r1u1r2d1l1d2r1d2l1u1l2d4l6u4l3u1l1d1r1d1l9d1l2u1r1d1r1u3d3l6u5l1u1l1u2r1d1r3u1r2d1l1d3r6d1r1u4l1u1r23u1r1d2u1l4d5r3u3r3l3d6r5d1r1d1r2u1l1u3r1u2l1d1l3u7r1u1l19d1l1u7,27-17r1u1r2d1l1d2r1d2l1u1l2d4l6u5l2u1l1d2r1d1l10d1l2u1r1d1r1u3d3l6u5l1u1l1u2r1d1r3u1r2d1l1d3r6d1r1u4l1u1r23u1r1d2u1l4d5r3u3r3l3d6r5d1r1d1r2u1l1u3r1u2l1d1l3u7r1u1l19d1l1u6,27-17r1u1r2d1l1d2r1d2l1u1l2d4l2u3l16d1l2u1r1d1r1u3d3l6u5l1u1l1u2r1d1r3u1r2d1l1d3r6d1r1u4l1u1r23u1r1d2u1l4d5r3u3r3l3d6r5d1r1d1r2u1l1u3r1u2l1d1l3u7r1u1l19d1l1u5,27-17r1u1r2d1l1d2r1d2l1u1l2d1l18d1l2u1r1d1r1u3d3l6u5l1u1l1u2r1d1r3u1r2d1l1d3r6d1r1u4l1u1r23u1r1d2u1l4d5r3u3r3l3d6r5d1r1d1r2u1l1u3r1u2l1d1l3u7r1u1l19d1l1u4,27-17r1u1r2d1l1d2r1d2l1u1l2d1l2d1l13d1l1u1r1u1l3d1l2u1r1d1r1u3d3l6u5l1u1l1u2r1d1r3u1r2d1l1d3r6d1r1u4l1u1r23u1r1d2u1l4d5r3u3r3l3d6r5d1r1d1r2u1l1u3r1u2l1d1l3u7r1u1l19d1l1u3,27-17r1u1r2d1l1d2r1d2l1u1l2d2l15d1l1u1r1u1l3d1l2u1r1d1r1u3d3l6u5l1u1l1u2r1d1r3u1r2d1l1d3r6d1r1u4l1u1r23u1r1d2u1l4d5r3u3r3l3d6r5d1r1d1r2u1l1u3r1u2l1d1l3u7r1u1l19d1l1u2,27-17r1u1r2d1l1d2r1d2l1u1l2d2l2d1l13d1l1u2r1u1l3d1l2u1r1d1r1u3d3l6u5l1u1l1u2r1d1r3u1r2d1l1d3r6d1r1u4l1u1r23u1r1d2u1l4d5r3u3r3l3d6r5d1r1d1r2u1l1u3r1u2l1d1l3u7r1u1d1l2u1r3d1r1u3r1u1l1u1l1d1r1d3,27-17r1u1r2d1l1d2r1d2l1u1l2d3l15d1l1u2r1u1l3d1l2u1r1d1r1u3d3l6u5l1u1l1u2r1d1r3u1r2d1l1d3r6d1r1u4l1u1r23u1r1d2u1l4d5r3u3r3l3d6r5d1r1d1r2u1l1u3r1u2l1d1l3u7l1u1r3d1r1u3r1u2l2d1r1u1r1d1,27-17r1u1r2d1l1d2r1d2l1u1l2d2l6u6r2d5r1d1l12d1l1u1r1u1l3d1l2u1r1d1r1u3d3l6u5l1u1l1u2r1d1r3u1r2d1l1d3r6d1r1u4l1u1r23u1r1d2u1l4d5r3u3r3l3d6r5d1r1d1r2u1l1u3r1u2l1d1l3u7l1u1r3d1r1u8r1u1l1d1l1u1,27-17r1u1r2d1l1d2r1d2l1u1l2d2l6u5l1u1l1d4r1d1l11d1l2u1r1d1r1u3d3l6u5l1u1l1u2r1d1r3u1r2d1l1d3r6d1r1u4l1u1r23u1r1d2u1l4d5r3u3r3l3d6r5d1r1d1r2u1l1u3r1u2l1d1l3u7l1u1r3d1r1u8l1u1r1d1r1u1,27-17r1u1r2d1l1d2r1d2l1u1l2d1l6u4l1d3r1d1l12d1l2u1r1d1r1u3d3l6u5l1u1l1u2r1d1r3u1r2d1l1d3r6d1r1u4l1u1r23u1r1d2u1l4d5r3u3r3l3d6r5d1r1d1r2u1l1u3r1u2l1d1l3u7l1u1r3d1r1u9,27-17r1u1r2d1l1d2r1d2l1u1l2d1l4u4l1u1l1d4l1d2r2u1l13d1l2u1r1d1r1u3d3l6u5l1u1l1u2r1d1r3u1r2d1l1d3r6d1r1u4l1u1r23u1r1d2u1l4d5r3u3r3l3d6r5d1r1d1r2u1l1u3r1u2l1d1l3u7l1u1r3d1r1u8,27-17r1u1r2l1r1d1l1d2r1d2l1u1l2d1l4u3l1u1l1d4r1d1l10d1l1u1r1u1l3d1l2u1r1d1r1u3d3l6u5l1u1l1u2r1d1r3u1r2d1l1d3r6d1r1u4l1u1r23u1r1d2u1l4d5r3u3r3l3d6r5d1r1d1r2u1l1u3r1u2l1d1l3u7l1u1r3d1r1u7,27-17r1u1r2d1l1d2r1d2l1u1l2d1l4u2l2u1l1d2r1d1l12d1l2u1r1d1r1u3d3l6u5l1u1l1u2r1d1r3u1r2d1l1d3r6d1r1u4l1u1r23u1r1d2u1l4d5r3u3r3l3d6r5d1r1d1r2u1l1u3r1u2l1d1l3u7l1u1r3d1r1u6,27-17r1u1r2d1l1d2r1d2l1u1l2d1l4u2l1d1r1d1l14d1l2u1r1d1r1u3d3l6u5l1u1l1u2r1d1r3u1r2d1l1d3r6d1r1u4l1u1r23u1r1d2u1l4d5r3u3r3l3d6r5d1r1d1r2u1l1u3r1u2l1d1l3u7l1u1r3d1r1u5,27-17r1u1r2d1l1d2r1d2l1u1l2d1l2u1l4u1l1d1r1d1l12d1l2u1r1d1r1u3d3l6u5l1u1l1u2r1d1r3u1r2d1l1d3r6d1r1u4l1u1r23u1r1d2u1l4d5r3u3r3l3d6r5d1r1d1r2u1l1u3r1u2l1d1l3u7l1u1r3d1r1u4,27-17r1u1r2d1l1d2r1d2l1u1l2d1l2u2l2u1l1d1r1l1d1r1d1l14d1l2u1r1d1r1u3d3l6u5l1u1l1u2r1d1r3u1r2d1l1d3r6d1r1u4l1u1r23u1r1d2u1l4d5r3u3r3l3d6r5d1r1d1r2u1l1u3r1u2l1d1l3u7l1u1r3d1r1u3,27-17r1u1r2d1l2r1d2r1d2l1u2d1l2d1l4u5r1d4r1d1l16d1l2u1r1d1r1u3d3l6u5l1u1l1u2r1d1r3u1r2d1l2r1d3r6d1r1u4l1u1r23u1r1d2u1l4d5r3u3r3l3d6r5d1r1d1r2u1l1u3r1u2l1d2u1l3u7l1u1r3d1r1u2

;3
##############################################
##############################################
#          #####   # @########        #.#    #
#   $$####*.*..# $$#......####     $ ##*##$$ #
#     ###.  ## #   #.$ $  .###     $  .$.    #
#   # ##.$  ## # $$#*###$ #.##      ##.$.##  #
#     #.$  ##  #   #.# #  $ .#      #.$  .#  #
#    $#.$ ## $ # $$#.# #  $ .#     ##.$ $.## #
####  ##.   $  #   #*###  #.##     #.......# #
#**#  ## .#   ## $$#.  $  .###    ##.$$ $$.# #
#.*#  ####..*..#   #.*....####    #*  # #  .##
# ##  #####  ###  $## ########     #### ######
#    $ $ $ $ $ $  $ $  $ $ $ $   $ $ $ $ $ $ #
#                                            #
##############################################
Solution: 20-4d2,22-4l1,20-3d2,24-4l3,20-3d1,24-6u1,25-4l4,25-7r2,25-6r2,22-9r3,20-10r1,9-7l1,9-6l1,11-3r1,13-8l3,12-7r1,14-8u4,11-10r2,10-2d1,8-5r1,9-4r1,10-6u1,11-5u1,9-4r1,10-3r1,11-5u1,9-9u4,11-13u4,12-8l2,9-9u3,8-12r2,11-13u4,12-8l2,9-9u1,8-5r1,10-6u2,6-12r4,11-13u4,12-8l3,8-9u3,9-6d2,6-12l4,1-13u2,5-6d5,4-12r6,11-13u4,12-8l3,5-2d9,4-12r6,11-13u2,12-10l1,14-12l1,12-13u2,11-10r1,3-3r1,5-2d9,4-12r6,11-13u2,16-12l3,12-13u2,19-12r1,21-13u3,20-9r3,24-10u5,23-4r2,17-12r3,21-13u3,20-9r3,24-10u5,23-4r1,25-3d3,24-7r2,27-6d1,18-10d1,17-12r3,21-13u3,20-9r3,24-10u5,23-4r1,25-3d2,24-6r2,27-7u1,17-8d3,16-12r4,21-13u3,20-9r4,25-10u2,24-7r1,18-8d3,17-12r3,21-13u3,20-9r3,24-10u6,25-3l4,17-6d5,16-12r4,21-13u3,20-9r3,24-10u6,25-3l3,18-6d5,17-12r3,21-13u3,20-9r3,24-10u6,25-3l2,17-4d7,16-12r4,21-13u3,20-9r3,24-10u6,25-3l1,18-4d7,17-12r3,21-13u3,20-9r3,24-10u6,17-2d9,16-12r4,21-13u3,20-9r4,25-10u6,24-12l2,21-13u3,20-9r3,24-10u4,26-12l4,21-13u3,20-9r4,25-10u2,28-12l6,21-13u3,20-9r3,23-10l2,30-12l8,21-13u3,22-9l1,24-8d1,25-10l2,24-4d5,25-10l1,25-6d3,27-7l2,24-6d3,18-2d9,17-12r3,21-13u2,36-4l2,33-3d3,33-13u1,36-12l2,38-12l2,40-12l2,40-4l6,33-3d1,39-4u1,39-6u2,41-10u1,42-8l1,39-9r2,42-8d1,41-10r1,39-8r2,40-6d2,39-9r2,37-10u1,36-8r3,39-9l2,41-8l4,39-7l1,39-6l1,42-12l2,39-13u4,40-8l2,44-12l4,39-13u4,38-8r2,41-9u2,43-2d1,44-4l10,42-2d1,43-4l3,38-4r1,35-2d1,34-4r3,36-12r2,39-13u6,40-6l1,38-7u1,34-12r4,39-13u6,38-6r1,40-7u1,32-12r6,39-13u5,38-7r2,33-10d1,32-12r6,39-13u4,38-8r2,33-6d5,32-12r6,39-13u4,40-8l1,32-4r1d7,32-12r6,39-13u5,38-7r1,40-6d1,35-4l1,33-3d8,32-12r6,39-13u4

;4
##############################################
##############################################
#     #.  #  .#     #.....  #     #....  #   #
#   $$#.* $ *. # $$$#.    .  #    #####*  #  #
#     #.$. *#. #    #.##   . #    ##### . #  #
#   $$#.##. $.#  $$$#.#####.#     #####* #   #
#     #.#####.#     #.##  . #     #..*.  #$$ #
#    $#.#   #.#  $$$#.....  #  @  #####. #   #
####  #*# $$#.#$    #*###   #     ######*#$$ #
#**#  #.#   #.#  $$$#.#   ###     #####. #   #
#.*#  #.# $$#.#$    #.#   ###     #.*..  #$$ #
# ## $###   # #     #### ####     #####  #   #
#    $ $ $ $ $ $ $ $ $ $ $ $ $ $ $ $ $ $ $ $ #
#                                            #
##############################################
Solution: 6-12l4d1l1u2d2r7u1l1d1r3u1l1d1r3u1l1d1r3u1l1u10l2r2d3l2u1l2u2l2d7u7r2d2l1r1u2l2d6u4r2u1l1u1l1d5u3r4d1r2u3l2d1l3u1l1d4u2r2u1r2u1r2d1l5u1l1d3u1r2u1r4d3u1l2u1d1r2u2l5u1l1d2,11-12r1d1r1u9r1u1l6u1l1d1,9-12r3d1r1u9r1u1l5d1l1u1r1u1l1,7-12r5d1r1u9r1u1l4d1l2u2r1d1,11-9l2r2d2l1d1r2d1r1u9r1u1l6,10-9d2l1d1r3d1r1u9r1u1l5,11-7d4l1d1r2d1r1u9r1u1l2u1l1d1,5-12r7d1r1u9r1u1l1,5-10d1l1d1r8d1r1u10d2,10-7d4l1d1r3d1r1u9,5-6d5l1d1r8d1r1u8,5-4d7l1d1r8d1r1u7,3-5r1u1r1d7l1d1r8d1r1u6,5-2d9l1d1r8d1r1u5,3-3d1u1r1u1r1d9l1d1r8d1r1u4d4r3u1l2d1l1u3d2r3u3l1d2r1d1l2d1l1u2,21-7d2,22-12r1d1r1u3l1u1r1d1r1u3l1u1r2d1r1u3r1u1l3d1u1l3u1l1d6,20-12r3d1r1u3l1u1r1d1r1u3l1u1r2d1r1u3r1u1l6u1l1d5,18-12r5d1r1u3l1u1r1d1r1u2r1u1l4,16-12r7d1r1u3l1u1r1d1r1u3l1u1r2d1r1u3r1u1l6u1l1d3,19-8d3l1d1r5d1r1u3l1u1r1d1r1u3l1u1r2d1r1u3r1u1l6u1l1d2,18-8d3l1d1r6d1r1u3l1u1r1d1r1u3l1u1r2d1r1u3r1u1l6u1l1d1,16-9r2u1r1d3l1d1r5d1r1u3l1u1r1d1r1u3l1u1r2d1r1u3r1u1l6,15-7d4r1d2l2u1r9d1r1u3l1u1r1d1r1u3l1u1r2d1r1u3r1u1l1d1l1u1r1u1l5,19-6d5l1d1r5d1r1u3l1u1r1d1r1u3l1u1r2d1r1u3r1u1l1d1l1u1r1u1l4,18-6d5l1d1r6d1r1u3l1u1r1d1r1u3l1u1r2d1r1u3r1u1l1d1l1u1r1u1l3,16-7r2u1r1d5l1d1r5d1r1u3l1u1r1d1r1u3l1u1r2d1r1u3r1u1l1d1l1u1r1u1l2,19-4d7l1d1r5d1r1u3l1u1r1d1r1u3l1u1r2d1r1u3r1u1l1d1l1u1r1u1l1,18-4d7l1d1r6d1r1u3l1u1r1d1r1u3l1u1r2d1r1u3r1u1l1,16-5r2u1r1d7l1d1r5d1r1u3l1u1r1d1r1u3l1u1r2d1r1u2,19-2d9l1d1r5d1r1u3l1u1r1d1r1u3l1u1r2d1r1u1,18-2d9l1d1r6d1r1u3l1u1r1d1r1u3l1u1r1,16-3r2u1r1d8l1d1u1r1d1l1d1r5d1r1u3l1u1r1d1r1u2r1u1l3r2d3l1d3r2u1l1d1l1u3l1u1r1d1r1u2r1u1l2r1d3l1d3r4u1l3d1l1u3l1u1r1d1r1u2r1u1l1d3l1d3r6u1l5d1l1u3l1u1r1d1r1u2,37-10l1r4u3l1u1l3r3d1r1u3l1d1r1d1l3r2u3d1r2u1l1u1l4r4d2l1u1r1u1l3r3d11l2r1u2r1u1l3r2d3l3u1r2d1r1u2r1u1l2r1d3l5u1r4d1r1u2r1u1l1r1d3l8u1r7d1r1u9r1u1l1d1l1u1r1u1l2r1d3r1d7l7d1l3u1r9d1r1u8l1u2r2d1l1u1l1d2r1d1l2r2d7r2u1l1d1l1u8l1u2r2d1l1u1l1d2r1d1l1r1d7r4u1l3d1l1u9r1u1l1d1l1u1r1u1l1r1d10r4u3l2d2r1d1l2d1l1u8l1u2r2d1l1u1l1d3r1d6r4u3l1d2r1d1l3d1l1u8l1u2r2d1l1u1l1d1r1d8r4u5l2d4r1d1l2d1l1u9r1u1l1d9r4u5l1d4r1d1l3d1l1u8d7r4u7l2d6r1d1l2d1l1u4d3r4u7l1d6r1d1l4d1l1u3

;5
##############################################
###########  #################################
#####.  ###  .  ###  .# #.  #  .#     #.#    #
######.  #  .#.  #  .## #.* $ *. # $ ##*##$$ #
#   @#.$ # $.#.$ # $.#  #.$. *#. # $  .$.    #
#    ##. $ .###. $ .##  #.##. $.#   ##.$.##  #
#  $  #. $ .# #. $ .# $ #.#####.# $ #.$  .#  #
#  $ $##.$.## ##.$.## $ #.#   #.# $##.$ $.## #
####   #. .#   #. .#  $ #*#$$ #.#  #.......# #
#**# $ ##*##   ##.## $  #.#   #.# ##.$$ $$.# #
#.*#  $ #.# $ $ #.#  $ $#.#$$ #.# #*  # #  .##
# ## $  ### $ $ # #  $  ###   # #  #### ######
#    $ $ $ $ $ $ $ $ $ $ $ $ $ $ $ $ $ $ $ $ #
#                                            #
##############################################
Solution: 6-12l4,1-13u2,8-12l1,10-12l1,12-12l1,14-12l1,16-12l1,18-12l1,9-8d1,7-5u1,8-3l1,6-4u1,7-2l1,10-5l2,7-6u2,8-3l1,10-6l1,8-7u1,9-5l1,7-6u1,8-4l1,9-8u2,10-5l2,7-4d1,12-4l1,10-3d2,11-6l1,9-5d3,15-5u1,16-3l1,14-4u1,15-2l3,11-1d2,12-4l1,10-3d2,11-6l2,8-5d2,18-5l2,15-6u2,16-3l1,14-4u1,15-2l3,11-1d2,12-4l1,10-3d2,11-6l2,8-5d1,18-6l1,16-7u1,17-5l1,15-6u2,16-3l1,14-4u1,15-2l3,11-1d2,12-4l1,10-3d1,11-5l3,19-5u1,18-3r1,20-4u1,19-2r1,17-8u2,18-5l2,15-6u2,16-3l1,14-4u1,15-2l3,11-1d2,12-4l1,10-3d4,15-12r1,17-13u7,18-5l2,15-6u2,16-3l1,14-4u1,15-2l3,11-1d2,12-4l1,10-3d3,13-12r3,17-13u7,18-5l2,15-6u2,16-3l1,14-4u1,15-2l3,11-1d1,10-3r1,11-12r5,17-13u7,18-5l2,15-6u2,16-3l1,14-4u1,15-2l3,11-1d2,10-4r1,15-10l1d1,13-12r3,17-13u7,18-5l2,15-6u2,16-3l1,14-4u1,15-2l3,11-1d4,13-9d2,12-12r4,17-13u7,18-5l2,15-6u2,16-3l1,14-4u1,15-2l3,11-1d3,11-10r1d1,11-12r5,17-13u7,18-5l2,15-6u2,16-3l1,14-4u1,15-2l1,13-9d2,12-12r4,17-13u7,18-5l2,15-6u2,16-3l1,9-12r7,17-13u7,16-5r2,19-6u2,18-3r1,7-12r9,17-13u7,16-5r2,19-6u1,18-4r1,5-12r11,17-13u7,18-5l2,15-6u1,16-4l1,5-10d1,4-12r12,17-13u5,18-7l1,16-6d1,6-9d2,5-12r11,17-13u5,16-7r1,18-6d1,5-8d3,4-12r12,17-13u6,18-6l1,16-5d1,5-6d5,3-12r13,17-13u6,16-6r1,18-5d1,2-6r1,4-5d6,3-12r13,17-13u7,18-5l2,15-4d1,2-7r2,5-6d5,4-12r12,17-13u7,16-5r2,19-4d1,20-12l2,17-13u7,18-5l2,22-12l4,17-13u7,16-5r2,24-12l6,17-13u3,23-9d2,24-12l6,17-13u2,26-12l1,28-12l1,30-12l1,32-12l1,31-5l2u1,25-7d2,27-4l1,25-3d5,27-3l1,25-2d5,29-2d1l3,25-2d4,31-3l5,25-2d3,29-5u1,30-3l4,25-2d2,29-12r1,31-13u9,32-3l6,25-2d1,27-12r3,31-13u9,32-3l6,25-12r5,31-13u9,32-3l5,26-4u1,27-2l1,23-12r7,31-13u9,32-3l4,27-2d1,27-9d2,26-12r4,31-13u9,32-3l5,27-7d4,26-12r4,31-13u9,32-3l2,29-2d1,28-9d2,27-12r3,31-13u9,32-3l1,28-7d4,27-12r3,31-13u10,20-11r2,23-10d1,22-12r8,31-13u9,20-10r2,23-9d2,22-12r8,31-13u8,21-8d3,20-12r10,31-13u7,21-7r1d4,21-12r9,31-13u6,22-7u1,23-6d5,22-12r8,31-13u5,22-4d7,21-12r9,31-13u4,34-12l2,31-13u3,36-12l4,31-13u2,35-6l1,33-5d6,34-12l7,34-8u1,35-6l1,33-5d6,34-12l5,36-4l1,34-3d2,35-6l1,33-5d6,34-12l3,38-12l1,40-12l1,42-12l1,40-4l1u1,39-6u2l4,34-3d2,35-6l1,33-5d6,34-12l1,27-12l2,29-12l2,31-12l2,33-12l2,43-2d1,44-4l9,34-3d2,35-6l1,33-5d6,42-2d1,43-4l3,38-4r1,35-2d1,34-4r3,37-6r1,40-6d1,41-10u3,39-9r2,42-8d1,41-10r1,40-7d1,39-9r2,37-10u1r1,38-8l1,40-9l3,39-7l1,40-6l2,41-12l1,39-13u5,38-7r2,44-12l4,39-13u7,40-5l1,37-12r1,39-13u6,38-6r1,40-7u1,35-12r3,39-13u4,40-8l2,32-12r6,39-13u4,38-8r3,29-12r9,39-13u4,38-8r2,27-12r11,39-13u4,40-8l1,25-12r13,39-13u5,38-7r1,40-6d1,23-12r15,39-13u4

;6
                 ##############################
                #                              #
               #  ############################  #
              #  #                            #  #
             #  #  ##########################  #  #
            #  #  #                          #  #  #
           #  #  #  ########################  #  #  #
          #  #  #  #                        #  #  # #
         #  #  #  #  ######################  #  # #  #
        #  #  #  #  #                      #  # #  # #
       #  #  #  #  #  ####################  # #  # #  #
      #  #  #  #  #  #                    # #  # #  #  #
     #  #  #  #  #  #  ################## #  # #  #  # #
     # #  #  #  #  #  #                 #  # #  #  # # #
    #  # #  #  #  #  #  ###############  # #  #  # # # #
   #  #  # #  #  #  #  #               # #  #  # # # # #
   # #  #  # #  #  #  #  ############# #  #  # # # # # #
   # # #  #  # #  #  #  #            #  #  # # # # # # #
   # # # #  #  # #  #  #  ##########  #  # # # # # # # #
   # # # # #  #  # #  #  #          #  # # # # # # # # #
   # # # # # #  #  # #  #  ########  # # # # # # # # # #
   # # # # # # #  #  # #  ##       # # # # # # # # # # #
   # # # # # # # #  #  # #   ##### # # # # # # # # # # #
   # # # # # # # # #  #  # ###   # # # # # # # # # # # #
   # # # # # # # # # #  #  #@$ # # # # # # # # # # # # #
   # # # # # # # # # # #  #  #.# # # # # # # # # # # # #
   # # # # # # # # # # # #  #### # # # # # # # # # # # #
   # # # # # # # # # # #   #  #  # # # # # # # # # # # #
   # # # # # # # # # #  ###     #  # # # # # # # # # # #
   # # # # # # # # #  #     ####  ## # # # # # # # # # #
   # # # # # # # #  #  #####     #   # # # # # # # # # #
   # # # # # # #  #  #       ####  ##  # # # # # # # # #
   # # # # # #  #  #  #######     #   #  # # # # # # # #
   # # # # #  #  #  #         ####  ##  #  # # # # # # #
   # # # #  #  #  #  #########     #   #  #  # # # # # #
   # # #  #  #  #  #           ####  ##  #  #  # # # # #
   # #  #  #  #  # ############     #   #  #  #  # # # #
####  #  #  #  # #              ####  ##  #  #  #  # # #
#   #  #  #  # #  ##############     #   #  #  #  #  # #
# #  #  #  # #  #                ####  ##  #  #  #  #  #
#  #  #  # #  #  ################     #   #  #  #  #  #
 #  #  # #  #  #                  ####  ##  #  #  #  #
  #  # #  #  #  ##################     #   #  #  #  #
   # #  #  #  #                    ####  ##  #  #  #
   #  #  #  #  ####################     #   #  #  #
    #  #  #  #                      ####  ##  #  #
     #  #  #  ######################     #   #  #
      #  #  #                        ####  ##  #
       #  #  ########################     #   #
        #  #                          ####  ##
         #  ##########################     #
          #                            ####
           ############################
Solution: r1,30-23d1

;7
                          #########
                     #####    #    #####
                 ####      ## #         ####
                #     ######  # #######     #
             #### ####       ## #      #### ####
            #     #    ######   # ####    #     #
          ### ####  ###       ##  #   ###  #### ###
         #    #    #    ######   #  #    #    #    #
         # ###  ###  ###       ##  # ###  ###  ### #
       ### #   #    #    ######   #     #    #   # ###
      #    # ##  ###  ###        #  ###  ###  ## #    #
      # ###  #  #    #    #######  #   #    #  #  ### #
     ## #   #  #  ###  ###        #  #  ###  #  #   # ##
    #   # ##  #  #    #    #######  # #    #  #  ## #   #
    # ##  #  #  #  ###  ###        #   ###  #  #  #  ## #
    # #  #  #  #  #    #    #######  #    #  #  #  #  # #
   ## # #  #  #  #  ###  ###        # ###  #  #  #  # # ##
  #   # # #  #  #  #    #    #######     #  #  #  # # #   #
  # ##  # # #  #  #  ###  ###        ###  #  #  # # #  ## #
  # #  #  # # #  #  #    #    #######   #  #  # # #  #  # #
  # # #  #  # # #  #  ###  ###        #  #  # # #  #  # # #
 #  # # #  #  # # #  #    #    ####### #  # # #  #  # # #  #
 # #  # # #  #  # # #  ###  ###         # # #  #  # # #  # #
 # # #  # # #  #  # # #    #    ####### # #  #  # # #  # # #
 # # # #  # # #  #  # # ###  ##     # # #  #  # # #  # # # #
 # # # # #  # # #  #  # #   #     ### #  #  # # #  # # # # #
#  # # # # #  # # #  #  # ##      #    #  # # #  # # # # #  #
# #  # # # # #  # # #  #  ###  ####  #  # # #  # # # # #  # #
# # #  # # # # #  # # #  # ###   #*#  # # #  # # # # #  # # #
# # # #  # # # # #  # # #  # $ # #**# # #  # # # # #  # # # #
# # # # #  # # # # #  #  ##  #.###**# #  # # # # #  # # # # #
# # # # #  # # # #  #  #@#  #### #**# # #  # # # # #  # # # #
# # # #  # # # #  #  # #  #   #  #. $ # # #  # # # # #  # # #
# # #  # # # #  #  # # ####     # #  #  # # #  # # # # #  # #
# #  # # # #  #  # # #  #   ####### #  #  # # #  # # # # #  #
#  # # # #  #  # # #  #  #  #  #    # #  #  # # #  # # # # #
 # # # #  #  # # #  #  # ##  ##  ###  # #  #  # # #  # # # #
 # # #  #  # # #  #  # #   #    ##   #  # #  #  # # #  # # #
 # #  #  # # #  #  # # ###  ####   ##   # # #  #  # # #  # #
 #  #  # # #  #  # # #    #      ##   ##  # # #  #  # # #  #
 ##  # # #  #  # # #  ###  ### ##   ##   #  # # #  #  # # #
   # # #  #  # # #  #    #    #   ##   ##  #  # # #  #  # #
   # #  #  # # #  #  ###  ###   ##   ##   #  #  # # #  ## #
   #  #  # # #  #  #    #    ###   ##   ##  #  #  # # #   #
   ##  # # #  #  #  ###  ###     ##   ##   #  #  #  # # ##
     # # #  #  #  #    #    #####   ##   ##  #  #  #  # #
     # #  #  #  #  ###  ###       ##   ###  #  #  #  ## #
     #  #  #  #  #    #    #######   ##    #  #  ## #   #
     ##  #  #  #  ###  ###         ###  ###  #  #   # ##
       # ##  #  #    #    #########    #    #  #  ### #
       #   #  #  ###  ###           ###  ###  ## #    #
       ###  #  #    #    ##### #####    #    #   # ###
          # ##  ###  ###      #      ###  ###  ### #
          #   #    #    #####   #####    #    #    #
          ###  ###  ###      ###      ###  ###  ###
             #    #    #####     #####    #    #
             ####  ###      #####      ###  ####
                 #    #####       #####    #
                 ####      #######      ####
                     #####         #####
                          #########
Solution: 5-31u3r1u5r1u3r1u1r1u3r1u1r1u1r1u1r1u1r1u1r1u1r1u1r3u1r1u1r3u1r6u1r2u3r8d1r4d2r4d2r3d3r3d3r2d4r2d4r1d5r1d8l1d5l1d4l2d4l2d3l3d3l3d1l1d1l3d1l1d1l3d1l5d1l8u1l5u1l3u1l1u1l3u1l1u1l2u2l1u1l2u2,37-32l2,28-29r1,30-28d1


