;1
    #####
    #@  #
    # $$#
    ##  #     #####
     # $#    ##.#.#
     #  #   ##..#.#
     #  #####...#.#
     # $    ......#
######$######   # #
#      $ ######## #
#  $#    #      # #
# $ #$   # #### # #
#  $# $  # #  # # #
# $ #$ $ $ #  # # #
#   #    ###  #   #
##########    #####
Solution: 6-1d2,7-3d2,6-7r8,15-8u3,7-5d1,6-7r8,15-8u2,6-7d2,5-10r1,7-1d5,6-7r7,14-8u2,6-5u2,5-2r1,7-1d5,6-7r7,15-7l1,13-8u1,6-13u10,5-2r1,7-1d5,6-7r7,14-8u1,8-13l1,6-14u11,10-13l3,5-2r1,7-1d5,6-7r10,17-8u3,6-14u11,5-2r1,7-1d5,6-7r10,17-8u2,8-9l1,6-10u7,5-2r1,7-1d5,6-7r10,17-8u1,8-10l1,6-11u8,5-2r1,7-1d5,6-7r8,15-8u1,2-12u2,1-9r5,8-9l1,6-10u7,5-2r1,7-1d5,6-7r10,3-11u1,2-9r3,6-10u7,5-2r1,7-1d5,6-7r9,2-14u4,1-9r4,6-10u7,5-2r1,7-1d5,6-7r8,3-13u3,2-9r3,6-10u7,5-2r1,7-1d5,6-7r7,5-12u2,6-9l3,1-9r4,6-10u7,5-2r1,7-1d5,6-7r6,5-14u4,6-9l3,1-9r4,6-10u7,5-2r1,7-1d5,6-7r5

;2
       ###
   #####.#######
  ##    .      ##
  #  ### ### $  ##
### ## # # ## $  #
#   #  # #  # $$ #
# ######$#### $  #
#      $ $   $$$ #
#   #### ####    #
#####  # #  ######
    #  # #  #
    # ## ## #
    ###. .###
    ##. @ .##
    #.. . ..#
    #########
Solution: 8-7u5,6-7r1,8-6d6,9-13l2,13-8u1,10-7l2,6-7r1,8-6d6,7-13r2,15-6u1,15-8u1l7,6-7r1,8-6d6,9-13l1,7-14u1,15-5d1,16-7l8,6-7r1,8-6d6,7-13r1,9-14u1,15-3d3,16-7l7,8-6d7,9-14l3,12-3r1,13-5d1,12-7r1,15-7l6,8-6d7,9-14l2,15-5l1d1,15-7l7,6-7r1,8-6d7,7-14r3,13-4d2,14-7l5,8-6d7,7-14r2,15-3l1d3,15-7l6,8-6d7,13-4u1,14-2l5

;3
     ### ### ######
  ####.###.###.# @#
  #   $ $.$ $.$   #
  #   $.$ $.$ $.$ #
  # $###.###.###  #
  #  #.###.###.####
  # $ $.$ $.$ $   #
  #  .$ $.$ $.$ $ #
  ######.###.###  #
######.###.###.#$ #
#...  $ $.$ $.$   #
#..   $.$ $.$ $.  #
########.###.######
       ### ###
Solution: d3l1u1l2u1l2d1l2u1l2d1l2u1l3d5r3u1r2d1r2u1r2d1r2u1r3d5l3u1l2d1l2u1l2d1l6r5l1u1d1r2u1l6r8d1r2u1l9r7d1l2u1r9u2l1d1r1d1l13r13u4l1d3r1d1l7r4d1l2r5u5l3d1r1u1r1d3r1d1l3r2u3l4u1l2d1r5u1r1d4l1d1l3u1l2d1l7r7u1r2d1l4r6u1r3d1l5r5u4l9u1l2d1r9u1r1d4r1d1l1u5l4d1l9u2r1d1l1d1r9l2u1l2d1l5u4r1d3l1d1r5l4u5r2d1l1u1l1d4l1d1r1u4r4u1r2d1l5r7u1r2d1r3u2l1d1r1d1l1u1l2d1l4u1r2l4d1r2l4u1r2l5d1r3

;4
######
#.   #
#  $ ###
#.$#$ .#
#  $  ##
#.   @#
#######
Solution: 2-4r2u1,5-5u1,4-3r1,4-1d3,5-5l3,4-2l2,1-1d1,2-4u2,3-1l1

;5
######    ######
#.   #    #   .#
#  $ ###### $  #
#.$#$ .  . $#$.#
#  $  ####  $  #
#.   @#  #    .#
#######  #######
Solution: 4-4u1,4-4l2,1-5u3,2-2d1,3-4l1,1-5u1,4-1d1l1,2-1d3,3-5l1,4-2d1,11-2r2,11-2d1,14-3u1,13-4u1,14-2l1,11-5u1r2,14-5u1,11-2d2,10-5r3,13-2l1,11-1d2,12-4l1,10-5u1,11-3l6,3-4r1,4-2d1,5-5u1,4-3r4,3-4r1,5-5u1,4-3r1

;6
  ##############
  #     .      #
  #  $  * $ $  #
  #####  #######
      ##.#
###### # #  #######
#.   ###.#  #    .#
#  $ ##  ####  $  #
#.$#$ .  .    $#$.#
#  $  #   ###  $  #
#.   @###.# #    .#
#########.# #######
  ######  #######
  #   $  *  $ $ #
  #      .      #
  ###############
Solution: 9-12d1,10-14l5,4-9l2,1-10u3,2-7d1,3-9l1,1-10u1,4-7l1,2-6d3,3-10l1,4-7d1,3-9r1,5-10u1,4-8r3,9-8l2,14-9r2,17-10u3,16-7d1,15-9r1,17-10u1,14-7r1,16-6d3,15-10r1,14-7d1,15-9l1,13-10u1,14-8l5,7-8r1,8-3u1,9-1l1,11-2r1,9-2r1,4-2r4,10-2l4,8-8r5,14-7d1,13-9r1,12-2l3,8-1d6,7-8r6,14-9u1,13-7r1,14-2l5,8-1d6,6-1r1,4-2r3,8-9u4,16-7l2,13-6d1,14-8l5,8-9u2,16-9l2,13-10u1,14-8l5,7-8r1,5-13r3,9-14u3,13-13l3,9-14u2,15-13l5,3-14r5

;7
#########
#...    #
#$$$+$$$#
#   .  .#
#########
Solution: 1-3u1,2-3u1r1,7-1d1,6-3u1,7-1l3d1,6-2l1

;8
          #####
###########   #
#+$.        . #
############  #
           # ##
           #. #
           # ##
############  #
#.$ $   $   $ #
###   #   #   #
  #############
Solution: r10,13-2l11,12-9u6,13-2l9,7-8r4,12-9u6,3-8l1,3-8r8,12-9u3

;9
#########
#       #
# $ $ $ #
# $ $ $ #
#@# # # #
##.#.#. ##
# . . .  #
# * * *  #
#  #### ##
####  ###
Solution: 2-8u2,5-7l2,2-8u1,1-6r2,4-7u1,7-7l4,2-8u1,1-6r4,6-7u1,5-2r1,7-1d5,8-7l5,2-8u1,1-6r4,5-3r1,7-2d4,8-7l5,2-8u1,1-6r2,3-2r3,7-1d5,8-7l5,2-8u1,3-3r3,7-2d4,8-7l5,1-2r5,7-1d5,8-7l3,1-3r5,7-2d4,8-7l1

;10
 #######
##     ##
#  $.$  #
# $#.#$ #
# ..*.. #
# $#.#$ #
#  $.$  #
##  @ ###
 ######
Solution: l2u1r1d1r1u1l2u1l1u1r1l1u2r1d1u1r1u1r1d1u1r2d1l1r1d1r1d1l1r1d2l2r1u1

;11
       ######
    ####@   #
    #  $  $ #
    ## .. ###
     ##.###
      #*#
 ######.#####
##    ..    ##
 ## $    $ ##
  ## $  $ ##
   ##    ##
    ######
Solution: 7-4d4,5-10u1,4-9u1,6-2r1,8-1d1,9-3l1,7-2d5,11-2l2,8-1d1,8-10u1l1u5,5-9r1,7-10u5,4-8r2,7-9u3,9-9u1,10-7l2,7-8u1,8-9u1,9-7l1,3-7r2

;12
#########
#   $ . #
#  $@$  #
####$.###
 #. . $.#
 ########
Solution: d1r1d1l2r3l2u2l1u1r2d1u1l4d1r2u1r1d2

;13
    #####
#####.  #
#   $ .$#
#  $@$  #
####$.# #
 #. . $.#
 ########
Solution: d1,5-5l2,5-4u2,7-5l2,7-1d3,4-3l1,3-2r2,1-3r3,5-2d1

;14
    #####
#####.  #
#   $ .$#
#@ $ $  #
####$.# #
 #. . $.#
 ########
Solution: 3-2r1,4-3l1,4-3d1,5-5l2,4-2r1d1,7-5l2,5-5u1,7-1d3,5-4u2,1-3r3,5-2d1

;15
###
#.#############
# $          .#
# ##########$##
# #  $   . # #
# # .#.  $ # #
# #  $   . # #
# ##$####### #
#$#.       $ #
#@##########.#
###        ###
Solution: u7r11d6l8u2r4,10-5l3,4-4r4

;16
###
#.#############
# $ .    .   .#
# ## #### ##$##
#.   $     # #
# #  #   $ # #
# #  $      .#
# ##$####### #
#$#.       $ #
#@##########.#
###        ###
Solution: u7r11d6l8u5d3r7l2u3d1l7

;17
#####
#@  #####
# $$ .  #
#   $#$ ###
### ..... #
  # $#$$$ #
  #. .   ##
  ########
Solution: 2-1d1r1,5-2l2,8-6u1,6-2d1,7-4l1,6-6u1,7-6u1,4-4d1,3-6r1,4-2d1,1-2r3,1-3r1,3-2d3

;18
##########
#        ##
# $ *.. $ ##
#   .+*    #
####...# ###
 #   #  ##
 # $$ $ #
 #   $$ #
 ####   #
    #####
Solution: 7-3l1,3-2r2d1,7-2l1,5-1d1,1-2r3,9-2l2,4-7u4,7-6l2,6-8u4,5-8u1,4-7u3,4-6r1,6-7u2,2-6r1,4-7u2

;19
  ##########
 ## .##    #
## $$ $  ..########
#@$   $$$$......$ #
## $$    .#####   #
 ## .#### #   #####
  ####  ###
Solution: r3u1,4-3d1,5-2r4,9-4u1,7-4u1,5-4u1,7-3l1,9-3l1,2-4r6,6-3l2,8-3l2,17-3l9,6-3r8,7-1d1,6-3r7,4-2r2,7-1d1,6-3r6,2-2r4,7-1d1,6-3r5,4-3r6,2-3r7

;20
####   ####
#* #   #. #
# *#  ##@$#
#* #  #   #  ######
# *# ##$ $####....#
#* # #   $       *#
# *# # $ ######.  #
#* # ### #  #.## *#
# *#   # #  #$ $ .#
#* #   # #### #  ##
# *#   #$      $##
####   #  #### .#
 ##    ####  ####
Solution: 8-5r6,15-9d1,13-9u1,14-8r2,15-6u1,16-4l1,9-3d1,8-5r7,9-1d2,8-11u9,17-6u1,16-4d2,9-3d1,8-5r7,17-5l1,15-6u1,16-8u1,17-6l1,6-6r1,8-7u1,7-5r8,16-6u1,7-3d1,6-5r10

;21
 #########
 #.#.#.#.#####
##$#$#$#$##..#
#.$    $   $ #
###$ # # $  .#
#.$ $  ####.*#
##   ###.##..#
 ##$ # # ##..#
  # ## # $.###
  # #  # #####
 ## #  #$ $ .#
##  #### # ###
#.   $ $ $ #
###  #    @#
  ##########
Solution: 6-12l4,8-11u4,8-8r1,9-10r2,3-8u1,4-6u1,3-5l1,3-3l1u1,4-3u1,6-3u1,6-3r2u1,8-4r2,10-3r1d3,12-4d2,12-2d3,8-3r2,11-2d3,6-12r1,8-13u1,3-5d6,2-12r4,3-3d2,4-5u1,3-3r7,11-2d2,2-6r1,4-7u3,3-3r8,12-2d2,8-12l4,3-13u7,2-5r1,4-6u2,3-3r7,11-2d1,12-4l2,10-12l6,3-13u7,2-5r1,4-6u2,3-3r7,11-4u1,8-10d1,9-12l5,3-13u7,2-5r1,4-6u2,3-3r8,12-4u1,8-4r3


