;1
#########
#.  #  .#
# #   # #
#  #$#  #
#  $@$  #
#  #$#  #
# #   # #
#.  #  .#
#########
Solution: l2,4-4r2,7-5u3,4-2d1,3-4r3,1-5u3,4-6u1,5-4l3,1-3d3,7-3d3

;2
#####
#   ###
#  .$.#
# # # ###
# $ * $ #
###@# # #
  #.$.  #
  ###   #
    #####
Solution: d1r2,5-2l2,7-4l1,5-5u2,3-4r2,1-4r1,3-3d2,1-2r1,7-4l2,7-6l1

;3
     #####
     #   #
 #####$# ##
##    $   #
# ..#@#.. #
#   $    ##
## #$#####
 #   #
 #####
Solution: 5-5l2,7-3l3,6-1d1,5-3r2,8-2d1,9-4l1,2-3r4,1-5r4,4-7u1,5-5l2,2-6u1,1-4r1,7-5l4,2-6u1,6-3r1,8-2d1

;4
#######
#. .  ###
#  # $  #
# $#*#$ #
#  $ #  #
### @. .#
  #######
Solution: u3r1,5-1l3,2-4r1,4-3d1,3-5r3,7-2l2,4-3u1,5-1l1,6-4u1,7-2l2,4-1d3,3-5r1,2-2d1,1-4r2,4-5u1

;5
###########
#  #####  #
#    $    #
# # #$# # #
# #  $  # #
# ###$### #
# ##   ## #
#.  .@.  .#
###########
Solution: 4-2r3,6-4l1u1,6-2l3,5-4d2,3-4r2,1-2r2,6-7l2,7-4l1,5-3d3,4-7r1,2-7r1,5-2l3,1-1d5,7-2r1,9-1d5

;6
#########
# $  .  #
# $.$.# #
# #.$.$ #
#@ .  $ #
#########
Solution: 3-2r1,4-4u1,7-4l2,1-1r4,5-4l2,4-1d1,5-3l1,7-3l1,7-1l1,1-2r1,1-4r1

;7
 #######
 #     #
 #  $  #
##.##*##
#   *  #
#  *   #
##*##.##
#  $  #
#@    #
#######
Solution: r4u4d1l2u1l1u3r3d1l1u1l2d3r1d1r2u2d2l2u1r1l3d1u1r2d1r3u1l1d1u1d3l2d1l2u1r3d1r1u3l2u1l2d1r1u4r2d1l1u1l1d1u1r4d1l1d3u4l2d1r1u1r1d1

;8
  #####
  # @ #
###$$$###
#   $   #
# ## ## #
#  ...  #
### . ###
  #   #
  #####
Solution: r1d1u1l2d1u1r2d1l1d3l1d2r2u1l1u4d3r3u2l2u1l1d2u1r1l1d2u2r3d2l6u2r2l2d2r6u2l2u1l1d2u1l3d2r4d2u2l4u2r3u2l1d1r1d3l3u2r2u1r1d1l3d2r4d2l2u1d1r2u2l1u2r3d2l1r1u2l2u2l1d3

;9
###########
#    .    #
# #  $  # #
#.#.#$#.#.#
# $  $ @$ #
# ###$### #
#    .    #
###########
Solution: 6-2l1,4-4r1d1,4-6r1,5-2l1,3-1d1,5-4u2,3-4l1,1-5u1,7-6l2,7-4l1,5-5u1,4-1r1,5-1r2,5-4u1,4-2r2,7-1d1,9-1l3,7-4r1,9-5u1,3-6r1

;10
    ####
#####  ##
#  # $  #
# $# #  #
#. .*. .#
#  # #$ #
#@ $ #  #
##  #####
 ####
Solution: u2r3u1d3l1d1l1u1d1u1l1u4r1d1l1d3r3u2l2u1l1d1r3u2r1u1r1d1r1d2l3r3d2l1u1r1u3l3d2r2l2u2r2d1r1d1l1d2r1u1l1u3l2d4l3u2r2l2d2r1u1l1u1r1u2l1d1

;11
     #####
     #   ###
     #$#   #
###### ##  #
#  *  $..  #
#  ..$  *  #
#  ## ######
#   #$#
###  @#
  #####
Solution: l2u1l1u2r2u1r2d1r2l3u1l2r1l1d1l1d2r1d1r2u3d1u1l2r2d3l2u1l2u3r1d1l1d2r2d1r2u3l1u1l1d1r3u1l1d1r3u1r1u2l1u1l2d3r2l2u3r2d1r2d3l1u1l4d1l2u1r5l2r1d1l2d3l2u1l1u1l1u1r1l1u1r3l2d3r1d1r2u3r1u1l2r2u3r2d1r2d2l2r2u2l1d1r1d1l1

;12
  ####
###  #
# . .###
# # $  #
# #$$# #
#  $ # #
###. . #
  #@ ###
  ####
Solution: undefined

;13
   #####
 ###   ####
 #   $ #  #
 # @...#  ##
####$$$$.  #
#  .$..$.$ #
# $.$..$.  #
#  .$$$$####
##  #...  #
 #  # $   #
 ####   ###
    #####
Solution: r3u1l2r2d2r2d2l1d2l2d2r2u1d1l2u2r2u2r1u2l2r2d2l1d2l2u1l2u2l2d2r1l1u2r2d2u2r1u2r1u2l1d2l2u1r3d1r1d1r2d2l1d2l2u1l2u2r1u2r1u1l1r1d1r1d1r2d2l1d2l2u1l2u2r1u2r2d1l1r3d2l1d2l2u1l2u2r1u2d1r4d2l1d1l4r4u1r1u2l4d2l1d1r3l2u3r1u3l1d2l2u1r2d1r2d1r2d2l1d1l3u3r1u1l1d4r3u2d1r3u2l1u1l1d2l1d2l3u3r3d1r1u1r2l3d3l2d3r2u1l1d1l1u1d1r2u3d2r2u1l2u1l3u3r3d3l4u2l2d2r3l2d2r1u3d1l2u1r1d1r2u3r3d3l3u5l2d1r1u1r1d2u3r1d1u1r1d1l2d2r3d3l3u3d1u1r6d1l1u3l1d1

;14
#########
#    .$ #
# $. $#.#
#.#$ .$ #
# $.@   #
#########
Solution: u3l1d1u1l2d3r2l2u3r3d2r1d1r2u3l2r2d3l2u1l1r1d1l2r4u3d3u3l2d1l2u1d1r1d2r1u1d1l1u2d2u2l1u1l2d3r2u1r2d1u1d1r2u3l3d2r1d1u1r1d1r1u1d1l2u1l1u1d1r1d1u1l1u2l1r1d2u2d2u2r1d1l1d1r1d1u1l1u2l1r1d2l1d1l2u3r3l1r1d2u2l1d1u1l2d1r1u1r2d2r1d1l2r1u2l1r1d2l1u1d1r4u1l1d1l2u3l3d3r1l1u3r3l1r1d3u3d3r2u1l1u1l1u1l3d3r2l2u3r2l2d3r4l4u3r2d1l1u1l1d1r4d2l2u1d1r1l1u1d1r2u2l2r2d1r2d1l3r1u2l2d1r1u2l3d1r1

;15
  ######
###    ####
#    #    #
#.##.$.##.#
#  $$#$$  #
# .$.@.$. #
#  $$#$$  #
#.##.$.##.#
#    #    #
####    ###
   ######
Solution: undefined

;16
#########
#   . . #
#   $.$ #
#### $###
  # @ #
###$ ####
# $.$   #
# . .   #
#########
Solution: undefined

;17
######
#    # ####
#    # #  #
# # ####.$###
# # ##. $   #
# # .$@$. # #
#   $ .## # #
###$.#### # #
  #  # #    #
  #### #    #
       ######
Solution: undefined

;18
     ####
     #  #
######  #
#  $    #
#    $ ##
####.$*#
 #  .*.#
 #.*.  #
 #*$.####
## $    #
#    $  #
# @######
#  #
####
Solution: undefined

;19
 #########
##   #   #
#    # $ #
# $$$#.$ #
##  ...# #
 ###.#.###
 # #...  ##
 # $.@$$$ #
 # $ #    #
 #   #   ##
 #########
Solution: 8-6d1,9-8l1,6-8u1,7-6l1,8-7l1,6-6d1,2-7r4,2-4u1,1-2r1,8-7l4,8-2l1,6-1d5,5-7r1,8-3l1,6-2d2,6-6u2,6-9u4,8-7l1,6-8u2,4-6r2,2-7r4,4-2d4,5-7l1,2-7r2,2-2r1,4-1d6,2-3r1,4-2d1,3-4r1,4-9u4,2-8r1,4-9u3,6-7l1,8-6l1,7-6l2,8-7l1,6-8u1,7-6l1,7-9u2,8-6l1

;20
    ####
   ##  ##
 ## #$ ###
 # $..$   #
#   *..*   #
 #@  $..$ #
  ### $# ##
   ##  ##
    ####
Solution: undefined


