;1
#######
#..   #
# #   ###
# #     #
#   # # #
#####$$ #
    # @##
    ####
Solution: l1u3d1u1r2d2l1d1l1u2,6-3l2,3-4u1,5-1d1,3-3u1,1-1r2,4-3r1,7-3l3,3-4u1,5-1l3,3-3u1,4-1l1

;2
    ####
 ####  #
 #. #  #
 #     #
 #.#$$ #
##   ###
#@ # #
#    #
######
Solution: 4-3d2,6-4l1,4-5u1,3-3r1,5-4u1,4-7u3,5-3l2,2-2d3,5-1d2l1,6-4l1,4-5u1,5-3l2,2-4u1,2-7u2

;3
   ####
   #@ #
 ###  ##
## $$  #
#   $. #
#.. #  #
########
Solution: 5-4l2,4-4u1,1-4r1,2-3r2,4-4l1,1-4r1,6-3l2,4-4l1,1-4r3,4-1d2,5-5u2l1,5-5u1l2,1-4r1,2-3r2,4-4l1,2-3d1,3-5l1,6-3l2,5-1d2,2-3r1,4-4u1,6-4l3,2-3d1,4-1d2,3-4r1

;4
#####################
#    . . . * $ $  $ #
#  $ $  $  . . . .$@#
#####################
Solution: l2u1l1r1d1l5u1l2d1l2r2u1r2d1r2u1d1r5u1l1d1l6u1l2d1l2u1l4d1l1u1r3d1l1u1r3d1l1r3u1l1r3d1l1r3u1l1d1r3u1l1d1r3u1l1d1l6u1l2d1r8l6r2u1l2d1r4u1l2d1r4u1l2d1l8u1l2d1r10l6u1l2d1r4u1l2d1r4u1l2d1r4u1l2d1l8u1l2d1r10l6u1l2d1r4u1l2d1r4u1l2d1r4u1l2d1u1r4d1l1u1r3d1l1u1r3d1l1u1l7d1l8u1l2d1r9l1u1r1d1l3u1r1l1d1l2u1r1d1l3u1r1

;5
#######
#    .#
# # # #
# . $ #
##   ##
##$#$#
#.  @#
######
Solution: l2u2r1u3r2d2l1d1l1r1u1r1u2l2d2u2l2d2r1l1u2r1l1d2r1d3u3l1u2r4d2l1d1u1r1u2l4d2r1d3r2u2l1u1l1d2u1r2d2l2u3r1l2u2r4d2l2r2u2l2d2u2l2d2r1l1u2r4d2l1d1l1u2d1l2u2r3l1d3r1d2l2u2

;6
   ####
 ###  #
 #@$ .##
##$#.. #
#   $  #
#   #  #
########
Solution: undefined

;7
     ####
    ##  #
#####   #
#...$$$ #
# ##   ##
#    ###
##    #
 # ## #
 # @  #
 ######
Solution: undefined

;8
#######
# .$  #
#     #
#..$###
#  $  #
###  @#
  #####
Solution: l1u1l1u1l1u2d1l1d2r2l1u3r1d1r2u1l2d1l1d2r1u1l1u1r1u1r2d1l2d1l2u2r2d1u1l1d1r1d3r2u1l1d1l1u1l2u3r1d1r3u1l2d1l2d2r2u1d1l2u2r2u1r2d1l2d2l2u3r2d1l1u1l1d1r4u1l2

;9
 ####
 #  #
##  ####
#  $   #
# #$$  #
#+  .###
### .#
  ####
Solution: undefined

;10
  ######
  # .  #
### #. #
#@$$   #
# #  . #
# ##$###
#    #
######
Solution: undefined

;11
 #####
 #   ##
 # #$ ##
##   $ #
#   #  #
# # #$ #
#..   ##
### #@#
  #.  #
  #####
Solution: undefined

;12
  ####
  #  #
###  #
# .$ ###
#  $$  #
## #.  #
 #.@ ###
 #####
Solution: undefined

;13
#######
#  *  #
# .$  #
#.  # #
# # $*#
#@    #
#######
Solution: undefined

;14
  ####
 ##  #
 # @.###
##$*.. #
#  $#  #
#    $ #
#####  #
    ####
Solution: undefined

;15
  ####
  #  #
###* #
#  . ###
#.     #
## #$$@#
 #   ###
 #####
Solution: undefined

;16
 #####
 #   #
 # # ###
 #  $  #
##$#  .#
#  .# ##
#. @ $#
####  #
   ####
Solution: undefined

;17
 ####
 #  ######
 #   $ $ #
 # #   $@#
 # ##$####
## ##   #
# . . ..#
#   #   #
#########
Solution: undefined

;18
   ####
 ### @###
##  **  #
#     # #
#  # ## #
## $.   #
 #  #####
 ####
Solution: undefined

;19
 #####
 #   ##
## #$@#
# . $ #
#..*# ##
#    $ #
###    #
  ######
Solution: undefined

;20
  ####
  #  #
  #  #####
 ##$ $ $ #
 # $     #
##@##### ##
#  ..  #  #
#  ###   .#
#      .###
##  #  ##
 #######
Solution: undefined

;21
   #####
  ##   #
###@$# #
#  *$. #
# # . ##
# $ . #
###  ##
  ####
Solution: undefined

;22
    ####
  ### .#
 ##    #
## $.  #
#@ ##$##
#  $   #
#  #.  #
########
Solution: undefined

;23
  ####
###+ #
# $*$#
#  * ##
#. #  #
##    #
 #    #
 ######
Solution: undefined

;24
     ####
  ####  #
###  $$ #
#  .#   #
# #.  ###
# $$ @ #
### #. #
  #  .##
  #####
Solution: undefined

;25
########
#  ##  #
#..... ##
# #$#$$ #
# $   $@#
#    ####
#  ###
####
Solution: undefined

;26
  ######
###   .#
#  $ # ##
# #@$$  ###
# # *. .  #
#  ###### #
##        #
 ##########
Solution: undefined

;27
 ####
 #@ #####
 #$ $ $ ##
 #  #    #
 #$## #  #
##   ...##
#  ##.# #
#       #
######  #
     ####
Solution: undefined

;28
   #####
  ##@  #
### $  #
#  * $ #
# *.*.##
##  .$ #
 ###   #
   #####
Solution: undefined

;29
     ####
 #####  ###
 # $ $  $ #
## #  # $ #
#       # #
# .. #  $@#
###... ####
  ######
Solution: undefined

;30
 #########
 # . .   #
 #$# # # #
 #@#   # #
 # #.# # #
##  $  $ #
# $#.#####
#    #
###  #
  ####
Solution: undefined

;31
########
#.$    ##
# ## #$ #
#  #. $@#
#  . .$##
## #.#  #
 #   $  #
 #####  #
     ####
Solution: undefined

;32
##########
#   ##   #
#  ..$.. #
## # # # #
 # $$$   #
 ###@ ####
   ####
Solution: undefined

;33
  #####
  #.  ###
###.# $ #
#  *    #
# *. $# #
## ## $ #
 #   @###
 ######
Solution: undefined

;34
#######
#    .##
# # #  #
#  $   #
#  ##.##
##$.#$ #
 #     #
 #@ #  #
 #######
Solution: undefined

;35
########
#   .  #
#  #.# #
##  ...#
##$$ #.#
# $ #  #
# $$@$ #
#    ###
######
Solution: undefined

;36
 #####
 #   ###
 #$# $ ##
##  ... #
#  ##.  #
#  $  ###
#  ##$ #
#####  #
    # @#
    ####
Solution: undefined

;37
########
#   #  #
# .@ * #
## #*  #
 #  $ ##
 ###  #
   ####
Solution: undefined

;38
  ####
###  #
#. * ####
#  $    #
#$$##   #
# . . @##
#####  #
    ####
Solution: undefined

;39
########
#@.#   #
#  $   #
#  #$$ #
#... ###
#   $#
###  #
  ####
Solution: undefined

;40
########
#   #  #
#      ##
## ##.* #
 # $ .# #
 #$# .  #
 # $ ####
 # @##
 ####
Solution: undefined

;41
     #####
######   #
#    # # ##
#@$ $.* $ #
## ##. $# #
 #   .#   #
 ####.  ###
    #####
Solution: undefined

;42
   #####
#####  ###
#  $   . #
#@. $ $  #
####*# ###
   #.  #
   #####
Solution: undefined

;43
  ####
 ##  #
##   ####
# $$$   #
# #+# # #
#  *.  .#
###   ###
  #####
Solution: undefined

;44
  ##########
  #   ##   #
 ## ....   #
 #   # # ###
 #   $ # #
## ##$## ##
#@$$      #
#   ###   #
##### #####
Solution: undefined

;45
########
#.  #  #
#  .. .#
##$##  #
#  $ $ #
#  $@# #
###    #
  ######
Solution: undefined

;46
     ####
######  #
#       #
#...#$  #
#  #  ###
# $  $@#
##. $  #
 #######
Solution: undefined

;47
 #####
 #@  ###
## # * #
#  .$. #
#  $  $#
#### # #
   #  .#
   #####
Solution: undefined

;48
 #######
 #  #  #
##     #
#  ##  #
#   #*##
#  $ . #
###@*$ #
  # . ##
  #####
Solution: undefined

;49
  #####
###.  ##
#...*  #
# #  $ #
#  $ $ #
####$@##
   #  #
   ####
Solution: undefined

;50
  ########
  # .#   #
### .$   #
# .**$#$##
# #  @  #
#    ####
######
Solution: undefined

;51
#####
# @.#####
# $.##  #
##$  $  #
 #..#$  #
 #    ###
 #  ###
 ####
Solution: undefined

;52
   ####
####. #
# $@* #####
#  #    $ #
## .# #$# #
 #    .   #
 #  #######
 ####
Solution: undefined

;53
########
#.. #  ##
#  .*.  #
## #  #$#
 # #    ##
## ## #$ #
#@$$     #
#   ###  #
##### ####
Solution: undefined

;54
##########
#   ##   #
# .  $   #
##*###   #
# ...# ###
#    $$ @#
#####  $ #
    #  ###
    ####
Solution: undefined

;55
    #####
    #   #
##### # #
#   $$  #
#  *.  ##
## ##$ #
#.. @ ##
#######
Solution: undefined

;56
   ####
 ###  #
 # $. #
 # #  #
##+ *##
#  $ .#
# #$  #
#   ###
#####
Solution: undefined

;57
########
#  #   #
#  * # #
# ..*  #
## *@# #
## #$$ #
#    ###
#   ##
#####
Solution: undefined

;58
  ######
###    ##
#  $## .#
#    ## #
## #*## ##
# $$   . #
#  #.    #
# @#######
####
Solution: undefined

;59
    #####
#####   #
#   @   #
#  *#$###
###.*  #
 ##. # #
 # $ # #
 #     #
 ###   #
   #####
Solution: undefined

;60
  #####
  #   #
  # # ######
 ##  $     #
 # $ #.... #
##@#$####*##
#  $       #
#   ####   #
#####  #####
Solution: undefined

;61
#########
#   ##  #
#   * . ##
####    .#
  ##$#.# #
  # $ $  #
  # @ ####
  #####
Solution: undefined

;62
   ######
####    #
# @# #. #
# $$ $. #
#   ## ##
### .#$ #
  #   . #
  #  #  #
  #######
Solution: undefined

;63
 #######
 #..   #
 #$$$$@#
##.# ###
#     .#
# # .$ #
#    ###
######
Solution: undefined

;64
   #####
   #.  #
 ###$# #
##     #
# .*** #
#  $  ##
###@  #
  #####
Solution: undefined

;65
  #####
  #.  ###
###.#$$ #
# *.*@$ #
# #   # #
# ##    #
#     ###
#######
Solution: undefined

;66
 ##########
 #   ##   #
 #$# $    #
##   # # ##
#  #.. # #
#  ...$# ##
#  #   $$ #
####### @ #
      #####
Solution: undefined

;67
  #####
  #.  #
### #$####
# $ .    #
# +$  *$ #
#  # # ###
####.  #
   #####
Solution: undefined

;68
  #####
  #.  ###
 ## #$  #
##    . #
# .* #  #
#  $##$##
###  @ #
  ######
Solution: undefined

;69
 ####
##+ ###
#  $..#
#.  # #
# #$  #
#  $$##
##    #
 # ## #
 #    #
 ######
Solution: undefined

;70
########
#   # @#
#  $ $ #
##..#  #
 #. # ##
##.$#$ #
# . $  #
# # #  #
#   ####
#####
Solution: undefined

;71
   #####
 ### . #####
##         #
# $ #*  $# #
# # #. #   #
#@$ #.##$###
## $..   #
 ###  ####
   ####
Solution: undefined

;72
#####
#  @#####
# #$ # .#
# #     #
# #$ #  #
# #  # ##
# #$ # ##
# # # * #
#.  .   #
####   ##
   #####
Solution: undefined

;73
######
#  .@#
# $#$#
## $ ###
#  .$  #
# . *  #
#  # ###
##.  #
 #####
Solution: undefined

;74
#########
#  ##   #
#    .  #
# $#..###
#  #..$@#
# $ $ $ #
#  ######
####
Solution: undefined

;75
      #####
#######   #
#    $  . #
# #.  $# ##
# $    $ #
##.*### ##
 #. $    #
 #  #@  .#
 #########
Solution: undefined

;76
   #####
 ###  .##
 #@$ #  #
##$#    #
#  *  .##
#   $# #
####  .#
   #####
Solution: undefined

;77
      #####
   ####   #
   # $ $#@#
 ###  # $ #
##      $##
#  ## *# #
#   .... #
#  ###  ##
#### ####
Solution: undefined

;78
  #####
  #   #  ######
  # # #  #    #
  #   #### #  #
 ## $ #       #
 # $ $# $ #...#
 #  $ # ##..*.#
## $ $# #..*.##
#   $ # #.*.##
#  $ $# #..##
### $  @   #
 # $ $  #  #
 #   #######
 #####
Solution: 10-9u1,11-8u1,12-7u2,11-4r1,13-5u1,9-7r1,10-6r1,11-8u1,12-7u2,10-6r2,5-10l1,4-9l1,3-6u3,4-5u1,3-8u1,4-7u1,4-9u1,5-8d1,4-10r5d1,10-11u1,10-10u2,9-7r1,11-8u1,10-6r1,2-11r1,4-12u2,3-9r1,5-8d1,4-10r5,10-11u3,9-7r1,3-9d1,9-5l1,7-4d5,8-10l3,13-4l4,11-8u1,12-7u2,12-5u1,10-6r1,12-7u1,3-10r6,10-11u3,9-7r1,11-8u1,10-6r1,1-9r3,5-8d1,4-10r5,10-11u3,9-7r2,2-11r1,4-12u1,3-10r5,8-10r1,10-11u3,9-7r1,6-11l1,4-12u1,3-10r6,10-11u1,10-10u1,9-8r1,3-5d3,2-9r2,5-8d1,4-10r4,9-11u3,4-6d3,3-10r5,9-11u1,9-10u1,5-6d3,4-10r4,9-11u1,5-4d2,5-6d3,4-10r5,10-11u4,4-4d5,3-10r6,10-11u3,3-1d2,3-3d5,2-9r2,5-8d1,4-10r4,8-10r1,10-11u2,3-3r1,5-2d2,5-4d2,5-6d1,5-7d2,4-10r5,10-11u1,13-5l1,11-4d1,12-2d1,12-3d1,13-5l1,13-2d2,7-4r4,12-3d1

;79
    ####
#####. ##
# $  $  #
#+$*..  #
# $   $ #
### .####
  ####
Solution: undefined

;80
  #####
  #  .#
###$# ##
#  $   #
#  @** #
### . ##
  #  ##
  #  #
  ####
Solution: undefined

;81
    ####
#####. #
# .  $ #
# ..#  ###
## ###$  #
 #  $@$  #
 #   ##  #
 #########
Solution: undefined

;82
     ####
######. #
#   *.. ###
#  #$#    #
# #   #   #
# # $ # $ #
# ##$    ##
#  # #####
##  +#
 #####
Solution: undefined

;83
  #####
  #   ###
  #$    #
  # #   #
  #@##  #
  #.$. ##
###$#$ #
#. .$  #
#   #. #
########
Solution: undefined

;84
####
#  ####
# @ * ###
#  * .  #
# $ *$  #
####. ###
   #  #
   ####
Solution: undefined

;85
    ####
  ###  ###
### ..   #
# $$#. # #
#@#  .   #
# $ #.# ##
# $$ .  #
## #$## #
 #      #
 ########
Solution: undefined

;86
 ########
 #   #  #
##   #  #
#@$$##  #
# $    ##
###$  $#
  # .. ##
  ###...#
    #   #
    #####
Solution: undefined

;87
  ######
 ##    #
 # . #$##
##   .$ #
# $.$.$@#
# # # ###
#  .* #
#######
Solution: undefined

;88
    ####  ####
#####  ####  #
#  $      .$ #
#    $ #$#.  #
#### ###@#*###
  #  ###*.. #
  #         #
  #  ########
  ####
Solution: undefined

;89
  ####
  #@ #
  # $###
###$  .#
#    # #
# *$.  #
### .###
  #  #
  ####
Solution: undefined

;90
     #####
######   #
# $    # #
# @##    #
#   .$#$##
#  #.*.$ #
#### .   #
   #######
Solution: undefined

;91
########
#. . ..#
# #  . #
# $ .# ##
## #$$  #
# $$    #
#@$ #####
##  #
 ####
Solution: undefined

;92
######
# .  ###
#*..$. #
#  #@#.#
#  $$# #
#     $#
####$  #
   # # #
   #   #
   #####
Solution: undefined

;93
#####
# @ #
# $ ######
# $      #
## ## #$ #
#   .   ##
# #... $#
# $..*  ##
##### #$ #
    #    #
    ######
Solution: undefined

;94
    ####
##### @##
#  .#$$ #
# $     #
# #.##$##
# $$.. .#
#      .#
#########
Solution: undefined

;95
 #######
 #  #  #
 #     #
##  #..#
# $$  ##
#  #$*.#
# $@.  #
########
Solution: undefined

;96
  ####
  #  ###
###    #
# $    #
#+* $###
# *  #
##.#$#
 #.  #
 #####
Solution: undefined

;97
  ######
###   .#
#  $ #$#
# # .# #
#. $.$.##
### $#  #
  ##    #
   ### @#
     ####
Solution: undefined

;98
#######
#     #
#  @#*###
#  $ .. #
## ##*  #
 # $..# ##
 ##$# #  #
 #    $  #
 #   ##  #
 #########
Solution: undefined

;99
#########
#  ##   #
#...    #
#.*#$  ##
##@$  $ #
 ##$# # #
  #     #
  #######
Solution: undefined

;100
      #####
   ####   #
#### +* #$##
#   $#.    ##
# #  ...$#$ #
#   #$#     #
#####   ##  #
    #########
Solution: undefined

;101
   #####
   #   #
 ###$# ##
 #  $.$ #
 #  ... #
##$#. . #
#  #$####
#   $ @#
#  #   #
########
Solution: undefined

;102
      ####
#######  #
#      .$#
# #   .# #
# #.# ##@#
#  .# ## ##
### $$ $$ #
  ###.    #
    #######
Solution: undefined

;103
     #####
######   #
# $   $  #
# #$ .# ###
# # ..$   #
#@$ #..#$ #
###  .   ##
  ###   ##
    #####
Solution: undefined

;104
####
#  #########
#    $ #   #
#  # $. . .#
# . # ###$##
# . #    $ #
# . ##  $$ #
##      #@ #
 ###########
Solution: undefined

;105
#########
#   #   #
#   $$# #
##$## # #
 # .@ $ #
##$####.#
#     #.##
#   #  ..#
###   ####
  #####
Solution: undefined

;106
 #####
 # . #
##$  #####
# @*$#   #
# #.$    #
#.  $#####
# #  #
#.# ##
#   #
#####
Solution: undefined

;107
 ############
 #          #
## ##### $$ #
#  #.  ###  #
#       .#$ #
##.#. ##$ $@#
#  # ### ####
#         #
# .####   #
####  #####
Solution: undefined

;108
  #####
  #  .##
  #$#. #
### ...##
# $$#*  #
#       #
#  $##$##
###@   #
  ######
Solution: undefined

;109
   #######
  ##     #
### *. . #
# .$. $ ##
#  $.##$#
###   $@#
  #  ####
  ####
Solution: undefined

;110
   #####
   #   #
  ## # #
  #   .#
 ##*.#.#
##   # #
#@$$$  #
# *   ##
#######
Solution: undefined

;111
   ####
####  #
#@*.. ###
# ##*   #
# #  $. #
#  $$ ###
#    ##
#  ###
####
Solution: undefined

;112
 #####
 #   ##
 # .  #
###  $#
#+$.# ##
#$*$.  #
# $    #
#.## ###
#    #
######
Solution: undefined

;113
   ########
  ##  #   #
  #       #
  # # ##  #
  # .*   ##
###$#*$###
#   .* #
#   #@ #
########
Solution: undefined

;114
   ####
   #  #####
   #  $...#
   #  #.. #
  ###$## ##
###    $  #
#   $$#   #
#   # @ # #
#######   #
      #####
Solution: 8-5l3u2,5-1d1r2,5-4u1,4-2r1,5-7u4,5-6l2,3-5r4,5-1d3,5-4d1,5-7u1,6-5l1,9-5l1,7-2l1,5-1d1,6-5r1,5-4u1,5-1d1,8-4d1,9-6l1,3-5r4,5-4u1,5-1d1,8-4d1,5-2d2,6-5l1,9-2l3,7-7u1,9-6l1,6-5r1,8-6u2,5-1d1,9-3l1,5-4u1,4-2r4,7-7u1,6-5r1,8-6u3,3-5r4,8-6u2,1-6r3,5-7u4,4-2r2

;115
  #######
  #     #
### ### #
# .*  # #
#.*+#$$ #
## *  # #
 # #$   #
 #    ###
 ##   #
  #####
Solution: undefined

;116
     #####
  ####   #
 ##   $$@#
## *$.# ##
#  # *$  #
#  . .  .#
###   ####
  #####
Solution: undefined

;117
  ########
  #      #
  #$#### #
  # $  $@#
###.**  ##
#   ..* #
#   #   #
#########
Solution: undefined

;118
#########
#  # .  #
#  $ .$ #
#  #..###
## #.   #
# $$ $  #
#@  #####
#####
Solution: undefined

;119
    ######
#####... #
#   $ #  #
#.  #   ##
## #   $##
 #$.$ .$@#
 #  $# ###
 ###   #
   #####
Solution: undefined

;120
   ####
   #@ #
####$$##
#   $  #
# # # $##
#   *.* #
### # . #
  # # . #
  # ##.##
  #    #
  ######
Solution: undefined

;121
####
#  ####
# $  .#
#.#$..#
#.  . ###
###$$ @ #
 #  # # #
 #  $ $ #
 #  #####
 ####
Solution: undefined

;122
     #####
 #####   #
## @$ $  #
# $#*.# ###
#   ..$   #
###  ..$# #
  #  ##   #
  #########
Solution: undefined

;123
     ####
   ###  #
####@$ .##
# $ $$#. #
# # # ..*##
# # ###.  #
# #    $  #
#     # ###
#####   #
    #####
Solution: undefined

;124
  ######
  #    #
### ## #
#@$  # #
# $    #
#.*##$##
## .. #
#. $$ #
#  # .#
#   ###
#   #
#####
Solution: undefined

;125
  #####
  #   #
  # #$##
  #  . #
### .. #
#   $. #
# $ #.##
###$$ #
  # @##
  ####
Solution: undefined

;126
 ######
 #    ###
##$...  #
# **.#  #
#@$     #
###$ $###
  #   #
  #####
Solution: undefined

;127
  #######
###     #
#   $ $ #
#   *. ##
##$$#*###
# $...* ##
#  .*#$  #
###...$$ #
  ##### @#
      ####
Solution: undefined

;128
######
#  . ###
# #.  .#
# $. # #
##$# # ##
# $ $   #
#.. #   #
#$$@#####
#   #
#####
Solution: undefined

;129
##########
#   ##   #
#   $ $  #
# #$ .# ###
# # ..    #
# $$#. #$ #
###@ .   ##
  ###.  ##
    #####
Solution: undefined

;130
########
#  # ..#
#  $.. #
#. ##$##
## $ $@#
 #$    #
 #   ###
 #   #
 #####
Solution: undefined

;131
  ####
  #  #
  #  #
 ##$.#####
## .  $  #
#  $*..  #
# .$  ####
##$@###
 #  #
 ####
Solution: undefined

;132
    #######
#####     #
#      ## #
#  $  ### #
###$ $  # #
  #@$.* # #
  ####.## #
    # ..  #
    #   ###
    #####
Solution: undefined

;133
#########
#.*...  #
# ###*# #
#@#   # #
# $$  # #
###   # #
  #$$ # #
  #     #
  #   ###
  #####
Solution: undefined

;134
  ####
  #  #
###..#####
#  $$    #
#   *.   #
### *$####
  # *@#
  #  ##
  ####
Solution: undefined

;135
#########
#.@ #   #
# $ $   #
## ### ##
#  $ . ##
#  #** .#
##*     #
 #  ##  #
 ########
Solution: undefined

;136
###########
#  #  #   #
#  $    # #
#  ## #   #
## #   $###
## #*    #
#@$$..#  #
#  #*.. ##
####  ###
   ####
Solution: undefined

;137
  #####
  # @ #
  # # ###
  #$$*  #
### ..  #
#  $.$###
#  .. #
#### $#
   #  #
   ####
Solution: undefined

;138
####
#  #####
#  $   #
#  # $.#
## ## ##
#@$ # #
#.$   #
##$## ##
 # .# .#
 #   . #
 #  #  #
 #######
Solution: undefined

;139
    #####
    #   #
##### # #
#     # #
#    $# ##
## ##@#  #
 #  #$## #
 #$ $. # #
 #  ...* #
 #########
Solution: undefined

;140
     ####
######@ #
#  #  . #
#  $$#. #
#  # ..##
## $  .#
##$##  #
#    $ #
#   ####
#####
Solution: undefined

;141
  ####
  #  #
###$ #####
#@$  $  .#
# ## #$  #
#.$  ..  #
#### .$ ##
   # .###
   ####
Solution: undefined

;142
  ######
  #.   ###
  # #$.  #
###$..   #
#  * #$###
#   .  #
####$#$#
   # @ #
   #####
Solution: undefined

;143
#####
#   #
# # #####
#  $  $ #
### ... #
#  $*#*##
# $    #
### # ##
  #+  #
  #####
Solution: undefined

;144
#########
#  . $  #
# *. $  #
##.### ##
 #. ## ##
##.  #  #
#  $$#  #
#  $    #
###### @#
     ####
Solution: undefined

;145
####  ####
#  #### @#
#      $$#
#  ###$# #
##  .*.# #
#  #...  #
#  $*#.#$##
###  $    #
  #  ##   #
  #########
Solution: undefined

;146
 #######
 # .#. #
 #  *  #
 #. #. #
 ##$   #
###  * #
# $ ## ##
# $$    #
# @##   #
#########
Solution: undefined

;147
     #####
 #####   #
 #      $#
 #  ##$# #
###  $ # #
#  $## # #
# # # $  #
# @... # #
# ...### ##
## # $    #
 #   ##   #
 ##########
Solution: 5-6r1,3-6u3,2-2r4d2l2,3-3d3,4-7l1,6-6u2,8-1d5l1,6-7u1,4-9r3,9-9l4,8-8u2,4-10u2,5-7l1,8-4d4,6-2r1,8-1d1,6-4u1,5-2r1,6-6u2,3-6d1,2-8r1,4-9u1,3-7r1,1-7r1,3-8u1,6-7l3,9-9l4,4-10u2,8-2d5,8-7d1,6-2r1,6-4u1,5-2r1,3-7u3,5-7l1,3-8u1,3-5d2,4-8l1,1-7r1,3-8u1,1-8r1,9-9l2,7-9l2,4-10u2,5-7l2,8-1d7,9-9l4,4-10u2l1,3-7r1,1-8r1,6-2r1,8-1d7,9-9l4,4-10u2,4-8l1,3-5d2,1-7r1d1r1,3-6d1,2-10u1,3-2d4

;148
    ####
    #  #
#####. ###
# $  *.  #
# $$ .$  #
# @# . ###
####  ##
   ####
Solution: undefined

;149
     ####
######  #
#  .$   #
# .$@#  #
## #*$ ##
# .$ . ##
#   # $.#
#####   #
    #####
Solution: undefined

;150
     ####
     #  #
 #####  #
 # $    #
##@.*.$##
#  $#*..#
# $     #
###  ####
  ####
Solution: undefined

;151
 ########
 #  .#  #
 #$$.*. #
 #@$. # #
 #$#..# ##
## ##$   #
#     $  #
#   ###  #
##### ####
Solution: undefined


